"filename", "language", "C", "JSON", "Python", "C++", "comment", "blank", "total"
"/Users/sbukhari/Sandbox/CProgram/ASTanalysis/ASTLooper.py", "Python", 0, 0, 47, 0, 22, 41, 110
"/Users/sbukhari/Sandbox/CProgram/ASTanalysis/ASTParser.py", "Python", 0, 0, 130, 0, 129, 165, 424
"/Users/sbukhari/Sandbox/CProgram/ASTanalysis/ASTandLexClassification.py", "Python", 0, 0, 169, 0, 68, 153, 390
"/Users/sbukhari/Sandbox/CProgram/ASTanalysis/ASTandLexLooper.py", "Python", 0, 0, 45, 0, 26, 41, 112
"/Users/sbukhari/Sandbox/CProgram/ASTanalysis/ASTandLexParse.py", "Python", 0, 0, 165, 0, 97, 157, 419
"/Users/sbukhari/Sandbox/CProgram/ASTanalysis/BigramASTClassification.py", "Python", 0, 0, 109, 0, 54, 111, 274
"/Users/sbukhari/Sandbox/CProgram/ASTanalysis/BigramDictUpdate.py", "Python", 0, 0, 80, 0, 41, 73, 194
"/Users/sbukhari/Sandbox/CProgram/ASTanalysis/BigramVectorCreation.py", "Python", 0, 0, 63, 0, 32, 58, 153
"/Users/sbukhari/Sandbox/CProgram/ASTanalysis/CodexUserStudyData/Assisted/0640be89-ee5f-4846-8e14-40fdc574d7d3/api_report.json", "JSON", 0, 14, 0, 0, 0, 1, 15
"/Users/sbukhari/Sandbox/CProgram/ASTanalysis/CodexUserStudyData/Assisted/0640be89-ee5f-4846-8e14-40fdc574d7d3/list.c", "C", 210, 0, 0, 0, 101, 59, 370
"/Users/sbukhari/Sandbox/CProgram/ASTanalysis/CodexUserStudyData/Assisted/0640be89-ee5f-4846-8e14-40fdc574d7d3/orig_testsuite.json", "JSON", 0, 92, 0, 0, 0, 1, 93
"/Users/sbukhari/Sandbox/CProgram/ASTanalysis/CodexUserStudyData/Assisted/0640be89-ee5f-4846-8e14-40fdc574d7d3/orig_testsuite_asan.json", "JSON", 0, 92, 0, 0, 0, 1, 93
"/Users/sbukhari/Sandbox/CProgram/ASTanalysis/CodexUserStudyData/Assisted/0640be89-ee5f-4846-8e14-40fdc574d7d3/orig_testsuite_asan_noleak.json", "JSON", 0, 92, 0, 0, 0, 1, 93
"/Users/sbukhari/Sandbox/CProgram/ASTanalysis/CodexUserStudyData/Assisted/0640be89-ee5f-4846-8e14-40fdc574d7d3/parts/gen_list_add_item_at_pos.c", "C", 45, 0, 0, 0, 24, 10, 79
"/Users/sbukhari/Sandbox/CProgram/ASTanalysis/CodexUserStudyData/Assisted/0640be89-ee5f-4846-8e14-40fdc574d7d3/parts/gen_list_cost_sum.c", "C", 25, 0, 0, 0, 10, 9, 44
"/Users/sbukhari/Sandbox/CProgram/ASTanalysis/CodexUserStudyData/Assisted/0640be89-ee5f-4846-8e14-40fdc574d7d3/parts/gen_list_deduplicate.c", "C", 18, 0, 0, 0, 10, 5, 33
"/Users/sbukhari/Sandbox/CProgram/ASTanalysis/CodexUserStudyData/Assisted/0640be89-ee5f-4846-8e14-40fdc574d7d3/parts/gen_list_find_highest_price_item_position.c", "C", 33, 0, 0, 0, 12, 10, 55
"/Users/sbukhari/Sandbox/CProgram/ASTanalysis/CodexUserStudyData/Assisted/0640be89-ee5f-4846-8e14-40fdc574d7d3/parts/gen_list_init.c", "C", 19, 0, 0, 0, 6, 6, 31
"/Users/sbukhari/Sandbox/CProgram/ASTanalysis/CodexUserStudyData/Assisted/0640be89-ee5f-4846-8e14-40fdc574d7d3/parts/gen_list_item_to_string.c", "C", 21, 0, 0, 0, 14, 5, 40
"/Users/sbukhari/Sandbox/CProgram/ASTanalysis/CodexUserStudyData/Assisted/0640be89-ee5f-4846-8e14-40fdc574d7d3/parts/gen_list_load.c", "C", 35, 0, 0, 0, 19, 7, 61
"/Users/sbukhari/Sandbox/CProgram/ASTanalysis/CodexUserStudyData/Assisted/0640be89-ee5f-4846-8e14-40fdc574d7d3/parts/gen_list_print.c", "C", 29, 0, 0, 0, 24, 8, 61
"/Users/sbukhari/Sandbox/CProgram/ASTanalysis/CodexUserStudyData/Assisted/0640be89-ee5f-4846-8e14-40fdc574d7d3/parts/gen_list_remove_item_at_pos.c", "C", 43, 0, 0, 0, 16, 9, 68
"/Users/sbukhari/Sandbox/CProgram/ASTanalysis/CodexUserStudyData/Assisted/0640be89-ee5f-4846-8e14-40fdc574d7d3/parts/gen_list_save.c", "C", 27, 0, 0, 0, 18, 11, 56
"/Users/sbukhari/Sandbox/CProgram/ASTanalysis/CodexUserStudyData/Assisted/0640be89-ee5f-4846-8e14-40fdc574d7d3/parts/gen_list_swap_item_positions.c", "C", 41, 0, 0, 0, 14, 10, 65
"/Users/sbukhari/Sandbox/CProgram/ASTanalysis/CodexUserStudyData/Assisted/0640be89-ee5f-4846-8e14-40fdc574d7d3/parts/gen_list_update_item_at_pos.c", "C", 29, 0, 0, 0, 15, 9, 53
"/Users/sbukhari/Sandbox/CProgram/ASTanalysis/CodexUserStudyData/Assisted/0640be89-ee5f-4846-8e14-40fdc574d7d3/ref_testsuite.json", "JSON", 0, 323, 0, 0, 0, 1, 324
"/Users/sbukhari/Sandbox/CProgram/ASTanalysis/CodexUserStudyData/Assisted/0640be89-ee5f-4846-8e14-40fdc574d7d3/ref_testsuite_asan.json", "JSON", 0, 323, 0, 0, 0, 1, 324
"/Users/sbukhari/Sandbox/CProgram/ASTanalysis/CodexUserStudyData/Assisted/0640be89-ee5f-4846-8e14-40fdc574d7d3/ref_testsuite_asan_noleak.json", "JSON", 0, 323, 0, 0, 0, 1, 324
"/Users/sbukhari/Sandbox/CProgram/ASTanalysis/CodexUserStudyData/Assisted/0ed7147a-475a-438b-8eee-c19d9d380739/api_report.json", "JSON", 0, 14, 0, 0, 0, 1, 15
"/Users/sbukhari/Sandbox/CProgram/ASTanalysis/CodexUserStudyData/Assisted/0ed7147a-475a-438b-8eee-c19d9d380739/list.c", "C", 137, 0, 0, 0, 72, 25, 234
"/Users/sbukhari/Sandbox/CProgram/ASTanalysis/CodexUserStudyData/Assisted/0ed7147a-475a-438b-8eee-c19d9d380739/orig_testsuite.json", "JSON", 0, 92, 0, 0, 0, 1, 93
"/Users/sbukhari/Sandbox/CProgram/ASTanalysis/CodexUserStudyData/Assisted/0ed7147a-475a-438b-8eee-c19d9d380739/orig_testsuite_asan.json", "JSON", 0, 92, 0, 0, 0, 1, 93
"/Users/sbukhari/Sandbox/CProgram/ASTanalysis/CodexUserStudyData/Assisted/0ed7147a-475a-438b-8eee-c19d9d380739/orig_testsuite_asan_noleak.json", "JSON", 0, 92, 0, 0, 0, 1, 93
"/Users/sbukhari/Sandbox/CProgram/ASTanalysis/CodexUserStudyData/Assisted/0ed7147a-475a-438b-8eee-c19d9d380739/parts/gen_list_add_item_at_pos.c", "C", 46, 0, 0, 0, 19, 10, 75
"/Users/sbukhari/Sandbox/CProgram/ASTanalysis/CodexUserStudyData/Assisted/0ed7147a-475a-438b-8eee-c19d9d380739/parts/gen_list_cost_sum.c", "C", 25, 0, 0, 0, 9, 5, 39
"/Users/sbukhari/Sandbox/CProgram/ASTanalysis/CodexUserStudyData/Assisted/0ed7147a-475a-438b-8eee-c19d9d380739/parts/gen_list_deduplicate.c", "C", 18, 0, 0, 0, 10, 5, 33
"/Users/sbukhari/Sandbox/CProgram/ASTanalysis/CodexUserStudyData/Assisted/0ed7147a-475a-438b-8eee-c19d9d380739/parts/gen_list_find_highest_price_item_position.c", "C", 29, 0, 0, 0, 10, 5, 44
"/Users/sbukhari/Sandbox/CProgram/ASTanalysis/CodexUserStudyData/Assisted/0ed7147a-475a-438b-8eee-c19d9d380739/parts/gen_list_init.c", "C", 19, 0, 0, 0, 6, 6, 31
"/Users/sbukhari/Sandbox/CProgram/ASTanalysis/CodexUserStudyData/Assisted/0ed7147a-475a-438b-8eee-c19d9d380739/parts/gen_list_item_to_string.c", "C", 20, 0, 0, 0, 11, 5, 36
"/Users/sbukhari/Sandbox/CProgram/ASTanalysis/CodexUserStudyData/Assisted/0ed7147a-475a-438b-8eee-c19d9d380739/parts/gen_list_load.c", "C", 18, 0, 0, 0, 12, 5, 35
"/Users/sbukhari/Sandbox/CProgram/ASTanalysis/CodexUserStudyData/Assisted/0ed7147a-475a-438b-8eee-c19d9d380739/parts/gen_list_print.c", "C", 27, 0, 0, 0, 22, 5, 54
"/Users/sbukhari/Sandbox/CProgram/ASTanalysis/CodexUserStudyData/Assisted/0ed7147a-475a-438b-8eee-c19d9d380739/parts/gen_list_remove_item_at_pos.c", "C", 18, 0, 0, 0, 8, 5, 31
"/Users/sbukhari/Sandbox/CProgram/ASTanalysis/CodexUserStudyData/Assisted/0ed7147a-475a-438b-8eee-c19d9d380739/parts/gen_list_save.c", "C", 18, 0, 0, 0, 11, 5, 34
"/Users/sbukhari/Sandbox/CProgram/ASTanalysis/CodexUserStudyData/Assisted/0ed7147a-475a-438b-8eee-c19d9d380739/parts/gen_list_swap_item_positions.c", "C", 17, 0, 0, 0, 8, 5, 30
"/Users/sbukhari/Sandbox/CProgram/ASTanalysis/CodexUserStudyData/Assisted/0ed7147a-475a-438b-8eee-c19d9d380739/parts/gen_list_update_item_at_pos.c", "C", 37, 0, 0, 0, 14, 8, 59
"/Users/sbukhari/Sandbox/CProgram/ASTanalysis/CodexUserStudyData/Assisted/0ed7147a-475a-438b-8eee-c19d9d380739/ref_testsuite.json", "JSON", 0, 323, 0, 0, 0, 1, 324
"/Users/sbukhari/Sandbox/CProgram/ASTanalysis/CodexUserStudyData/Assisted/0ed7147a-475a-438b-8eee-c19d9d380739/ref_testsuite_asan.json", "JSON", 0, 323, 0, 0, 0, 1, 324
"/Users/sbukhari/Sandbox/CProgram/ASTanalysis/CodexUserStudyData/Assisted/0ed7147a-475a-438b-8eee-c19d9d380739/ref_testsuite_asan_noleak.json", "JSON", 0, 323, 0, 0, 0, 1, 324
"/Users/sbukhari/Sandbox/CProgram/ASTanalysis/CodexUserStudyData/Assisted/1f1c4c51-758b-4b08-88e3-e919cb5eaeaf/api_report.json", "JSON", 0, 14, 0, 0, 0, 1, 15
"/Users/sbukhari/Sandbox/CProgram/ASTanalysis/CodexUserStudyData/Assisted/1f1c4c51-758b-4b08-88e3-e919cb5eaeaf/list.c", "C", 99, 0, 0, 0, 74, 26, 199
"/Users/sbukhari/Sandbox/CProgram/ASTanalysis/CodexUserStudyData/Assisted/1f1c4c51-758b-4b08-88e3-e919cb5eaeaf/orig_testsuite.json", "JSON", 0, 92, 0, 0, 0, 1, 93
"/Users/sbukhari/Sandbox/CProgram/ASTanalysis/CodexUserStudyData/Assisted/1f1c4c51-758b-4b08-88e3-e919cb5eaeaf/orig_testsuite_asan.json", "JSON", 0, 92, 0, 0, 0, 1, 93
"/Users/sbukhari/Sandbox/CProgram/ASTanalysis/CodexUserStudyData/Assisted/1f1c4c51-758b-4b08-88e3-e919cb5eaeaf/orig_testsuite_asan_noleak.json", "JSON", 0, 92, 0, 0, 0, 1, 93
"/Users/sbukhari/Sandbox/CProgram/ASTanalysis/CodexUserStudyData/Assisted/1f1c4c51-758b-4b08-88e3-e919cb5eaeaf/parts/gen_list_add_item_at_pos.c", "C", 44, 0, 0, 0, 22, 12, 78
"/Users/sbukhari/Sandbox/CProgram/ASTanalysis/CodexUserStudyData/Assisted/1f1c4c51-758b-4b08-88e3-e919cb5eaeaf/parts/gen_list_cost_sum.c", "C", 18, 0, 0, 0, 8, 5, 31
"/Users/sbukhari/Sandbox/CProgram/ASTanalysis/CodexUserStudyData/Assisted/1f1c4c51-758b-4b08-88e3-e919cb5eaeaf/parts/gen_list_deduplicate.c", "C", 18, 0, 0, 0, 10, 5, 33
"/Users/sbukhari/Sandbox/CProgram/ASTanalysis/CodexUserStudyData/Assisted/1f1c4c51-758b-4b08-88e3-e919cb5eaeaf/parts/gen_list_find_highest_price_item_position.c", "C", 18, 0, 0, 0, 8, 5, 31
"/Users/sbukhari/Sandbox/CProgram/ASTanalysis/CodexUserStudyData/Assisted/1f1c4c51-758b-4b08-88e3-e919cb5eaeaf/parts/gen_list_init.c", "C", 19, 0, 0, 0, 6, 6, 31
"/Users/sbukhari/Sandbox/CProgram/ASTanalysis/CodexUserStudyData/Assisted/1f1c4c51-758b-4b08-88e3-e919cb5eaeaf/parts/gen_list_item_to_string.c", "C", 22, 0, 0, 0, 14, 5, 41
"/Users/sbukhari/Sandbox/CProgram/ASTanalysis/CodexUserStudyData/Assisted/1f1c4c51-758b-4b08-88e3-e919cb5eaeaf/parts/gen_list_load.c", "C", 18, 0, 0, 0, 12, 5, 35
"/Users/sbukhari/Sandbox/CProgram/ASTanalysis/CodexUserStudyData/Assisted/1f1c4c51-758b-4b08-88e3-e919cb5eaeaf/parts/gen_list_print.c", "C", 26, 0, 0, 0, 21, 7, 54
"/Users/sbukhari/Sandbox/CProgram/ASTanalysis/CodexUserStudyData/Assisted/1f1c4c51-758b-4b08-88e3-e919cb5eaeaf/parts/gen_list_remove_item_at_pos.c", "C", 18, 0, 0, 0, 8, 5, 31
"/Users/sbukhari/Sandbox/CProgram/ASTanalysis/CodexUserStudyData/Assisted/1f1c4c51-758b-4b08-88e3-e919cb5eaeaf/parts/gen_list_save.c", "C", 18, 0, 0, 0, 11, 5, 34
"/Users/sbukhari/Sandbox/CProgram/ASTanalysis/CodexUserStudyData/Assisted/1f1c4c51-758b-4b08-88e3-e919cb5eaeaf/parts/gen_list_swap_item_positions.c", "C", 17, 0, 0, 0, 8, 5, 30
"/Users/sbukhari/Sandbox/CProgram/ASTanalysis/CodexUserStudyData/Assisted/1f1c4c51-758b-4b08-88e3-e919cb5eaeaf/parts/gen_list_update_item_at_pos.c", "C", 17, 0, 0, 0, 8, 5, 30
"/Users/sbukhari/Sandbox/CProgram/ASTanalysis/CodexUserStudyData/Assisted/1f1c4c51-758b-4b08-88e3-e919cb5eaeaf/ref_testsuite.json", "JSON", 0, 323, 0, 0, 0, 1, 324
"/Users/sbukhari/Sandbox/CProgram/ASTanalysis/CodexUserStudyData/Assisted/1f1c4c51-758b-4b08-88e3-e919cb5eaeaf/ref_testsuite_asan.json", "JSON", 0, 323, 0, 0, 0, 1, 324
"/Users/sbukhari/Sandbox/CProgram/ASTanalysis/CodexUserStudyData/Assisted/1f1c4c51-758b-4b08-88e3-e919cb5eaeaf/ref_testsuite_asan_noleak.json", "JSON", 0, 323, 0, 0, 0, 1, 324
"/Users/sbukhari/Sandbox/CProgram/ASTanalysis/CodexUserStudyData/Assisted/212591de-3007-4e4d-a0df-67d22d6c5f91/api_report.json", "JSON", 0, 14, 0, 0, 0, 1, 15
"/Users/sbukhari/Sandbox/CProgram/ASTanalysis/CodexUserStudyData/Assisted/212591de-3007-4e4d-a0df-67d22d6c5f91/list.c", "C", 183, 0, 0, 0, 73, 22, 278
"/Users/sbukhari/Sandbox/CProgram/ASTanalysis/CodexUserStudyData/Assisted/212591de-3007-4e4d-a0df-67d22d6c5f91/orig_testsuite.json", "JSON", 0, 92, 0, 0, 0, 1, 93
"/Users/sbukhari/Sandbox/CProgram/ASTanalysis/CodexUserStudyData/Assisted/212591de-3007-4e4d-a0df-67d22d6c5f91/orig_testsuite_asan.json", "JSON", 0, 92, 0, 0, 0, 1, 93
"/Users/sbukhari/Sandbox/CProgram/ASTanalysis/CodexUserStudyData/Assisted/212591de-3007-4e4d-a0df-67d22d6c5f91/orig_testsuite_asan_noleak.json", "JSON", 0, 92, 0, 0, 0, 1, 93
"/Users/sbukhari/Sandbox/CProgram/ASTanalysis/CodexUserStudyData/Assisted/212591de-3007-4e4d-a0df-67d22d6c5f91/parts/gen_list_add_item_at_pos.c", "C", 56, 0, 0, 0, 28, 20, 104
"/Users/sbukhari/Sandbox/CProgram/ASTanalysis/CodexUserStudyData/Assisted/212591de-3007-4e4d-a0df-67d22d6c5f91/parts/gen_list_cost_sum.c", "C", 18, 0, 0, 0, 8, 5, 31
"/Users/sbukhari/Sandbox/CProgram/ASTanalysis/CodexUserStudyData/Assisted/212591de-3007-4e4d-a0df-67d22d6c5f91/parts/gen_list_deduplicate.c", "C", 18, 0, 0, 0, 10, 5, 33
"/Users/sbukhari/Sandbox/CProgram/ASTanalysis/CodexUserStudyData/Assisted/212591de-3007-4e4d-a0df-67d22d6c5f91/parts/gen_list_find_highest_price_item_position.c", "C", 32, 0, 0, 0, 7, 5, 44
"/Users/sbukhari/Sandbox/CProgram/ASTanalysis/CodexUserStudyData/Assisted/212591de-3007-4e4d-a0df-67d22d6c5f91/parts/gen_list_init.c", "C", 19, 0, 0, 0, 6, 5, 30
"/Users/sbukhari/Sandbox/CProgram/ASTanalysis/CodexUserStudyData/Assisted/212591de-3007-4e4d-a0df-67d22d6c5f91/parts/gen_list_item_to_string.c", "C", 20, 0, 0, 0, 14, 6, 40
"/Users/sbukhari/Sandbox/CProgram/ASTanalysis/CodexUserStudyData/Assisted/212591de-3007-4e4d-a0df-67d22d6c5f91/parts/gen_list_load.c", "C", 18, 0, 0, 0, 12, 5, 35
"/Users/sbukhari/Sandbox/CProgram/ASTanalysis/CodexUserStudyData/Assisted/212591de-3007-4e4d-a0df-67d22d6c5f91/parts/gen_list_print.c", "C", 17, 0, 0, 0, 20, 5, 42
"/Users/sbukhari/Sandbox/CProgram/ASTanalysis/CodexUserStudyData/Assisted/212591de-3007-4e4d-a0df-67d22d6c5f91/parts/gen_list_remove_item_at_pos.c", "C", 40, 0, 0, 0, 10, 7, 57
"/Users/sbukhari/Sandbox/CProgram/ASTanalysis/CodexUserStudyData/Assisted/212591de-3007-4e4d-a0df-67d22d6c5f91/parts/gen_list_save.c", "C", 30, 0, 0, 0, 12, 5, 47
"/Users/sbukhari/Sandbox/CProgram/ASTanalysis/CodexUserStudyData/Assisted/212591de-3007-4e4d-a0df-67d22d6c5f91/parts/gen_list_swap_item_positions.c", "C", 55, 0, 0, 0, 10, 6, 71
"/Users/sbukhari/Sandbox/CProgram/ASTanalysis/CodexUserStudyData/Assisted/212591de-3007-4e4d-a0df-67d22d6c5f91/parts/gen_list_update_item_at_pos.c", "C", 33, 0, 0, 0, 9, 5, 47
"/Users/sbukhari/Sandbox/CProgram/ASTanalysis/CodexUserStudyData/Assisted/212591de-3007-4e4d-a0df-67d22d6c5f91/ref_testsuite.json", "JSON", 0, 323, 0, 0, 0, 1, 324
"/Users/sbukhari/Sandbox/CProgram/ASTanalysis/CodexUserStudyData/Assisted/212591de-3007-4e4d-a0df-67d22d6c5f91/ref_testsuite_asan.json", "JSON", 0, 323, 0, 0, 0, 1, 324
"/Users/sbukhari/Sandbox/CProgram/ASTanalysis/CodexUserStudyData/Assisted/212591de-3007-4e4d-a0df-67d22d6c5f91/ref_testsuite_asan_noleak.json", "JSON", 0, 323, 0, 0, 0, 1, 324
"/Users/sbukhari/Sandbox/CProgram/ASTanalysis/CodexUserStudyData/Assisted/21cb2508-2c4a-468d-a771-002ba7e0f211/api_report.json", "JSON", 0, 14, 0, 0, 0, 1, 15
"/Users/sbukhari/Sandbox/CProgram/ASTanalysis/CodexUserStudyData/Assisted/21cb2508-2c4a-468d-a771-002ba7e0f211/list.c", "C", 63, 0, 0, 0, 74, 17, 154
"/Users/sbukhari/Sandbox/CProgram/ASTanalysis/CodexUserStudyData/Assisted/21cb2508-2c4a-468d-a771-002ba7e0f211/orig_testsuite.json", "JSON", 0, 92, 0, 0, 0, 1, 93
"/Users/sbukhari/Sandbox/CProgram/ASTanalysis/CodexUserStudyData/Assisted/21cb2508-2c4a-468d-a771-002ba7e0f211/orig_testsuite_asan.json", "JSON", 0, 92, 0, 0, 0, 1, 93
"/Users/sbukhari/Sandbox/CProgram/ASTanalysis/CodexUserStudyData/Assisted/21cb2508-2c4a-468d-a771-002ba7e0f211/orig_testsuite_asan_noleak.json", "JSON", 0, 92, 0, 0, 0, 1, 93
"/Users/sbukhari/Sandbox/CProgram/ASTanalysis/CodexUserStudyData/Assisted/21cb2508-2c4a-468d-a771-002ba7e0f211/parts/gen_list_add_item_at_pos.c", "C", 18, 0, 0, 0, 18, 5, 41
"/Users/sbukhari/Sandbox/CProgram/ASTanalysis/CodexUserStudyData/Assisted/21cb2508-2c4a-468d-a771-002ba7e0f211/parts/gen_list_cost_sum.c", "C", 18, 0, 0, 0, 8, 5, 31
"/Users/sbukhari/Sandbox/CProgram/ASTanalysis/CodexUserStudyData/Assisted/21cb2508-2c4a-468d-a771-002ba7e0f211/parts/gen_list_deduplicate.c", "C", 18, 0, 0, 0, 10, 5, 33
"/Users/sbukhari/Sandbox/CProgram/ASTanalysis/CodexUserStudyData/Assisted/21cb2508-2c4a-468d-a771-002ba7e0f211/parts/gen_list_find_highest_price_item_position.c", "C", 18, 0, 0, 0, 8, 5, 31
"/Users/sbukhari/Sandbox/CProgram/ASTanalysis/CodexUserStudyData/Assisted/21cb2508-2c4a-468d-a771-002ba7e0f211/parts/gen_list_init.c", "C", 19, 0, 0, 0, 6, 6, 31
"/Users/sbukhari/Sandbox/CProgram/ASTanalysis/CodexUserStudyData/Assisted/21cb2508-2c4a-468d-a771-002ba7e0f211/parts/gen_list_item_to_string.c", "C", 17, 0, 0, 0, 11, 5, 33
"/Users/sbukhari/Sandbox/CProgram/ASTanalysis/CodexUserStudyData/Assisted/21cb2508-2c4a-468d-a771-002ba7e0f211/parts/gen_list_load.c", "C", 18, 0, 0, 0, 12, 5, 35
"/Users/sbukhari/Sandbox/CProgram/ASTanalysis/CodexUserStudyData/Assisted/21cb2508-2c4a-468d-a771-002ba7e0f211/parts/gen_list_print.c", "C", 22, 0, 0, 0, 21, 5, 48
"/Users/sbukhari/Sandbox/CProgram/ASTanalysis/CodexUserStudyData/Assisted/21cb2508-2c4a-468d-a771-002ba7e0f211/parts/gen_list_remove_item_at_pos.c", "C", 18, 0, 0, 0, 8, 5, 31
"/Users/sbukhari/Sandbox/CProgram/ASTanalysis/CodexUserStudyData/Assisted/21cb2508-2c4a-468d-a771-002ba7e0f211/parts/gen_list_save.c", "C", 18, 0, 0, 0, 11, 5, 34
"/Users/sbukhari/Sandbox/CProgram/ASTanalysis/CodexUserStudyData/Assisted/21cb2508-2c4a-468d-a771-002ba7e0f211/parts/gen_list_swap_item_positions.c", "C", 17, 0, 0, 0, 8, 5, 30
"/Users/sbukhari/Sandbox/CProgram/ASTanalysis/CodexUserStudyData/Assisted/21cb2508-2c4a-468d-a771-002ba7e0f211/parts/gen_list_update_item_at_pos.c", "C", 17, 0, 0, 0, 8, 5, 30
"/Users/sbukhari/Sandbox/CProgram/ASTanalysis/CodexUserStudyData/Assisted/21cb2508-2c4a-468d-a771-002ba7e0f211/ref_testsuite.json", "JSON", 0, 323, 0, 0, 0, 1, 324
"/Users/sbukhari/Sandbox/CProgram/ASTanalysis/CodexUserStudyData/Assisted/21cb2508-2c4a-468d-a771-002ba7e0f211/ref_testsuite_asan.json", "JSON", 0, 323, 0, 0, 0, 1, 324
"/Users/sbukhari/Sandbox/CProgram/ASTanalysis/CodexUserStudyData/Assisted/21cb2508-2c4a-468d-a771-002ba7e0f211/ref_testsuite_asan_noleak.json", "JSON", 0, 323, 0, 0, 0, 1, 324
"/Users/sbukhari/Sandbox/CProgram/ASTanalysis/CodexUserStudyData/Assisted/26a41023-c10e-41cc-b9e1-8103dc46f264/api_report.json", "JSON", 0, 14, 0, 0, 0, 1, 15
"/Users/sbukhari/Sandbox/CProgram/ASTanalysis/CodexUserStudyData/Assisted/26a41023-c10e-41cc-b9e1-8103dc46f264/list.c", "C", 233, 0, 0, 0, 71, 37, 341
"/Users/sbukhari/Sandbox/CProgram/ASTanalysis/CodexUserStudyData/Assisted/26a41023-c10e-41cc-b9e1-8103dc46f264/orig_testsuite.json", "JSON", 0, 92, 0, 0, 0, 1, 93
"/Users/sbukhari/Sandbox/CProgram/ASTanalysis/CodexUserStudyData/Assisted/26a41023-c10e-41cc-b9e1-8103dc46f264/orig_testsuite_asan.json", "JSON", 0, 92, 0, 0, 0, 1, 93
"/Users/sbukhari/Sandbox/CProgram/ASTanalysis/CodexUserStudyData/Assisted/26a41023-c10e-41cc-b9e1-8103dc46f264/orig_testsuite_asan_noleak.json", "JSON", 0, 92, 0, 0, 0, 1, 93
"/Users/sbukhari/Sandbox/CProgram/ASTanalysis/CodexUserStudyData/Assisted/26a41023-c10e-41cc-b9e1-8103dc46f264/parts/gen_list_add_item_at_pos.c", "C", 40, 0, 0, 0, 17, 10, 67
"/Users/sbukhari/Sandbox/CProgram/ASTanalysis/CodexUserStudyData/Assisted/26a41023-c10e-41cc-b9e1-8103dc46f264/parts/gen_list_cost_sum.c", "C", 23, 0, 0, 0, 9, 5, 37
"/Users/sbukhari/Sandbox/CProgram/ASTanalysis/CodexUserStudyData/Assisted/26a41023-c10e-41cc-b9e1-8103dc46f264/parts/gen_list_deduplicate.c", "C", 36, 0, 0, 0, 11, 5, 52
"/Users/sbukhari/Sandbox/CProgram/ASTanalysis/CodexUserStudyData/Assisted/26a41023-c10e-41cc-b9e1-8103dc46f264/parts/gen_list_find_highest_price_item_position.c", "C", 26, 0, 0, 0, 10, 5, 41
"/Users/sbukhari/Sandbox/CProgram/ASTanalysis/CodexUserStudyData/Assisted/26a41023-c10e-41cc-b9e1-8103dc46f264/parts/gen_list_init.c", "C", 20, 0, 0, 0, 6, 6, 32
"/Users/sbukhari/Sandbox/CProgram/ASTanalysis/CodexUserStudyData/Assisted/26a41023-c10e-41cc-b9e1-8103dc46f264/parts/gen_list_item_to_string.c", "C", 21, 0, 0, 0, 14, 6, 41
"/Users/sbukhari/Sandbox/CProgram/ASTanalysis/CodexUserStudyData/Assisted/26a41023-c10e-41cc-b9e1-8103dc46f264/parts/gen_list_load.c", "C", 46, 0, 0, 0, 17, 5, 68
"/Users/sbukhari/Sandbox/CProgram/ASTanalysis/CodexUserStudyData/Assisted/26a41023-c10e-41cc-b9e1-8103dc46f264/parts/gen_list_print.c", "C", 24, 0, 0, 0, 23, 5, 52
"/Users/sbukhari/Sandbox/CProgram/ASTanalysis/CodexUserStudyData/Assisted/26a41023-c10e-41cc-b9e1-8103dc46f264/parts/gen_list_remove_item_at_pos.c", "C", 34, 0, 0, 0, 10, 9, 53
"/Users/sbukhari/Sandbox/CProgram/ASTanalysis/CodexUserStudyData/Assisted/26a41023-c10e-41cc-b9e1-8103dc46f264/parts/gen_list_save.c", "C", 27, 0, 0, 0, 12, 5, 44
"/Users/sbukhari/Sandbox/CProgram/ASTanalysis/CodexUserStudyData/Assisted/26a41023-c10e-41cc-b9e1-8103dc46f264/parts/gen_list_swap_item_positions.c", "C", 60, 0, 0, 0, 11, 9, 80
"/Users/sbukhari/Sandbox/CProgram/ASTanalysis/CodexUserStudyData/Assisted/26a41023-c10e-41cc-b9e1-8103dc46f264/parts/gen_list_update_item_at_pos.c", "C", 31, 0, 0, 0, 9, 8, 48
"/Users/sbukhari/Sandbox/CProgram/ASTanalysis/CodexUserStudyData/Assisted/26a41023-c10e-41cc-b9e1-8103dc46f264/ref_testsuite.json", "JSON", 0, 323, 0, 0, 0, 1, 324
"/Users/sbukhari/Sandbox/CProgram/ASTanalysis/CodexUserStudyData/Assisted/26a41023-c10e-41cc-b9e1-8103dc46f264/ref_testsuite_asan.json", "JSON", 0, 323, 0, 0, 0, 1, 324
"/Users/sbukhari/Sandbox/CProgram/ASTanalysis/CodexUserStudyData/Assisted/26a41023-c10e-41cc-b9e1-8103dc46f264/ref_testsuite_asan_noleak.json", "JSON", 0, 323, 0, 0, 0, 1, 324
"/Users/sbukhari/Sandbox/CProgram/ASTanalysis/CodexUserStudyData/Assisted/3533dacf-349b-4581-bc32-6b9f015199c1/api_report.json", "JSON", 0, 14, 0, 0, 0, 1, 15
"/Users/sbukhari/Sandbox/CProgram/ASTanalysis/CodexUserStudyData/Assisted/3533dacf-349b-4581-bc32-6b9f015199c1/list.c", "C", 287, 0, 0, 0, 60, 47, 394
"/Users/sbukhari/Sandbox/CProgram/ASTanalysis/CodexUserStudyData/Assisted/3533dacf-349b-4581-bc32-6b9f015199c1/orig_testsuite.json", "JSON", 0, 92, 0, 0, 0, 1, 93
"/Users/sbukhari/Sandbox/CProgram/ASTanalysis/CodexUserStudyData/Assisted/3533dacf-349b-4581-bc32-6b9f015199c1/orig_testsuite_asan.json", "JSON", 0, 92, 0, 0, 0, 1, 93
"/Users/sbukhari/Sandbox/CProgram/ASTanalysis/CodexUserStudyData/Assisted/3533dacf-349b-4581-bc32-6b9f015199c1/orig_testsuite_asan_noleak.json", "JSON", 0, 92, 0, 0, 0, 1, 93
"/Users/sbukhari/Sandbox/CProgram/ASTanalysis/CodexUserStudyData/Assisted/3533dacf-349b-4581-bc32-6b9f015199c1/parts/gen_list_add_item_at_pos.c", "C", 43, 0, 0, 0, 22, 9, 74
"/Users/sbukhari/Sandbox/CProgram/ASTanalysis/CodexUserStudyData/Assisted/3533dacf-349b-4581-bc32-6b9f015199c1/parts/gen_list_cost_sum.c", "C", 26, 0, 0, 0, 7, 6, 39
"/Users/sbukhari/Sandbox/CProgram/ASTanalysis/CodexUserStudyData/Assisted/3533dacf-349b-4581-bc32-6b9f015199c1/parts/gen_list_deduplicate.c", "C", 44, 0, 0, 0, 12, 8, 64
"/Users/sbukhari/Sandbox/CProgram/ASTanalysis/CodexUserStudyData/Assisted/3533dacf-349b-4581-bc32-6b9f015199c1/parts/gen_list_find_highest_price_item_position.c", "C", 32, 0, 0, 0, 8, 6, 46
"/Users/sbukhari/Sandbox/CProgram/ASTanalysis/CodexUserStudyData/Assisted/3533dacf-349b-4581-bc32-6b9f015199c1/parts/gen_list_init.c", "C", 19, 0, 0, 0, 6, 6, 31
"/Users/sbukhari/Sandbox/CProgram/ASTanalysis/CodexUserStudyData/Assisted/3533dacf-349b-4581-bc32-6b9f015199c1/parts/gen_list_item_to_string.c", "C", 22, 0, 0, 0, 13, 5, 40
"/Users/sbukhari/Sandbox/CProgram/ASTanalysis/CodexUserStudyData/Assisted/3533dacf-349b-4581-bc32-6b9f015199c1/parts/gen_list_load.c", "C", 77, 0, 0, 0, 18, 15, 110
"/Users/sbukhari/Sandbox/CProgram/ASTanalysis/CodexUserStudyData/Assisted/3533dacf-349b-4581-bc32-6b9f015199c1/parts/gen_list_print.c", "C", 29, 0, 0, 0, 21, 5, 55
"/Users/sbukhari/Sandbox/CProgram/ASTanalysis/CodexUserStudyData/Assisted/3533dacf-349b-4581-bc32-6b9f015199c1/parts/gen_list_remove_item_at_pos.c", "C", 37, 0, 0, 0, 10, 5, 52
"/Users/sbukhari/Sandbox/CProgram/ASTanalysis/CodexUserStudyData/Assisted/3533dacf-349b-4581-bc32-6b9f015199c1/parts/gen_list_save.c", "C", 30, 0, 0, 0, 12, 7, 49
"/Users/sbukhari/Sandbox/CProgram/ASTanalysis/CodexUserStudyData/Assisted/3533dacf-349b-4581-bc32-6b9f015199c1/parts/gen_list_swap_item_positions.c", "C", 53, 0, 0, 0, 9, 8, 70
"/Users/sbukhari/Sandbox/CProgram/ASTanalysis/CodexUserStudyData/Assisted/3533dacf-349b-4581-bc32-6b9f015199c1/parts/gen_list_update_item_at_pos.c", "C", 30, 0, 0, 0, 9, 7, 46
"/Users/sbukhari/Sandbox/CProgram/ASTanalysis/CodexUserStudyData/Assisted/3533dacf-349b-4581-bc32-6b9f015199c1/ref_testsuite.json", "JSON", 0, 323, 0, 0, 0, 1, 324
"/Users/sbukhari/Sandbox/CProgram/ASTanalysis/CodexUserStudyData/Assisted/3533dacf-349b-4581-bc32-6b9f015199c1/ref_testsuite_asan.json", "JSON", 0, 323, 0, 0, 0, 1, 324
"/Users/sbukhari/Sandbox/CProgram/ASTanalysis/CodexUserStudyData/Assisted/3533dacf-349b-4581-bc32-6b9f015199c1/ref_testsuite_asan_noleak.json", "JSON", 0, 323, 0, 0, 0, 1, 324
"/Users/sbukhari/Sandbox/CProgram/ASTanalysis/CodexUserStudyData/Assisted/36deba30-9345-480d-8221-387f5192f83d/api_report.json", "JSON", 0, 14, 0, 0, 0, 1, 15
"/Users/sbukhari/Sandbox/CProgram/ASTanalysis/CodexUserStudyData/Assisted/36deba30-9345-480d-8221-387f5192f83d/list.c", "C", 219, 0, 0, 0, 90, 25, 334
"/Users/sbukhari/Sandbox/CProgram/ASTanalysis/CodexUserStudyData/Assisted/36deba30-9345-480d-8221-387f5192f83d/orig_testsuite.json", "JSON", 0, 92, 0, 0, 0, 1, 93
"/Users/sbukhari/Sandbox/CProgram/ASTanalysis/CodexUserStudyData/Assisted/36deba30-9345-480d-8221-387f5192f83d/orig_testsuite_asan.json", "JSON", 0, 92, 0, 0, 0, 1, 93
"/Users/sbukhari/Sandbox/CProgram/ASTanalysis/CodexUserStudyData/Assisted/36deba30-9345-480d-8221-387f5192f83d/orig_testsuite_asan_noleak.json", "JSON", 0, 92, 0, 0, 0, 1, 93
"/Users/sbukhari/Sandbox/CProgram/ASTanalysis/CodexUserStudyData/Assisted/36deba30-9345-480d-8221-387f5192f83d/parts/gen_list_add_item_at_pos.c", "C", 41, 0, 0, 0, 19, 5, 65
"/Users/sbukhari/Sandbox/CProgram/ASTanalysis/CodexUserStudyData/Assisted/36deba30-9345-480d-8221-387f5192f83d/parts/gen_list_cost_sum.c", "C", 24, 0, 0, 0, 9, 5, 38
"/Users/sbukhari/Sandbox/CProgram/ASTanalysis/CodexUserStudyData/Assisted/36deba30-9345-480d-8221-387f5192f83d/parts/gen_list_deduplicate.c", "C", 17, 0, 0, 0, 26, 4, 47
"/Users/sbukhari/Sandbox/CProgram/ASTanalysis/CodexUserStudyData/Assisted/36deba30-9345-480d-8221-387f5192f83d/parts/gen_list_find_highest_price_item_position.c", "C", 32, 0, 0, 0, 9, 5, 46
"/Users/sbukhari/Sandbox/CProgram/ASTanalysis/CodexUserStudyData/Assisted/36deba30-9345-480d-8221-387f5192f83d/parts/gen_list_init.c", "C", 19, 0, 0, 0, 6, 6, 31
"/Users/sbukhari/Sandbox/CProgram/ASTanalysis/CodexUserStudyData/Assisted/36deba30-9345-480d-8221-387f5192f83d/parts/gen_list_item_to_string.c", "C", 22, 0, 0, 0, 15, 5, 42
"/Users/sbukhari/Sandbox/CProgram/ASTanalysis/CodexUserStudyData/Assisted/36deba30-9345-480d-8221-387f5192f83d/parts/gen_list_load.c", "C", 33, 0, 0, 0, 18, 5, 56
"/Users/sbukhari/Sandbox/CProgram/ASTanalysis/CodexUserStudyData/Assisted/36deba30-9345-480d-8221-387f5192f83d/parts/gen_list_print.c", "C", 29, 0, 0, 0, 22, 6, 57
"/Users/sbukhari/Sandbox/CProgram/ASTanalysis/CodexUserStudyData/Assisted/36deba30-9345-480d-8221-387f5192f83d/parts/gen_list_remove_item_at_pos.c", "C", 38, 0, 0, 0, 14, 5, 57
"/Users/sbukhari/Sandbox/CProgram/ASTanalysis/CodexUserStudyData/Assisted/36deba30-9345-480d-8221-387f5192f83d/parts/gen_list_save.c", "C", 29, 0, 0, 0, 14, 6, 49
"/Users/sbukhari/Sandbox/CProgram/ASTanalysis/CodexUserStudyData/Assisted/36deba30-9345-480d-8221-387f5192f83d/parts/gen_list_swap_item_positions.c", "C", 56, 0, 0, 0, 8, 5, 69
"/Users/sbukhari/Sandbox/CProgram/ASTanalysis/CodexUserStudyData/Assisted/36deba30-9345-480d-8221-387f5192f83d/parts/gen_list_update_item_at_pos.c", "C", 34, 0, 0, 0, 13, 5, 52
"/Users/sbukhari/Sandbox/CProgram/ASTanalysis/CodexUserStudyData/Assisted/36deba30-9345-480d-8221-387f5192f83d/ref_testsuite.json", "JSON", 0, 323, 0, 0, 0, 1, 324
"/Users/sbukhari/Sandbox/CProgram/ASTanalysis/CodexUserStudyData/Assisted/36deba30-9345-480d-8221-387f5192f83d/ref_testsuite_asan.json", "JSON", 0, 323, 0, 0, 0, 1, 324
"/Users/sbukhari/Sandbox/CProgram/ASTanalysis/CodexUserStudyData/Assisted/36deba30-9345-480d-8221-387f5192f83d/ref_testsuite_asan_noleak.json", "JSON", 0, 323, 0, 0, 0, 1, 324
"/Users/sbukhari/Sandbox/CProgram/ASTanalysis/CodexUserStudyData/Assisted/3cff10bf-23d9-48f4-9f45-96a223a8e2de/api_report.json", "JSON", 0, 14, 0, 0, 0, 1, 15
"/Users/sbukhari/Sandbox/CProgram/ASTanalysis/CodexUserStudyData/Assisted/3cff10bf-23d9-48f4-9f45-96a223a8e2de/list.c", "C", 160, 0, 0, 0, 85, 32, 277
"/Users/sbukhari/Sandbox/CProgram/ASTanalysis/CodexUserStudyData/Assisted/3cff10bf-23d9-48f4-9f45-96a223a8e2de/orig_testsuite.json", "JSON", 0, 92, 0, 0, 0, 1, 93
"/Users/sbukhari/Sandbox/CProgram/ASTanalysis/CodexUserStudyData/Assisted/3cff10bf-23d9-48f4-9f45-96a223a8e2de/orig_testsuite_asan.json", "JSON", 0, 92, 0, 0, 0, 1, 93
"/Users/sbukhari/Sandbox/CProgram/ASTanalysis/CodexUserStudyData/Assisted/3cff10bf-23d9-48f4-9f45-96a223a8e2de/orig_testsuite_asan_noleak.json", "JSON", 0, 92, 0, 0, 0, 1, 93
"/Users/sbukhari/Sandbox/CProgram/ASTanalysis/CodexUserStudyData/Assisted/3cff10bf-23d9-48f4-9f45-96a223a8e2de/parts/gen_list_add_item_at_pos.c", "C", 18, 0, 0, 0, 18, 5, 41
"/Users/sbukhari/Sandbox/CProgram/ASTanalysis/CodexUserStudyData/Assisted/3cff10bf-23d9-48f4-9f45-96a223a8e2de/parts/gen_list_cost_sum.c", "C", 18, 0, 0, 0, 8, 7, 33
"/Users/sbukhari/Sandbox/CProgram/ASTanalysis/CodexUserStudyData/Assisted/3cff10bf-23d9-48f4-9f45-96a223a8e2de/parts/gen_list_deduplicate.c", "C", 18, 0, 0, 0, 10, 6, 34
"/Users/sbukhari/Sandbox/CProgram/ASTanalysis/CodexUserStudyData/Assisted/3cff10bf-23d9-48f4-9f45-96a223a8e2de/parts/gen_list_find_highest_price_item_position.c", "C", 18, 0, 0, 0, 8, 6, 32
"/Users/sbukhari/Sandbox/CProgram/ASTanalysis/CodexUserStudyData/Assisted/3cff10bf-23d9-48f4-9f45-96a223a8e2de/parts/gen_list_init.c", "C", 19, 0, 0, 0, 6, 6, 31
"/Users/sbukhari/Sandbox/CProgram/ASTanalysis/CodexUserStudyData/Assisted/3cff10bf-23d9-48f4-9f45-96a223a8e2de/parts/gen_list_item_to_string.c", "C", 21, 0, 0, 0, 14, 5, 40
"/Users/sbukhari/Sandbox/CProgram/ASTanalysis/CodexUserStudyData/Assisted/3cff10bf-23d9-48f4-9f45-96a223a8e2de/parts/gen_list_load.c", "C", 18, 0, 0, 0, 12, 6, 36
"/Users/sbukhari/Sandbox/CProgram/ASTanalysis/CodexUserStudyData/Assisted/3cff10bf-23d9-48f4-9f45-96a223a8e2de/parts/gen_list_print.c", "C", 28, 0, 0, 0, 10, 5, 43
"/Users/sbukhari/Sandbox/CProgram/ASTanalysis/CodexUserStudyData/Assisted/3cff10bf-23d9-48f4-9f45-96a223a8e2de/parts/gen_list_remove_item_at_pos.c", "C", 18, 0, 0, 0, 8, 5, 31
"/Users/sbukhari/Sandbox/CProgram/ASTanalysis/CodexUserStudyData/Assisted/3cff10bf-23d9-48f4-9f45-96a223a8e2de/parts/gen_list_save.c", "C", 18, 0, 0, 0, 11, 6, 35
"/Users/sbukhari/Sandbox/CProgram/ASTanalysis/CodexUserStudyData/Assisted/3cff10bf-23d9-48f4-9f45-96a223a8e2de/parts/gen_list_swap_item_positions.c", "C", 17, 0, 0, 0, 8, 6, 31
"/Users/sbukhari/Sandbox/CProgram/ASTanalysis/CodexUserStudyData/Assisted/3cff10bf-23d9-48f4-9f45-96a223a8e2de/parts/gen_list_update_item_at_pos.c", "C", 37, 0, 0, 0, 13, 5, 55
"/Users/sbukhari/Sandbox/CProgram/ASTanalysis/CodexUserStudyData/Assisted/3cff10bf-23d9-48f4-9f45-96a223a8e2de/ref_testsuite.json", "JSON", 0, 323, 0, 0, 0, 1, 324
"/Users/sbukhari/Sandbox/CProgram/ASTanalysis/CodexUserStudyData/Assisted/3cff10bf-23d9-48f4-9f45-96a223a8e2de/ref_testsuite_asan.json", "JSON", 0, 323, 0, 0, 0, 1, 324
"/Users/sbukhari/Sandbox/CProgram/ASTanalysis/CodexUserStudyData/Assisted/3cff10bf-23d9-48f4-9f45-96a223a8e2de/ref_testsuite_asan_noleak.json", "JSON", 0, 323, 0, 0, 0, 1, 324
"/Users/sbukhari/Sandbox/CProgram/ASTanalysis/CodexUserStudyData/Assisted/514e6c1d-f935-474d-899e-96e27d5babd3/api_report.json", "JSON", 0, 14, 0, 0, 0, 1, 15
"/Users/sbukhari/Sandbox/CProgram/ASTanalysis/CodexUserStudyData/Assisted/514e6c1d-f935-474d-899e-96e27d5babd3/list.c", "C", 87, 0, 0, 0, 85, 21, 193
"/Users/sbukhari/Sandbox/CProgram/ASTanalysis/CodexUserStudyData/Assisted/514e6c1d-f935-474d-899e-96e27d5babd3/orig_testsuite.json", "JSON", 0, 92, 0, 0, 0, 1, 93
"/Users/sbukhari/Sandbox/CProgram/ASTanalysis/CodexUserStudyData/Assisted/514e6c1d-f935-474d-899e-96e27d5babd3/orig_testsuite_asan.json", "JSON", 0, 92, 0, 0, 0, 1, 93
"/Users/sbukhari/Sandbox/CProgram/ASTanalysis/CodexUserStudyData/Assisted/514e6c1d-f935-474d-899e-96e27d5babd3/orig_testsuite_asan_noleak.json", "JSON", 0, 92, 0, 0, 0, 1, 93
"/Users/sbukhari/Sandbox/CProgram/ASTanalysis/CodexUserStudyData/Assisted/514e6c1d-f935-474d-899e-96e27d5babd3/parts/gen_list_add_item_at_pos.c", "C", 35, 0, 0, 0, 20, 5, 60
"/Users/sbukhari/Sandbox/CProgram/ASTanalysis/CodexUserStudyData/Assisted/514e6c1d-f935-474d-899e-96e27d5babd3/parts/gen_list_cost_sum.c", "C", 18, 0, 0, 0, 8, 5, 31
"/Users/sbukhari/Sandbox/CProgram/ASTanalysis/CodexUserStudyData/Assisted/514e6c1d-f935-474d-899e-96e27d5babd3/parts/gen_list_deduplicate.c", "C", 18, 0, 0, 0, 10, 5, 33
"/Users/sbukhari/Sandbox/CProgram/ASTanalysis/CodexUserStudyData/Assisted/514e6c1d-f935-474d-899e-96e27d5babd3/parts/gen_list_find_highest_price_item_position.c", "C", 18, 0, 0, 0, 8, 5, 31
"/Users/sbukhari/Sandbox/CProgram/ASTanalysis/CodexUserStudyData/Assisted/514e6c1d-f935-474d-899e-96e27d5babd3/parts/gen_list_init.c", "C", 19, 0, 0, 0, 6, 6, 31
"/Users/sbukhari/Sandbox/CProgram/ASTanalysis/CodexUserStudyData/Assisted/514e6c1d-f935-474d-899e-96e27d5babd3/parts/gen_list_item_to_string.c", "C", 20, 0, 0, 0, 23, 8, 51
"/Users/sbukhari/Sandbox/CProgram/ASTanalysis/CodexUserStudyData/Assisted/514e6c1d-f935-474d-899e-96e27d5babd3/parts/gen_list_load.c", "C", 18, 0, 0, 0, 12, 5, 35
"/Users/sbukhari/Sandbox/CProgram/ASTanalysis/CodexUserStudyData/Assisted/514e6c1d-f935-474d-899e-96e27d5babd3/parts/gen_list_print.c", "C", 26, 0, 0, 0, 23, 5, 54
"/Users/sbukhari/Sandbox/CProgram/ASTanalysis/CodexUserStudyData/Assisted/514e6c1d-f935-474d-899e-96e27d5babd3/parts/gen_list_remove_item_at_pos.c", "C", 18, 0, 0, 0, 8, 5, 31
"/Users/sbukhari/Sandbox/CProgram/ASTanalysis/CodexUserStudyData/Assisted/514e6c1d-f935-474d-899e-96e27d5babd3/parts/gen_list_save.c", "C", 18, 0, 0, 0, 11, 5, 34
"/Users/sbukhari/Sandbox/CProgram/ASTanalysis/CodexUserStudyData/Assisted/514e6c1d-f935-474d-899e-96e27d5babd3/parts/gen_list_swap_item_positions.c", "C", 17, 0, 0, 0, 8, 5, 30
"/Users/sbukhari/Sandbox/CProgram/ASTanalysis/CodexUserStudyData/Assisted/514e6c1d-f935-474d-899e-96e27d5babd3/parts/gen_list_update_item_at_pos.c", "C", 17, 0, 0, 0, 8, 5, 30
"/Users/sbukhari/Sandbox/CProgram/ASTanalysis/CodexUserStudyData/Assisted/514e6c1d-f935-474d-899e-96e27d5babd3/ref_testsuite.json", "JSON", 0, 323, 0, 0, 0, 1, 324
"/Users/sbukhari/Sandbox/CProgram/ASTanalysis/CodexUserStudyData/Assisted/514e6c1d-f935-474d-899e-96e27d5babd3/ref_testsuite_asan.json", "JSON", 0, 323, 0, 0, 0, 1, 324
"/Users/sbukhari/Sandbox/CProgram/ASTanalysis/CodexUserStudyData/Assisted/514e6c1d-f935-474d-899e-96e27d5babd3/ref_testsuite_asan_noleak.json", "JSON", 0, 323, 0, 0, 0, 1, 324
"/Users/sbukhari/Sandbox/CProgram/ASTanalysis/CodexUserStudyData/Assisted/5a790fe9-4950-4f24-903a-a7440f7f826f/api_report.json", "JSON", 0, 14, 0, 0, 0, 1, 15
"/Users/sbukhari/Sandbox/CProgram/ASTanalysis/CodexUserStudyData/Assisted/5a790fe9-4950-4f24-903a-a7440f7f826f/list.c", "C", 162, 0, 0, 0, 76, 21, 259
"/Users/sbukhari/Sandbox/CProgram/ASTanalysis/CodexUserStudyData/Assisted/5a790fe9-4950-4f24-903a-a7440f7f826f/orig_testsuite.json", "JSON", 0, 92, 0, 0, 0, 1, 93
"/Users/sbukhari/Sandbox/CProgram/ASTanalysis/CodexUserStudyData/Assisted/5a790fe9-4950-4f24-903a-a7440f7f826f/orig_testsuite_asan.json", "JSON", 0, 92, 0, 0, 0, 1, 93
"/Users/sbukhari/Sandbox/CProgram/ASTanalysis/CodexUserStudyData/Assisted/5a790fe9-4950-4f24-903a-a7440f7f826f/orig_testsuite_asan_noleak.json", "JSON", 0, 92, 0, 0, 0, 1, 93
"/Users/sbukhari/Sandbox/CProgram/ASTanalysis/CodexUserStudyData/Assisted/5a790fe9-4950-4f24-903a-a7440f7f826f/parts/gen_list_add_item_at_pos.c", "C", 47, 0, 0, 0, 18, 5, 70
"/Users/sbukhari/Sandbox/CProgram/ASTanalysis/CodexUserStudyData/Assisted/5a790fe9-4950-4f24-903a-a7440f7f826f/parts/gen_list_cost_sum.c", "C", 23, 0, 0, 0, 10, 5, 38
"/Users/sbukhari/Sandbox/CProgram/ASTanalysis/CodexUserStudyData/Assisted/5a790fe9-4950-4f24-903a-a7440f7f826f/parts/gen_list_deduplicate.c", "C", 18, 0, 0, 0, 10, 5, 33
"/Users/sbukhari/Sandbox/CProgram/ASTanalysis/CodexUserStudyData/Assisted/5a790fe9-4950-4f24-903a-a7440f7f826f/parts/gen_list_find_highest_price_item_position.c", "C", 29, 0, 0, 0, 9, 6, 44
"/Users/sbukhari/Sandbox/CProgram/ASTanalysis/CodexUserStudyData/Assisted/5a790fe9-4950-4f24-903a-a7440f7f826f/parts/gen_list_init.c", "C", 19, 0, 0, 0, 6, 6, 31
"/Users/sbukhari/Sandbox/CProgram/ASTanalysis/CodexUserStudyData/Assisted/5a790fe9-4950-4f24-903a-a7440f7f826f/parts/gen_list_item_to_string.c", "C", 18, 0, 0, 0, 11, 6, 35
"/Users/sbukhari/Sandbox/CProgram/ASTanalysis/CodexUserStudyData/Assisted/5a790fe9-4950-4f24-903a-a7440f7f826f/parts/gen_list_load.c", "C", 18, 0, 0, 0, 12, 5, 35
"/Users/sbukhari/Sandbox/CProgram/ASTanalysis/CodexUserStudyData/Assisted/5a790fe9-4950-4f24-903a-a7440f7f826f/parts/gen_list_print.c", "C", 25, 0, 0, 0, 22, 6, 53
"/Users/sbukhari/Sandbox/CProgram/ASTanalysis/CodexUserStudyData/Assisted/5a790fe9-4950-4f24-903a-a7440f7f826f/parts/gen_list_remove_item_at_pos.c", "C", 28, 0, 0, 0, 13, 5, 46
"/Users/sbukhari/Sandbox/CProgram/ASTanalysis/CodexUserStudyData/Assisted/5a790fe9-4950-4f24-903a-a7440f7f826f/parts/gen_list_save.c", "C", 18, 0, 0, 0, 11, 5, 34
"/Users/sbukhari/Sandbox/CProgram/ASTanalysis/CodexUserStudyData/Assisted/5a790fe9-4950-4f24-903a-a7440f7f826f/parts/gen_list_swap_item_positions.c", "C", 45, 0, 0, 0, 12, 6, 63
"/Users/sbukhari/Sandbox/CProgram/ASTanalysis/CodexUserStudyData/Assisted/5a790fe9-4950-4f24-903a-a7440f7f826f/parts/gen_list_update_item_at_pos.c", "C", 29, 0, 0, 0, 14, 5, 48
"/Users/sbukhari/Sandbox/CProgram/ASTanalysis/CodexUserStudyData/Assisted/5a790fe9-4950-4f24-903a-a7440f7f826f/ref_testsuite.json", "JSON", 0, 323, 0, 0, 0, 1, 324
"/Users/sbukhari/Sandbox/CProgram/ASTanalysis/CodexUserStudyData/Assisted/5a790fe9-4950-4f24-903a-a7440f7f826f/ref_testsuite_asan.json", "JSON", 0, 323, 0, 0, 0, 1, 324
"/Users/sbukhari/Sandbox/CProgram/ASTanalysis/CodexUserStudyData/Assisted/5a790fe9-4950-4f24-903a-a7440f7f826f/ref_testsuite_asan_noleak.json", "JSON", 0, 323, 0, 0, 0, 1, 324
"/Users/sbukhari/Sandbox/CProgram/ASTanalysis/CodexUserStudyData/Assisted/6c026517-fcff-496b-a8d2-3b99e3714fa4/api_report.json", "JSON", 0, 14, 0, 0, 0, 1, 15
"/Users/sbukhari/Sandbox/CProgram/ASTanalysis/CodexUserStudyData/Assisted/6c026517-fcff-496b-a8d2-3b99e3714fa4/list.c", "C", 69, 0, 0, 0, 85, 23, 177
"/Users/sbukhari/Sandbox/CProgram/ASTanalysis/CodexUserStudyData/Assisted/6c026517-fcff-496b-a8d2-3b99e3714fa4/orig_testsuite.json", "JSON", 0, 92, 0, 0, 0, 1, 93
"/Users/sbukhari/Sandbox/CProgram/ASTanalysis/CodexUserStudyData/Assisted/6c026517-fcff-496b-a8d2-3b99e3714fa4/orig_testsuite_asan.json", "JSON", 0, 92, 0, 0, 0, 1, 93
"/Users/sbukhari/Sandbox/CProgram/ASTanalysis/CodexUserStudyData/Assisted/6c026517-fcff-496b-a8d2-3b99e3714fa4/orig_testsuite_asan_noleak.json", "JSON", 0, 92, 0, 0, 0, 1, 93
"/Users/sbukhari/Sandbox/CProgram/ASTanalysis/CodexUserStudyData/Assisted/6c026517-fcff-496b-a8d2-3b99e3714fa4/parts/gen_list_add_item_at_pos.c", "C", 18, 0, 0, 0, 18, 5, 41
"/Users/sbukhari/Sandbox/CProgram/ASTanalysis/CodexUserStudyData/Assisted/6c026517-fcff-496b-a8d2-3b99e3714fa4/parts/gen_list_cost_sum.c", "C", 18, 0, 0, 0, 8, 5, 31
"/Users/sbukhari/Sandbox/CProgram/ASTanalysis/CodexUserStudyData/Assisted/6c026517-fcff-496b-a8d2-3b99e3714fa4/parts/gen_list_deduplicate.c", "C", 18, 0, 0, 0, 11, 5, 34
"/Users/sbukhari/Sandbox/CProgram/ASTanalysis/CodexUserStudyData/Assisted/6c026517-fcff-496b-a8d2-3b99e3714fa4/parts/gen_list_find_highest_price_item_position.c", "C", 18, 0, 0, 0, 8, 5, 31
"/Users/sbukhari/Sandbox/CProgram/ASTanalysis/CodexUserStudyData/Assisted/6c026517-fcff-496b-a8d2-3b99e3714fa4/parts/gen_list_init.c", "C", 19, 0, 0, 0, 7, 6, 32
"/Users/sbukhari/Sandbox/CProgram/ASTanalysis/CodexUserStudyData/Assisted/6c026517-fcff-496b-a8d2-3b99e3714fa4/parts/gen_list_item_to_string.c", "C", 17, 0, 0, 0, 11, 5, 33
"/Users/sbukhari/Sandbox/CProgram/ASTanalysis/CodexUserStudyData/Assisted/6c026517-fcff-496b-a8d2-3b99e3714fa4/parts/gen_list_load.c", "C", 18, 0, 0, 0, 14, 7, 39
"/Users/sbukhari/Sandbox/CProgram/ASTanalysis/CodexUserStudyData/Assisted/6c026517-fcff-496b-a8d2-3b99e3714fa4/parts/gen_list_print.c", "C", 17, 0, 0, 0, 20, 5, 42
"/Users/sbukhari/Sandbox/CProgram/ASTanalysis/CodexUserStudyData/Assisted/6c026517-fcff-496b-a8d2-3b99e3714fa4/parts/gen_list_remove_item_at_pos.c", "C", 18, 0, 0, 0, 8, 5, 31
"/Users/sbukhari/Sandbox/CProgram/ASTanalysis/CodexUserStudyData/Assisted/6c026517-fcff-496b-a8d2-3b99e3714fa4/parts/gen_list_save.c", "C", 18, 0, 0, 0, 11, 5, 34
"/Users/sbukhari/Sandbox/CProgram/ASTanalysis/CodexUserStudyData/Assisted/6c026517-fcff-496b-a8d2-3b99e3714fa4/parts/gen_list_swap_item_positions.c", "C", 17, 0, 0, 0, 8, 5, 30
"/Users/sbukhari/Sandbox/CProgram/ASTanalysis/CodexUserStudyData/Assisted/6c026517-fcff-496b-a8d2-3b99e3714fa4/parts/gen_list_update_item_at_pos.c", "C", 17, 0, 0, 0, 8, 5, 30
"/Users/sbukhari/Sandbox/CProgram/ASTanalysis/CodexUserStudyData/Assisted/6c026517-fcff-496b-a8d2-3b99e3714fa4/ref_testsuite.json", "JSON", 0, 323, 0, 0, 0, 1, 324
"/Users/sbukhari/Sandbox/CProgram/ASTanalysis/CodexUserStudyData/Assisted/6c026517-fcff-496b-a8d2-3b99e3714fa4/ref_testsuite_asan.json", "JSON", 0, 323, 0, 0, 0, 1, 324
"/Users/sbukhari/Sandbox/CProgram/ASTanalysis/CodexUserStudyData/Assisted/6c026517-fcff-496b-a8d2-3b99e3714fa4/ref_testsuite_asan_noleak.json", "JSON", 0, 323, 0, 0, 0, 1, 324
"/Users/sbukhari/Sandbox/CProgram/ASTanalysis/CodexUserStudyData/Assisted/7193a853-f8dd-423a-90be-39d0023d598e/api_report.json", "JSON", 0, 14, 0, 0, 0, 1, 15
"/Users/sbukhari/Sandbox/CProgram/ASTanalysis/CodexUserStudyData/Assisted/7193a853-f8dd-423a-90be-39d0023d598e/list.c", "C", 193, 0, 0, 0, 72, 52, 317
"/Users/sbukhari/Sandbox/CProgram/ASTanalysis/CodexUserStudyData/Assisted/7193a853-f8dd-423a-90be-39d0023d598e/orig_testsuite.json", "JSON", 0, 92, 0, 0, 0, 1, 93
"/Users/sbukhari/Sandbox/CProgram/ASTanalysis/CodexUserStudyData/Assisted/7193a853-f8dd-423a-90be-39d0023d598e/orig_testsuite_asan.json", "JSON", 0, 92, 0, 0, 0, 1, 93
"/Users/sbukhari/Sandbox/CProgram/ASTanalysis/CodexUserStudyData/Assisted/7193a853-f8dd-423a-90be-39d0023d598e/orig_testsuite_asan_noleak.json", "JSON", 0, 92, 0, 0, 0, 1, 93
"/Users/sbukhari/Sandbox/CProgram/ASTanalysis/CodexUserStudyData/Assisted/7193a853-f8dd-423a-90be-39d0023d598e/parts/gen_list_add_item_at_pos.c", "C", 42, 0, 0, 0, 20, 11, 73
"/Users/sbukhari/Sandbox/CProgram/ASTanalysis/CodexUserStudyData/Assisted/7193a853-f8dd-423a-90be-39d0023d598e/parts/gen_list_cost_sum.c", "C", 27, 0, 0, 0, 9, 10, 46
"/Users/sbukhari/Sandbox/CProgram/ASTanalysis/CodexUserStudyData/Assisted/7193a853-f8dd-423a-90be-39d0023d598e/parts/gen_list_deduplicate.c", "C", 22, 0, 0, 0, 10, 7, 39
"/Users/sbukhari/Sandbox/CProgram/ASTanalysis/CodexUserStudyData/Assisted/7193a853-f8dd-423a-90be-39d0023d598e/parts/gen_list_find_highest_price_item_position.c", "C", 30, 0, 0, 0, 9, 9, 48
"/Users/sbukhari/Sandbox/CProgram/ASTanalysis/CodexUserStudyData/Assisted/7193a853-f8dd-423a-90be-39d0023d598e/parts/gen_list_init.c", "C", 19, 0, 0, 0, 6, 6, 31
"/Users/sbukhari/Sandbox/CProgram/ASTanalysis/CodexUserStudyData/Assisted/7193a853-f8dd-423a-90be-39d0023d598e/parts/gen_list_item_to_string.c", "C", 18, 0, 0, 0, 14, 6, 38
"/Users/sbukhari/Sandbox/CProgram/ASTanalysis/CodexUserStudyData/Assisted/7193a853-f8dd-423a-90be-39d0023d598e/parts/gen_list_load.c", "C", 18, 0, 0, 0, 11, 5, 34
"/Users/sbukhari/Sandbox/CProgram/ASTanalysis/CodexUserStudyData/Assisted/7193a853-f8dd-423a-90be-39d0023d598e/parts/gen_list_print.c", "C", 26, 0, 0, 0, 20, 5, 51
"/Users/sbukhari/Sandbox/CProgram/ASTanalysis/CodexUserStudyData/Assisted/7193a853-f8dd-423a-90be-39d0023d598e/parts/gen_list_remove_item_at_pos.c", "C", 38, 0, 0, 0, 10, 10, 58
"/Users/sbukhari/Sandbox/CProgram/ASTanalysis/CodexUserStudyData/Assisted/7193a853-f8dd-423a-90be-39d0023d598e/parts/gen_list_save.c", "C", 18, 0, 0, 0, 11, 7, 36
"/Users/sbukhari/Sandbox/CProgram/ASTanalysis/CodexUserStudyData/Assisted/7193a853-f8dd-423a-90be-39d0023d598e/parts/gen_list_swap_item_positions.c", "C", 58, 0, 0, 0, 13, 12, 83
"/Users/sbukhari/Sandbox/CProgram/ASTanalysis/CodexUserStudyData/Assisted/7193a853-f8dd-423a-90be-39d0023d598e/parts/gen_list_update_item_at_pos.c", "C", 32, 0, 0, 0, 11, 8, 51
"/Users/sbukhari/Sandbox/CProgram/ASTanalysis/CodexUserStudyData/Assisted/7193a853-f8dd-423a-90be-39d0023d598e/ref_testsuite.json", "JSON", 0, 323, 0, 0, 0, 1, 324
"/Users/sbukhari/Sandbox/CProgram/ASTanalysis/CodexUserStudyData/Assisted/7193a853-f8dd-423a-90be-39d0023d598e/ref_testsuite_asan.json", "JSON", 0, 323, 0, 0, 0, 1, 324
"/Users/sbukhari/Sandbox/CProgram/ASTanalysis/CodexUserStudyData/Assisted/7193a853-f8dd-423a-90be-39d0023d598e/ref_testsuite_asan_noleak.json", "JSON", 0, 323, 0, 0, 0, 1, 324
"/Users/sbukhari/Sandbox/CProgram/ASTanalysis/CodexUserStudyData/Assisted/74bd8618-cc17-42a6-8657-abebc4b6b500/api_report.json", "JSON", 0, 14, 0, 0, 0, 1, 15
"/Users/sbukhari/Sandbox/CProgram/ASTanalysis/CodexUserStudyData/Assisted/74bd8618-cc17-42a6-8657-abebc4b6b500/list.c", "C", 147, 0, 0, 0, 84, 26, 257
"/Users/sbukhari/Sandbox/CProgram/ASTanalysis/CodexUserStudyData/Assisted/74bd8618-cc17-42a6-8657-abebc4b6b500/orig_testsuite.json", "JSON", 0, 92, 0, 0, 0, 1, 93
"/Users/sbukhari/Sandbox/CProgram/ASTanalysis/CodexUserStudyData/Assisted/74bd8618-cc17-42a6-8657-abebc4b6b500/orig_testsuite_asan.json", "JSON", 0, 92, 0, 0, 0, 1, 93
"/Users/sbukhari/Sandbox/CProgram/ASTanalysis/CodexUserStudyData/Assisted/74bd8618-cc17-42a6-8657-abebc4b6b500/orig_testsuite_asan_noleak.json", "JSON", 0, 92, 0, 0, 0, 1, 93
"/Users/sbukhari/Sandbox/CProgram/ASTanalysis/CodexUserStudyData/Assisted/74bd8618-cc17-42a6-8657-abebc4b6b500/parts/gen_list_add_item_at_pos.c", "C", 35, 0, 0, 0, 21, 8, 64
"/Users/sbukhari/Sandbox/CProgram/ASTanalysis/CodexUserStudyData/Assisted/74bd8618-cc17-42a6-8657-abebc4b6b500/parts/gen_list_cost_sum.c", "C", 18, 0, 0, 0, 8, 5, 31
"/Users/sbukhari/Sandbox/CProgram/ASTanalysis/CodexUserStudyData/Assisted/74bd8618-cc17-42a6-8657-abebc4b6b500/parts/gen_list_deduplicate.c", "C", 18, 0, 0, 0, 10, 5, 33
"/Users/sbukhari/Sandbox/CProgram/ASTanalysis/CodexUserStudyData/Assisted/74bd8618-cc17-42a6-8657-abebc4b6b500/parts/gen_list_find_highest_price_item_position.c", "C", 18, 0, 0, 0, 8, 5, 31
"/Users/sbukhari/Sandbox/CProgram/ASTanalysis/CodexUserStudyData/Assisted/74bd8618-cc17-42a6-8657-abebc4b6b500/parts/gen_list_init.c", "C", 19, 0, 0, 0, 6, 6, 31
"/Users/sbukhari/Sandbox/CProgram/ASTanalysis/CodexUserStudyData/Assisted/74bd8618-cc17-42a6-8657-abebc4b6b500/parts/gen_list_item_to_string.c", "C", 26, 0, 0, 0, 18, 6, 50
"/Users/sbukhari/Sandbox/CProgram/ASTanalysis/CodexUserStudyData/Assisted/74bd8618-cc17-42a6-8657-abebc4b6b500/parts/gen_list_load.c", "C", 18, 0, 0, 0, 12, 5, 35
"/Users/sbukhari/Sandbox/CProgram/ASTanalysis/CodexUserStudyData/Assisted/74bd8618-cc17-42a6-8657-abebc4b6b500/parts/gen_list_print.c", "C", 23, 0, 0, 0, 23, 5, 51
"/Users/sbukhari/Sandbox/CProgram/ASTanalysis/CodexUserStudyData/Assisted/74bd8618-cc17-42a6-8657-abebc4b6b500/parts/gen_list_remove_item_at_pos.c", "C", 33, 0, 0, 0, 13, 6, 52
"/Users/sbukhari/Sandbox/CProgram/ASTanalysis/CodexUserStudyData/Assisted/74bd8618-cc17-42a6-8657-abebc4b6b500/parts/gen_list_save.c", "C", 18, 0, 0, 0, 11, 5, 34
"/Users/sbukhari/Sandbox/CProgram/ASTanalysis/CodexUserStudyData/Assisted/74bd8618-cc17-42a6-8657-abebc4b6b500/parts/gen_list_swap_item_positions.c", "C", 44, 0, 0, 0, 12, 6, 62
"/Users/sbukhari/Sandbox/CProgram/ASTanalysis/CodexUserStudyData/Assisted/74bd8618-cc17-42a6-8657-abebc4b6b500/parts/gen_list_update_item_at_pos.c", "C", 32, 0, 0, 0, 12, 6, 50
"/Users/sbukhari/Sandbox/CProgram/ASTanalysis/CodexUserStudyData/Assisted/74bd8618-cc17-42a6-8657-abebc4b6b500/ref_testsuite.json", "JSON", 0, 323, 0, 0, 0, 1, 324
"/Users/sbukhari/Sandbox/CProgram/ASTanalysis/CodexUserStudyData/Assisted/74bd8618-cc17-42a6-8657-abebc4b6b500/ref_testsuite_asan.json", "JSON", 0, 323, 0, 0, 0, 1, 324
"/Users/sbukhari/Sandbox/CProgram/ASTanalysis/CodexUserStudyData/Assisted/74bd8618-cc17-42a6-8657-abebc4b6b500/ref_testsuite_asan_noleak.json", "JSON", 0, 323, 0, 0, 0, 1, 324
"/Users/sbukhari/Sandbox/CProgram/ASTanalysis/CodexUserStudyData/Assisted/925cb076-503f-4a8e-b8d9-0aac9efe5955/api_report.json", "JSON", 0, 14, 0, 0, 0, 1, 15
"/Users/sbukhari/Sandbox/CProgram/ASTanalysis/CodexUserStudyData/Assisted/925cb076-503f-4a8e-b8d9-0aac9efe5955/list.c", "C", 206, 0, 0, 0, 73, 62, 341
"/Users/sbukhari/Sandbox/CProgram/ASTanalysis/CodexUserStudyData/Assisted/925cb076-503f-4a8e-b8d9-0aac9efe5955/orig_testsuite.json", "JSON", 0, 92, 0, 0, 0, 1, 93
"/Users/sbukhari/Sandbox/CProgram/ASTanalysis/CodexUserStudyData/Assisted/925cb076-503f-4a8e-b8d9-0aac9efe5955/orig_testsuite_asan.json", "JSON", 0, 92, 0, 0, 0, 1, 93
"/Users/sbukhari/Sandbox/CProgram/ASTanalysis/CodexUserStudyData/Assisted/925cb076-503f-4a8e-b8d9-0aac9efe5955/orig_testsuite_asan_noleak.json", "JSON", 0, 92, 0, 0, 0, 1, 93
"/Users/sbukhari/Sandbox/CProgram/ASTanalysis/CodexUserStudyData/Assisted/925cb076-503f-4a8e-b8d9-0aac9efe5955/parts/gen_list_add_item_at_pos.c", "C", 55, 0, 0, 0, 18, 5, 78
"/Users/sbukhari/Sandbox/CProgram/ASTanalysis/CodexUserStudyData/Assisted/925cb076-503f-4a8e-b8d9-0aac9efe5955/parts/gen_list_cost_sum.c", "C", 25, 0, 0, 0, 9, 8, 42
"/Users/sbukhari/Sandbox/CProgram/ASTanalysis/CodexUserStudyData/Assisted/925cb076-503f-4a8e-b8d9-0aac9efe5955/parts/gen_list_deduplicate.c", "C", 18, 0, 0, 0, 10, 5, 33
"/Users/sbukhari/Sandbox/CProgram/ASTanalysis/CodexUserStudyData/Assisted/925cb076-503f-4a8e-b8d9-0aac9efe5955/parts/gen_list_find_highest_price_item_position.c", "C", 30, 0, 0, 0, 9, 8, 47
"/Users/sbukhari/Sandbox/CProgram/ASTanalysis/CodexUserStudyData/Assisted/925cb076-503f-4a8e-b8d9-0aac9efe5955/parts/gen_list_init.c", "C", 27, 0, 0, 0, 6, 7, 40
"/Users/sbukhari/Sandbox/CProgram/ASTanalysis/CodexUserStudyData/Assisted/925cb076-503f-4a8e-b8d9-0aac9efe5955/parts/gen_list_item_to_string.c", "C", 33, 0, 0, 0, 16, 6, 55
"/Users/sbukhari/Sandbox/CProgram/ASTanalysis/CodexUserStudyData/Assisted/925cb076-503f-4a8e-b8d9-0aac9efe5955/parts/gen_list_load.c", "C", 18, 0, 0, 0, 10, 5, 33
"/Users/sbukhari/Sandbox/CProgram/ASTanalysis/CodexUserStudyData/Assisted/925cb076-503f-4a8e-b8d9-0aac9efe5955/parts/gen_list_print.c", "C", 29, 0, 0, 0, 20, 5, 54
"/Users/sbukhari/Sandbox/CProgram/ASTanalysis/CodexUserStudyData/Assisted/925cb076-503f-4a8e-b8d9-0aac9efe5955/parts/gen_list_remove_item_at_pos.c", "C", 24, 0, 0, 0, 13, 7, 44
"/Users/sbukhari/Sandbox/CProgram/ASTanalysis/CodexUserStudyData/Assisted/925cb076-503f-4a8e-b8d9-0aac9efe5955/parts/gen_list_save.c", "C", 29, 0, 0, 0, 14, 8, 51
"/Users/sbukhari/Sandbox/CProgram/ASTanalysis/CodexUserStudyData/Assisted/925cb076-503f-4a8e-b8d9-0aac9efe5955/parts/gen_list_swap_item_positions.c", "C", 34, 0, 0, 0, 15, 10, 59
"/Users/sbukhari/Sandbox/CProgram/ASTanalysis/CodexUserStudyData/Assisted/925cb076-503f-4a8e-b8d9-0aac9efe5955/parts/gen_list_update_item_at_pos.c", "C", 24, 0, 0, 0, 13, 7, 44
"/Users/sbukhari/Sandbox/CProgram/ASTanalysis/CodexUserStudyData/Assisted/925cb076-503f-4a8e-b8d9-0aac9efe5955/ref_testsuite.json", "JSON", 0, 323, 0, 0, 0, 1, 324
"/Users/sbukhari/Sandbox/CProgram/ASTanalysis/CodexUserStudyData/Assisted/925cb076-503f-4a8e-b8d9-0aac9efe5955/ref_testsuite_asan.json", "JSON", 0, 323, 0, 0, 0, 1, 324
"/Users/sbukhari/Sandbox/CProgram/ASTanalysis/CodexUserStudyData/Assisted/925cb076-503f-4a8e-b8d9-0aac9efe5955/ref_testsuite_asan_noleak.json", "JSON", 0, 323, 0, 0, 0, 1, 324
"/Users/sbukhari/Sandbox/CProgram/ASTanalysis/CodexUserStudyData/Assisted/a3edd088-a9ab-4b80-ae98-01ffcfca615b/api_report.json", "JSON", 0, 14, 0, 0, 0, 1, 15
"/Users/sbukhari/Sandbox/CProgram/ASTanalysis/CodexUserStudyData/Assisted/a3edd088-a9ab-4b80-ae98-01ffcfca615b/list.c", "C", 122, 0, 0, 0, 85, 28, 235
"/Users/sbukhari/Sandbox/CProgram/ASTanalysis/CodexUserStudyData/Assisted/a3edd088-a9ab-4b80-ae98-01ffcfca615b/orig_testsuite.json", "JSON", 0, 92, 0, 0, 0, 1, 93
"/Users/sbukhari/Sandbox/CProgram/ASTanalysis/CodexUserStudyData/Assisted/a3edd088-a9ab-4b80-ae98-01ffcfca615b/orig_testsuite_asan.json", "JSON", 0, 92, 0, 0, 0, 1, 93
"/Users/sbukhari/Sandbox/CProgram/ASTanalysis/CodexUserStudyData/Assisted/a3edd088-a9ab-4b80-ae98-01ffcfca615b/orig_testsuite_asan_noleak.json", "JSON", 0, 92, 0, 0, 0, 1, 93
"/Users/sbukhari/Sandbox/CProgram/ASTanalysis/CodexUserStudyData/Assisted/a3edd088-a9ab-4b80-ae98-01ffcfca615b/parts/gen_list_add_item_at_pos.c", "C", 33, 0, 0, 0, 23, 5, 61
"/Users/sbukhari/Sandbox/CProgram/ASTanalysis/CodexUserStudyData/Assisted/a3edd088-a9ab-4b80-ae98-01ffcfca615b/parts/gen_list_cost_sum.c", "C", 18, 0, 0, 0, 8, 5, 31
"/Users/sbukhari/Sandbox/CProgram/ASTanalysis/CodexUserStudyData/Assisted/a3edd088-a9ab-4b80-ae98-01ffcfca615b/parts/gen_list_deduplicate.c", "C", 18, 0, 0, 0, 10, 5, 33
"/Users/sbukhari/Sandbox/CProgram/ASTanalysis/CodexUserStudyData/Assisted/a3edd088-a9ab-4b80-ae98-01ffcfca615b/parts/gen_list_find_highest_price_item_position.c", "C", 18, 0, 0, 0, 8, 5, 31
"/Users/sbukhari/Sandbox/CProgram/ASTanalysis/CodexUserStudyData/Assisted/a3edd088-a9ab-4b80-ae98-01ffcfca615b/parts/gen_list_init.c", "C", 19, 0, 0, 0, 6, 6, 31
"/Users/sbukhari/Sandbox/CProgram/ASTanalysis/CodexUserStudyData/Assisted/a3edd088-a9ab-4b80-ae98-01ffcfca615b/parts/gen_list_item_to_string.c", "C", 17, 0, 0, 0, 11, 5, 33
"/Users/sbukhari/Sandbox/CProgram/ASTanalysis/CodexUserStudyData/Assisted/a3edd088-a9ab-4b80-ae98-01ffcfca615b/parts/gen_list_load.c", "C", 18, 0, 0, 0, 12, 5, 35
"/Users/sbukhari/Sandbox/CProgram/ASTanalysis/CodexUserStudyData/Assisted/a3edd088-a9ab-4b80-ae98-01ffcfca615b/parts/gen_list_print.c", "C", 23, 0, 0, 0, 20, 5, 48
"/Users/sbukhari/Sandbox/CProgram/ASTanalysis/CodexUserStudyData/Assisted/a3edd088-a9ab-4b80-ae98-01ffcfca615b/parts/gen_list_remove_item_at_pos.c", "C", 18, 0, 0, 0, 8, 5, 31
"/Users/sbukhari/Sandbox/CProgram/ASTanalysis/CodexUserStudyData/Assisted/a3edd088-a9ab-4b80-ae98-01ffcfca615b/parts/gen_list_save.c", "C", 18, 0, 0, 0, 11, 5, 34
"/Users/sbukhari/Sandbox/CProgram/ASTanalysis/CodexUserStudyData/Assisted/a3edd088-a9ab-4b80-ae98-01ffcfca615b/parts/gen_list_swap_item_positions.c", "C", 17, 0, 0, 0, 8, 5, 30
"/Users/sbukhari/Sandbox/CProgram/ASTanalysis/CodexUserStudyData/Assisted/a3edd088-a9ab-4b80-ae98-01ffcfca615b/parts/gen_list_update_item_at_pos.c", "C", 28, 0, 0, 0, 14, 6, 48
"/Users/sbukhari/Sandbox/CProgram/ASTanalysis/CodexUserStudyData/Assisted/a3edd088-a9ab-4b80-ae98-01ffcfca615b/ref_testsuite.json", "JSON", 0, 323, 0, 0, 0, 1, 324
"/Users/sbukhari/Sandbox/CProgram/ASTanalysis/CodexUserStudyData/Assisted/a3edd088-a9ab-4b80-ae98-01ffcfca615b/ref_testsuite_asan.json", "JSON", 0, 323, 0, 0, 0, 1, 324
"/Users/sbukhari/Sandbox/CProgram/ASTanalysis/CodexUserStudyData/Assisted/a3edd088-a9ab-4b80-ae98-01ffcfca615b/ref_testsuite_asan_noleak.json", "JSON", 0, 323, 0, 0, 0, 1, 324
"/Users/sbukhari/Sandbox/CProgram/ASTanalysis/CodexUserStudyData/Assisted/a4b3a969-44a1-4cea-87f5-86393eb85908/api_report.json", "JSON", 0, 14, 0, 0, 0, 1, 15
"/Users/sbukhari/Sandbox/CProgram/ASTanalysis/CodexUserStudyData/Assisted/a4b3a969-44a1-4cea-87f5-86393eb85908/list.c", "C", 189, 0, 0, 0, 76, 26, 291
"/Users/sbukhari/Sandbox/CProgram/ASTanalysis/CodexUserStudyData/Assisted/a4b3a969-44a1-4cea-87f5-86393eb85908/orig_testsuite.json", "JSON", 0, 92, 0, 0, 0, 1, 93
"/Users/sbukhari/Sandbox/CProgram/ASTanalysis/CodexUserStudyData/Assisted/a4b3a969-44a1-4cea-87f5-86393eb85908/orig_testsuite_asan.json", "JSON", 0, 92, 0, 0, 0, 1, 93
"/Users/sbukhari/Sandbox/CProgram/ASTanalysis/CodexUserStudyData/Assisted/a4b3a969-44a1-4cea-87f5-86393eb85908/orig_testsuite_asan_noleak.json", "JSON", 0, 92, 0, 0, 0, 1, 93
"/Users/sbukhari/Sandbox/CProgram/ASTanalysis/CodexUserStudyData/Assisted/a4b3a969-44a1-4cea-87f5-86393eb85908/parts/gen_list_add_item_at_pos.c", "C", 44, 0, 0, 0, 20, 6, 70
"/Users/sbukhari/Sandbox/CProgram/ASTanalysis/CodexUserStudyData/Assisted/a4b3a969-44a1-4cea-87f5-86393eb85908/parts/gen_list_cost_sum.c", "C", 18, 0, 0, 0, 8, 5, 31
"/Users/sbukhari/Sandbox/CProgram/ASTanalysis/CodexUserStudyData/Assisted/a4b3a969-44a1-4cea-87f5-86393eb85908/parts/gen_list_deduplicate.c", "C", 18, 0, 0, 0, 10, 6, 34
"/Users/sbukhari/Sandbox/CProgram/ASTanalysis/CodexUserStudyData/Assisted/a4b3a969-44a1-4cea-87f5-86393eb85908/parts/gen_list_find_highest_price_item_position.c", "C", 36, 0, 0, 0, 8, 5, 49
"/Users/sbukhari/Sandbox/CProgram/ASTanalysis/CodexUserStudyData/Assisted/a4b3a969-44a1-4cea-87f5-86393eb85908/parts/gen_list_init.c", "C", 19, 0, 0, 0, 6, 6, 31
"/Users/sbukhari/Sandbox/CProgram/ASTanalysis/CodexUserStudyData/Assisted/a4b3a969-44a1-4cea-87f5-86393eb85908/parts/gen_list_item_to_string.c", "C", 26, 0, 0, 0, 14, 5, 45
"/Users/sbukhari/Sandbox/CProgram/ASTanalysis/CodexUserStudyData/Assisted/a4b3a969-44a1-4cea-87f5-86393eb85908/parts/gen_list_load.c", "C", 18, 0, 0, 0, 12, 6, 36
"/Users/sbukhari/Sandbox/CProgram/ASTanalysis/CodexUserStudyData/Assisted/a4b3a969-44a1-4cea-87f5-86393eb85908/parts/gen_list_print.c", "C", 28, 0, 0, 0, 21, 6, 55
"/Users/sbukhari/Sandbox/CProgram/ASTanalysis/CodexUserStudyData/Assisted/a4b3a969-44a1-4cea-87f5-86393eb85908/parts/gen_list_remove_item_at_pos.c", "C", 37, 0, 0, 0, 11, 5, 53
"/Users/sbukhari/Sandbox/CProgram/ASTanalysis/CodexUserStudyData/Assisted/a4b3a969-44a1-4cea-87f5-86393eb85908/parts/gen_list_save.c", "C", 21, 0, 0, 0, 11, 6, 38
"/Users/sbukhari/Sandbox/CProgram/ASTanalysis/CodexUserStudyData/Assisted/a4b3a969-44a1-4cea-87f5-86393eb85908/parts/gen_list_swap_item_positions.c", "C", 41, 0, 0, 0, 11, 5, 57
"/Users/sbukhari/Sandbox/CProgram/ASTanalysis/CodexUserStudyData/Assisted/a4b3a969-44a1-4cea-87f5-86393eb85908/parts/gen_list_update_item_at_pos.c", "C", 37, 0, 0, 0, 13, 5, 55
"/Users/sbukhari/Sandbox/CProgram/ASTanalysis/CodexUserStudyData/Assisted/a4b3a969-44a1-4cea-87f5-86393eb85908/ref_testsuite.json", "JSON", 0, 323, 0, 0, 0, 1, 324
"/Users/sbukhari/Sandbox/CProgram/ASTanalysis/CodexUserStudyData/Assisted/a4b3a969-44a1-4cea-87f5-86393eb85908/ref_testsuite_asan.json", "JSON", 0, 323, 0, 0, 0, 1, 324
"/Users/sbukhari/Sandbox/CProgram/ASTanalysis/CodexUserStudyData/Assisted/a4b3a969-44a1-4cea-87f5-86393eb85908/ref_testsuite_asan_noleak.json", "JSON", 0, 323, 0, 0, 0, 1, 324
"/Users/sbukhari/Sandbox/CProgram/ASTanalysis/CodexUserStudyData/Assisted/a5ba06a2-cd4d-4aed-92ac-eeee80fe3e73/api_report.json", "JSON", 0, 14, 0, 0, 0, 1, 15
"/Users/sbukhari/Sandbox/CProgram/ASTanalysis/CodexUserStudyData/Assisted/a5ba06a2-cd4d-4aed-92ac-eeee80fe3e73/list.c", "C", 226, 0, 0, 0, 91, 24, 341
"/Users/sbukhari/Sandbox/CProgram/ASTanalysis/CodexUserStudyData/Assisted/a5ba06a2-cd4d-4aed-92ac-eeee80fe3e73/orig_testsuite.json", "JSON", 0, 92, 0, 0, 0, 1, 93
"/Users/sbukhari/Sandbox/CProgram/ASTanalysis/CodexUserStudyData/Assisted/a5ba06a2-cd4d-4aed-92ac-eeee80fe3e73/orig_testsuite_asan.json", "JSON", 0, 92, 0, 0, 0, 1, 93
"/Users/sbukhari/Sandbox/CProgram/ASTanalysis/CodexUserStudyData/Assisted/a5ba06a2-cd4d-4aed-92ac-eeee80fe3e73/orig_testsuite_asan_noleak.json", "JSON", 0, 92, 0, 0, 0, 1, 93
"/Users/sbukhari/Sandbox/CProgram/ASTanalysis/CodexUserStudyData/Assisted/a5ba06a2-cd4d-4aed-92ac-eeee80fe3e73/parts/gen_list_add_item_at_pos.c", "C", 46, 0, 0, 0, 24, 6, 76
"/Users/sbukhari/Sandbox/CProgram/ASTanalysis/CodexUserStudyData/Assisted/a5ba06a2-cd4d-4aed-92ac-eeee80fe3e73/parts/gen_list_cost_sum.c", "C", 26, 0, 0, 0, 8, 5, 39
"/Users/sbukhari/Sandbox/CProgram/ASTanalysis/CodexUserStudyData/Assisted/a5ba06a2-cd4d-4aed-92ac-eeee80fe3e73/parts/gen_list_deduplicate.c", "C", 37, 0, 0, 0, 14, 11, 62
"/Users/sbukhari/Sandbox/CProgram/ASTanalysis/CodexUserStudyData/Assisted/a5ba06a2-cd4d-4aed-92ac-eeee80fe3e73/parts/gen_list_find_highest_price_item_position.c", "C", 26, 0, 0, 0, 9, 5, 40
"/Users/sbukhari/Sandbox/CProgram/ASTanalysis/CodexUserStudyData/Assisted/a5ba06a2-cd4d-4aed-92ac-eeee80fe3e73/parts/gen_list_init.c", "C", 19, 0, 0, 0, 6, 6, 31
"/Users/sbukhari/Sandbox/CProgram/ASTanalysis/CodexUserStudyData/Assisted/a5ba06a2-cd4d-4aed-92ac-eeee80fe3e73/parts/gen_list_item_to_string.c", "C", 22, 0, 0, 0, 14, 5, 41
"/Users/sbukhari/Sandbox/CProgram/ASTanalysis/CodexUserStudyData/Assisted/a5ba06a2-cd4d-4aed-92ac-eeee80fe3e73/parts/gen_list_load.c", "C", 37, 0, 0, 0, 18, 5, 60
"/Users/sbukhari/Sandbox/CProgram/ASTanalysis/CodexUserStudyData/Assisted/a5ba06a2-cd4d-4aed-92ac-eeee80fe3e73/parts/gen_list_print.c", "C", 26, 0, 0, 0, 25, 5, 56
"/Users/sbukhari/Sandbox/CProgram/ASTanalysis/CodexUserStudyData/Assisted/a5ba06a2-cd4d-4aed-92ac-eeee80fe3e73/parts/gen_list_remove_item_at_pos.c", "C", 35, 0, 0, 0, 15, 5, 55
"/Users/sbukhari/Sandbox/CProgram/ASTanalysis/CodexUserStudyData/Assisted/a5ba06a2-cd4d-4aed-92ac-eeee80fe3e73/parts/gen_list_save.c", "C", 27, 0, 0, 0, 14, 5, 46
"/Users/sbukhari/Sandbox/CProgram/ASTanalysis/CodexUserStudyData/Assisted/a5ba06a2-cd4d-4aed-92ac-eeee80fe3e73/parts/gen_list_swap_item_positions.c", "C", 44, 0, 0, 0, 12, 5, 61
"/Users/sbukhari/Sandbox/CProgram/ASTanalysis/CodexUserStudyData/Assisted/a5ba06a2-cd4d-4aed-92ac-eeee80fe3e73/parts/gen_list_update_item_at_pos.c", "C", 36, 0, 0, 0, 13, 5, 54
"/Users/sbukhari/Sandbox/CProgram/ASTanalysis/CodexUserStudyData/Assisted/a5ba06a2-cd4d-4aed-92ac-eeee80fe3e73/ref_testsuite.json", "JSON", 0, 323, 0, 0, 0, 1, 324
"/Users/sbukhari/Sandbox/CProgram/ASTanalysis/CodexUserStudyData/Assisted/a5ba06a2-cd4d-4aed-92ac-eeee80fe3e73/ref_testsuite_asan.json", "JSON", 0, 323, 0, 0, 0, 1, 324
"/Users/sbukhari/Sandbox/CProgram/ASTanalysis/CodexUserStudyData/Assisted/a5ba06a2-cd4d-4aed-92ac-eeee80fe3e73/ref_testsuite_asan_noleak.json", "JSON", 0, 323, 0, 0, 0, 1, 324
"/Users/sbukhari/Sandbox/CProgram/ASTanalysis/CodexUserStudyData/Assisted/a80d5d0f-724e-4a28-8af1-02ca84993567/api_report.json", "JSON", 0, 14, 0, 0, 0, 1, 15
"/Users/sbukhari/Sandbox/CProgram/ASTanalysis/CodexUserStudyData/Assisted/a80d5d0f-724e-4a28-8af1-02ca84993567/list.c", "C", 188, 0, 0, 0, 54, 26, 268
"/Users/sbukhari/Sandbox/CProgram/ASTanalysis/CodexUserStudyData/Assisted/a80d5d0f-724e-4a28-8af1-02ca84993567/orig_testsuite.json", "JSON", 0, 92, 0, 0, 0, 1, 93
"/Users/sbukhari/Sandbox/CProgram/ASTanalysis/CodexUserStudyData/Assisted/a80d5d0f-724e-4a28-8af1-02ca84993567/orig_testsuite_asan.json", "JSON", 0, 92, 0, 0, 0, 1, 93
"/Users/sbukhari/Sandbox/CProgram/ASTanalysis/CodexUserStudyData/Assisted/a80d5d0f-724e-4a28-8af1-02ca84993567/orig_testsuite_asan_noleak.json", "JSON", 0, 92, 0, 0, 0, 1, 93
"/Users/sbukhari/Sandbox/CProgram/ASTanalysis/CodexUserStudyData/Assisted/a80d5d0f-724e-4a28-8af1-02ca84993567/parts/gen_list_add_item_at_pos.c", "C", 55, 0, 0, 0, 17, 5, 77
"/Users/sbukhari/Sandbox/CProgram/ASTanalysis/CodexUserStudyData/Assisted/a80d5d0f-724e-4a28-8af1-02ca84993567/parts/gen_list_cost_sum.c", "C", 17, 0, 0, 0, 6, 7, 30
"/Users/sbukhari/Sandbox/CProgram/ASTanalysis/CodexUserStudyData/Assisted/a80d5d0f-724e-4a28-8af1-02ca84993567/parts/gen_list_deduplicate.c", "C", 18, 0, 0, 0, 10, 6, 34
"/Users/sbukhari/Sandbox/CProgram/ASTanalysis/CodexUserStudyData/Assisted/a80d5d0f-724e-4a28-8af1-02ca84993567/parts/gen_list_find_highest_price_item_position.c", "C", 32, 0, 0, 0, 8, 6, 46
"/Users/sbukhari/Sandbox/CProgram/ASTanalysis/CodexUserStudyData/Assisted/a80d5d0f-724e-4a28-8af1-02ca84993567/parts/gen_list_init.c", "C", 19, 0, 0, 0, 6, 6, 31
"/Users/sbukhari/Sandbox/CProgram/ASTanalysis/CodexUserStudyData/Assisted/a80d5d0f-724e-4a28-8af1-02ca84993567/parts/gen_list_item_to_string.c", "C", 22, 0, 0, 0, 12, 5, 39
"/Users/sbukhari/Sandbox/CProgram/ASTanalysis/CodexUserStudyData/Assisted/a80d5d0f-724e-4a28-8af1-02ca84993567/parts/gen_list_load.c", "C", 18, 0, 0, 0, 10, 5, 33
"/Users/sbukhari/Sandbox/CProgram/ASTanalysis/CodexUserStudyData/Assisted/a80d5d0f-724e-4a28-8af1-02ca84993567/parts/gen_list_print.c", "C", 28, 0, 0, 0, 20, 5, 53
"/Users/sbukhari/Sandbox/CProgram/ASTanalysis/CodexUserStudyData/Assisted/a80d5d0f-724e-4a28-8af1-02ca84993567/parts/gen_list_remove_item_at_pos.c", "C", 41, 0, 0, 0, 9, 5, 55
"/Users/sbukhari/Sandbox/CProgram/ASTanalysis/CodexUserStudyData/Assisted/a80d5d0f-724e-4a28-8af1-02ca84993567/parts/gen_list_save.c", "C", 18, 0, 0, 0, 9, 5, 32
"/Users/sbukhari/Sandbox/CProgram/ASTanalysis/CodexUserStudyData/Assisted/a80d5d0f-724e-4a28-8af1-02ca84993567/parts/gen_list_swap_item_positions.c", "C", 42, 0, 0, 0, 7, 7, 56
"/Users/sbukhari/Sandbox/CProgram/ASTanalysis/CodexUserStudyData/Assisted/a80d5d0f-724e-4a28-8af1-02ca84993567/parts/gen_list_update_item_at_pos.c", "C", 33, 0, 0, 0, 9, 5, 47
"/Users/sbukhari/Sandbox/CProgram/ASTanalysis/CodexUserStudyData/Assisted/a80d5d0f-724e-4a28-8af1-02ca84993567/ref_testsuite.json", "JSON", 0, 323, 0, 0, 0, 1, 324
"/Users/sbukhari/Sandbox/CProgram/ASTanalysis/CodexUserStudyData/Assisted/a80d5d0f-724e-4a28-8af1-02ca84993567/ref_testsuite_asan.json", "JSON", 0, 323, 0, 0, 0, 1, 324
"/Users/sbukhari/Sandbox/CProgram/ASTanalysis/CodexUserStudyData/Assisted/a80d5d0f-724e-4a28-8af1-02ca84993567/ref_testsuite_asan_noleak.json", "JSON", 0, 323, 0, 0, 0, 1, 324
"/Users/sbukhari/Sandbox/CProgram/ASTanalysis/CodexUserStudyData/Assisted/a974cab3-f095-4360-969e-9942edfdedc1/api_report.json", "JSON", 0, 14, 0, 0, 0, 1, 15
"/Users/sbukhari/Sandbox/CProgram/ASTanalysis/CodexUserStudyData/Assisted/a974cab3-f095-4360-969e-9942edfdedc1/list.c", "C", 176, 0, 0, 0, 31, 13, 220
"/Users/sbukhari/Sandbox/CProgram/ASTanalysis/CodexUserStudyData/Assisted/a974cab3-f095-4360-969e-9942edfdedc1/orig_testsuite.json", "JSON", 0, 92, 0, 0, 0, 1, 93
"/Users/sbukhari/Sandbox/CProgram/ASTanalysis/CodexUserStudyData/Assisted/a974cab3-f095-4360-969e-9942edfdedc1/orig_testsuite_asan.json", "JSON", 0, 92, 0, 0, 0, 1, 93
"/Users/sbukhari/Sandbox/CProgram/ASTanalysis/CodexUserStudyData/Assisted/a974cab3-f095-4360-969e-9942edfdedc1/orig_testsuite_asan_noleak.json", "JSON", 0, 92, 0, 0, 0, 1, 93
"/Users/sbukhari/Sandbox/CProgram/ASTanalysis/CodexUserStudyData/Assisted/a974cab3-f095-4360-969e-9942edfdedc1/parts/gen_list_add_item_at_pos.c", "C", 43, 0, 0, 0, 9, 5, 57
"/Users/sbukhari/Sandbox/CProgram/ASTanalysis/CodexUserStudyData/Assisted/a974cab3-f095-4360-969e-9942edfdedc1/parts/gen_list_cost_sum.c", "C", 23, 0, 0, 0, 7, 5, 35
"/Users/sbukhari/Sandbox/CProgram/ASTanalysis/CodexUserStudyData/Assisted/a974cab3-f095-4360-969e-9942edfdedc1/parts/gen_list_deduplicate.c", "C", 18, 0, 0, 0, 8, 5, 31
"/Users/sbukhari/Sandbox/CProgram/ASTanalysis/CodexUserStudyData/Assisted/a974cab3-f095-4360-969e-9942edfdedc1/parts/gen_list_find_highest_price_item_position.c", "C", 28, 0, 0, 0, 8, 5, 41
"/Users/sbukhari/Sandbox/CProgram/ASTanalysis/CodexUserStudyData/Assisted/a974cab3-f095-4360-969e-9942edfdedc1/parts/gen_list_init.c", "C", 19, 0, 0, 0, 6, 6, 31
"/Users/sbukhari/Sandbox/CProgram/ASTanalysis/CodexUserStudyData/Assisted/a974cab3-f095-4360-969e-9942edfdedc1/parts/gen_list_item_to_string.c", "C", 18, 0, 0, 0, 12, 5, 35
"/Users/sbukhari/Sandbox/CProgram/ASTanalysis/CodexUserStudyData/Assisted/a974cab3-f095-4360-969e-9942edfdedc1/parts/gen_list_load.c", "C", 32, 0, 0, 0, 15, 5, 52
"/Users/sbukhari/Sandbox/CProgram/ASTanalysis/CodexUserStudyData/Assisted/a974cab3-f095-4360-969e-9942edfdedc1/parts/gen_list_print.c", "C", 25, 0, 0, 0, 8, 6, 39
"/Users/sbukhari/Sandbox/CProgram/ASTanalysis/CodexUserStudyData/Assisted/a974cab3-f095-4360-969e-9942edfdedc1/parts/gen_list_remove_item_at_pos.c", "C", 35, 0, 0, 0, 10, 5, 50
"/Users/sbukhari/Sandbox/CProgram/ASTanalysis/CodexUserStudyData/Assisted/a974cab3-f095-4360-969e-9942edfdedc1/parts/gen_list_save.c", "C", 27, 0, 0, 0, 12, 5, 44
"/Users/sbukhari/Sandbox/CProgram/ASTanalysis/CodexUserStudyData/Assisted/a974cab3-f095-4360-969e-9942edfdedc1/parts/gen_list_swap_item_positions.c", "C", 28, 0, 0, 0, 12, 5, 45
"/Users/sbukhari/Sandbox/CProgram/ASTanalysis/CodexUserStudyData/Assisted/a974cab3-f095-4360-969e-9942edfdedc1/parts/gen_list_update_item_at_pos.c", "C", 35, 0, 0, 0, 12, 5, 52
"/Users/sbukhari/Sandbox/CProgram/ASTanalysis/CodexUserStudyData/Assisted/a974cab3-f095-4360-969e-9942edfdedc1/ref_testsuite.json", "JSON", 0, 323, 0, 0, 0, 1, 324
"/Users/sbukhari/Sandbox/CProgram/ASTanalysis/CodexUserStudyData/Assisted/a974cab3-f095-4360-969e-9942edfdedc1/ref_testsuite_asan.json", "JSON", 0, 323, 0, 0, 0, 1, 324
"/Users/sbukhari/Sandbox/CProgram/ASTanalysis/CodexUserStudyData/Assisted/a974cab3-f095-4360-969e-9942edfdedc1/ref_testsuite_asan_noleak.json", "JSON", 0, 323, 0, 0, 0, 1, 324
"/Users/sbukhari/Sandbox/CProgram/ASTanalysis/CodexUserStudyData/Assisted/b59feaf2-4c48-4ec0-8d00-3428362914a7/api_report.json", "JSON", 0, 14, 0, 0, 0, 1, 15
"/Users/sbukhari/Sandbox/CProgram/ASTanalysis/CodexUserStudyData/Assisted/b59feaf2-4c48-4ec0-8d00-3428362914a7/list.c", "C", 88, 0, 0, 0, 74, 17, 179
"/Users/sbukhari/Sandbox/CProgram/ASTanalysis/CodexUserStudyData/Assisted/b59feaf2-4c48-4ec0-8d00-3428362914a7/orig_testsuite.json", "JSON", 0, 92, 0, 0, 0, 1, 93
"/Users/sbukhari/Sandbox/CProgram/ASTanalysis/CodexUserStudyData/Assisted/b59feaf2-4c48-4ec0-8d00-3428362914a7/orig_testsuite_asan.json", "JSON", 0, 92, 0, 0, 0, 1, 93
"/Users/sbukhari/Sandbox/CProgram/ASTanalysis/CodexUserStudyData/Assisted/b59feaf2-4c48-4ec0-8d00-3428362914a7/orig_testsuite_asan_noleak.json", "JSON", 0, 92, 0, 0, 0, 1, 93
"/Users/sbukhari/Sandbox/CProgram/ASTanalysis/CodexUserStudyData/Assisted/b59feaf2-4c48-4ec0-8d00-3428362914a7/parts/gen_list_add_item_at_pos.c", "C", 37, 0, 0, 0, 21, 5, 63
"/Users/sbukhari/Sandbox/CProgram/ASTanalysis/CodexUserStudyData/Assisted/b59feaf2-4c48-4ec0-8d00-3428362914a7/parts/gen_list_cost_sum.c", "C", 18, 0, 0, 0, 8, 5, 31
"/Users/sbukhari/Sandbox/CProgram/ASTanalysis/CodexUserStudyData/Assisted/b59feaf2-4c48-4ec0-8d00-3428362914a7/parts/gen_list_deduplicate.c", "C", 18, 0, 0, 0, 10, 5, 33
"/Users/sbukhari/Sandbox/CProgram/ASTanalysis/CodexUserStudyData/Assisted/b59feaf2-4c48-4ec0-8d00-3428362914a7/parts/gen_list_find_highest_price_item_position.c", "C", 18, 0, 0, 0, 8, 5, 31
"/Users/sbukhari/Sandbox/CProgram/ASTanalysis/CodexUserStudyData/Assisted/b59feaf2-4c48-4ec0-8d00-3428362914a7/parts/gen_list_init.c", "C", 19, 0, 0, 0, 6, 6, 31
"/Users/sbukhari/Sandbox/CProgram/ASTanalysis/CodexUserStudyData/Assisted/b59feaf2-4c48-4ec0-8d00-3428362914a7/parts/gen_list_item_to_string.c", "C", 17, 0, 0, 0, 11, 5, 33
"/Users/sbukhari/Sandbox/CProgram/ASTanalysis/CodexUserStudyData/Assisted/b59feaf2-4c48-4ec0-8d00-3428362914a7/parts/gen_list_load.c", "C", 18, 0, 0, 0, 12, 5, 35
"/Users/sbukhari/Sandbox/CProgram/ASTanalysis/CodexUserStudyData/Assisted/b59feaf2-4c48-4ec0-8d00-3428362914a7/parts/gen_list_print.c", "C", 17, 0, 0, 0, 20, 5, 42
"/Users/sbukhari/Sandbox/CProgram/ASTanalysis/CodexUserStudyData/Assisted/b59feaf2-4c48-4ec0-8d00-3428362914a7/parts/gen_list_remove_item_at_pos.c", "C", 18, 0, 0, 0, 8, 5, 31
"/Users/sbukhari/Sandbox/CProgram/ASTanalysis/CodexUserStudyData/Assisted/b59feaf2-4c48-4ec0-8d00-3428362914a7/parts/gen_list_save.c", "C", 18, 0, 0, 0, 11, 5, 34
"/Users/sbukhari/Sandbox/CProgram/ASTanalysis/CodexUserStudyData/Assisted/b59feaf2-4c48-4ec0-8d00-3428362914a7/parts/gen_list_swap_item_positions.c", "C", 17, 0, 0, 0, 8, 5, 30
"/Users/sbukhari/Sandbox/CProgram/ASTanalysis/CodexUserStudyData/Assisted/b59feaf2-4c48-4ec0-8d00-3428362914a7/parts/gen_list_update_item_at_pos.c", "C", 17, 0, 0, 0, 8, 5, 30
"/Users/sbukhari/Sandbox/CProgram/ASTanalysis/CodexUserStudyData/Assisted/b59feaf2-4c48-4ec0-8d00-3428362914a7/ref_testsuite.json", "JSON", 0, 323, 0, 0, 0, 1, 324
"/Users/sbukhari/Sandbox/CProgram/ASTanalysis/CodexUserStudyData/Assisted/b59feaf2-4c48-4ec0-8d00-3428362914a7/ref_testsuite_asan.json", "JSON", 0, 323, 0, 0, 0, 1, 324
"/Users/sbukhari/Sandbox/CProgram/ASTanalysis/CodexUserStudyData/Assisted/b59feaf2-4c48-4ec0-8d00-3428362914a7/ref_testsuite_asan_noleak.json", "JSON", 0, 323, 0, 0, 0, 1, 324
"/Users/sbukhari/Sandbox/CProgram/ASTanalysis/CodexUserStudyData/Assisted/be6fa0a5-e7ff-4ae0-b846-57d9385acd84/api_report.json", "JSON", 0, 14, 0, 0, 0, 1, 15
"/Users/sbukhari/Sandbox/CProgram/ASTanalysis/CodexUserStudyData/Assisted/be6fa0a5-e7ff-4ae0-b846-57d9385acd84/list.c", "C", 210, 0, 0, 0, 56, 57, 323
"/Users/sbukhari/Sandbox/CProgram/ASTanalysis/CodexUserStudyData/Assisted/be6fa0a5-e7ff-4ae0-b846-57d9385acd84/orig_testsuite.json", "JSON", 0, 92, 0, 0, 0, 1, 93
"/Users/sbukhari/Sandbox/CProgram/ASTanalysis/CodexUserStudyData/Assisted/be6fa0a5-e7ff-4ae0-b846-57d9385acd84/orig_testsuite_asan.json", "JSON", 0, 92, 0, 0, 0, 1, 93
"/Users/sbukhari/Sandbox/CProgram/ASTanalysis/CodexUserStudyData/Assisted/be6fa0a5-e7ff-4ae0-b846-57d9385acd84/orig_testsuite_asan_noleak.json", "JSON", 0, 92, 0, 0, 0, 1, 93
"/Users/sbukhari/Sandbox/CProgram/ASTanalysis/CodexUserStudyData/Assisted/be6fa0a5-e7ff-4ae0-b846-57d9385acd84/parts/gen_list_add_item_at_pos.c", "C", 41, 0, 0, 0, 17, 11, 69
"/Users/sbukhari/Sandbox/CProgram/ASTanalysis/CodexUserStudyData/Assisted/be6fa0a5-e7ff-4ae0-b846-57d9385acd84/parts/gen_list_cost_sum.c", "C", 26, 0, 0, 0, 7, 7, 40
"/Users/sbukhari/Sandbox/CProgram/ASTanalysis/CodexUserStudyData/Assisted/be6fa0a5-e7ff-4ae0-b846-57d9385acd84/parts/gen_list_deduplicate.c", "C", 18, 0, 0, 0, 8, 5, 31
"/Users/sbukhari/Sandbox/CProgram/ASTanalysis/CodexUserStudyData/Assisted/be6fa0a5-e7ff-4ae0-b846-57d9385acd84/parts/gen_list_find_highest_price_item_position.c", "C", 33, 0, 0, 0, 8, 9, 50
"/Users/sbukhari/Sandbox/CProgram/ASTanalysis/CodexUserStudyData/Assisted/be6fa0a5-e7ff-4ae0-b846-57d9385acd84/parts/gen_list_init.c", "C", 19, 0, 0, 0, 6, 6, 31
"/Users/sbukhari/Sandbox/CProgram/ASTanalysis/CodexUserStudyData/Assisted/be6fa0a5-e7ff-4ae0-b846-57d9385acd84/parts/gen_list_item_to_string.c", "C", 21, 0, 0, 0, 12, 7, 40
"/Users/sbukhari/Sandbox/CProgram/ASTanalysis/CodexUserStudyData/Assisted/be6fa0a5-e7ff-4ae0-b846-57d9385acd84/parts/gen_list_load.c", "C", 21, 0, 0, 0, 12, 5, 38
"/Users/sbukhari/Sandbox/CProgram/ASTanalysis/CodexUserStudyData/Assisted/be6fa0a5-e7ff-4ae0-b846-57d9385acd84/parts/gen_list_print.c", "C", 26, 0, 0, 0, 19, 7, 52
"/Users/sbukhari/Sandbox/CProgram/ASTanalysis/CodexUserStudyData/Assisted/be6fa0a5-e7ff-4ae0-b846-57d9385acd84/parts/gen_list_remove_item_at_pos.c", "C", 35, 0, 0, 0, 12, 10, 57
"/Users/sbukhari/Sandbox/CProgram/ASTanalysis/CodexUserStudyData/Assisted/be6fa0a5-e7ff-4ae0-b846-57d9385acd84/parts/gen_list_save.c", "C", 25, 0, 0, 0, 13, 7, 45
"/Users/sbukhari/Sandbox/CProgram/ASTanalysis/CodexUserStudyData/Assisted/be6fa0a5-e7ff-4ae0-b846-57d9385acd84/parts/gen_list_swap_item_positions.c", "C", 54, 0, 0, 0, 9, 12, 75
"/Users/sbukhari/Sandbox/CProgram/ASTanalysis/CodexUserStudyData/Assisted/be6fa0a5-e7ff-4ae0-b846-57d9385acd84/parts/gen_list_update_item_at_pos.c", "C", 33, 0, 0, 0, 9, 9, 51
"/Users/sbukhari/Sandbox/CProgram/ASTanalysis/CodexUserStudyData/Assisted/be6fa0a5-e7ff-4ae0-b846-57d9385acd84/ref_testsuite.json", "JSON", 0, 323, 0, 0, 0, 1, 324
"/Users/sbukhari/Sandbox/CProgram/ASTanalysis/CodexUserStudyData/Assisted/be6fa0a5-e7ff-4ae0-b846-57d9385acd84/ref_testsuite_asan.json", "JSON", 0, 323, 0, 0, 0, 1, 324
"/Users/sbukhari/Sandbox/CProgram/ASTanalysis/CodexUserStudyData/Assisted/be6fa0a5-e7ff-4ae0-b846-57d9385acd84/ref_testsuite_asan_noleak.json", "JSON", 0, 323, 0, 0, 0, 1, 324
"/Users/sbukhari/Sandbox/CProgram/ASTanalysis/CodexUserStudyData/Assisted/c23b2615-700f-48f2-b33d-3433d1c25bb6/api_report.json", "JSON", 0, 14, 0, 0, 0, 1, 15
"/Users/sbukhari/Sandbox/CProgram/ASTanalysis/CodexUserStudyData/Assisted/c23b2615-700f-48f2-b33d-3433d1c25bb6/list.c", "C", 245, 0, 0, 0, 74, 19, 338
"/Users/sbukhari/Sandbox/CProgram/ASTanalysis/CodexUserStudyData/Assisted/c23b2615-700f-48f2-b33d-3433d1c25bb6/orig_testsuite.json", "JSON", 0, 92, 0, 0, 0, 1, 93
"/Users/sbukhari/Sandbox/CProgram/ASTanalysis/CodexUserStudyData/Assisted/c23b2615-700f-48f2-b33d-3433d1c25bb6/orig_testsuite_asan.json", "JSON", 0, 92, 0, 0, 0, 1, 93
"/Users/sbukhari/Sandbox/CProgram/ASTanalysis/CodexUserStudyData/Assisted/c23b2615-700f-48f2-b33d-3433d1c25bb6/orig_testsuite_asan_noleak.json", "JSON", 0, 92, 0, 0, 0, 1, 93
"/Users/sbukhari/Sandbox/CProgram/ASTanalysis/CodexUserStudyData/Assisted/c23b2615-700f-48f2-b33d-3433d1c25bb6/parts/gen_list_add_item_at_pos.c", "C", 59, 0, 0, 0, 19, 5, 83
"/Users/sbukhari/Sandbox/CProgram/ASTanalysis/CodexUserStudyData/Assisted/c23b2615-700f-48f2-b33d-3433d1c25bb6/parts/gen_list_cost_sum.c", "C", 25, 0, 0, 0, 9, 5, 39
"/Users/sbukhari/Sandbox/CProgram/ASTanalysis/CodexUserStudyData/Assisted/c23b2615-700f-48f2-b33d-3433d1c25bb6/parts/gen_list_deduplicate.c", "C", 20, 0, 0, 0, 11, 5, 36
"/Users/sbukhari/Sandbox/CProgram/ASTanalysis/CodexUserStudyData/Assisted/c23b2615-700f-48f2-b33d-3433d1c25bb6/parts/gen_list_find_highest_price_item_position.c", "C", 33, 0, 0, 0, 9, 5, 47
"/Users/sbukhari/Sandbox/CProgram/ASTanalysis/CodexUserStudyData/Assisted/c23b2615-700f-48f2-b33d-3433d1c25bb6/parts/gen_list_init.c", "C", 19, 0, 0, 0, 6, 6, 31
"/Users/sbukhari/Sandbox/CProgram/ASTanalysis/CodexUserStudyData/Assisted/c23b2615-700f-48f2-b33d-3433d1c25bb6/parts/gen_list_item_to_string.c", "C", 21, 0, 0, 0, 14, 5, 40
"/Users/sbukhari/Sandbox/CProgram/ASTanalysis/CodexUserStudyData/Assisted/c23b2615-700f-48f2-b33d-3433d1c25bb6/parts/gen_list_load.c", "C", 31, 0, 0, 0, 14, 7, 52
"/Users/sbukhari/Sandbox/CProgram/ASTanalysis/CodexUserStudyData/Assisted/c23b2615-700f-48f2-b33d-3433d1c25bb6/parts/gen_list_print.c", "C", 30, 0, 0, 0, 22, 5, 57
"/Users/sbukhari/Sandbox/CProgram/ASTanalysis/CodexUserStudyData/Assisted/c23b2615-700f-48f2-b33d-3433d1c25bb6/parts/gen_list_remove_item_at_pos.c", "C", 38, 0, 0, 0, 11, 5, 54
"/Users/sbukhari/Sandbox/CProgram/ASTanalysis/CodexUserStudyData/Assisted/c23b2615-700f-48f2-b33d-3433d1c25bb6/parts/gen_list_save.c", "C", 31, 0, 0, 0, 13, 5, 49
"/Users/sbukhari/Sandbox/CProgram/ASTanalysis/CodexUserStudyData/Assisted/c23b2615-700f-48f2-b33d-3433d1c25bb6/parts/gen_list_swap_item_positions.c", "C", 55, 0, 0, 0, 9, 5, 69
"/Users/sbukhari/Sandbox/CProgram/ASTanalysis/CodexUserStudyData/Assisted/c23b2615-700f-48f2-b33d-3433d1c25bb6/parts/gen_list_update_item_at_pos.c", "C", 38, 0, 0, 0, 13, 5, 56
"/Users/sbukhari/Sandbox/CProgram/ASTanalysis/CodexUserStudyData/Assisted/c23b2615-700f-48f2-b33d-3433d1c25bb6/ref_testsuite.json", "JSON", 0, 323, 0, 0, 0, 1, 324
"/Users/sbukhari/Sandbox/CProgram/ASTanalysis/CodexUserStudyData/Assisted/c23b2615-700f-48f2-b33d-3433d1c25bb6/ref_testsuite_asan.json", "JSON", 0, 323, 0, 0, 0, 1, 324
"/Users/sbukhari/Sandbox/CProgram/ASTanalysis/CodexUserStudyData/Assisted/c23b2615-700f-48f2-b33d-3433d1c25bb6/ref_testsuite_asan_noleak.json", "JSON", 0, 323, 0, 0, 0, 1, 324
"/Users/sbukhari/Sandbox/CProgram/ASTanalysis/CodexUserStudyData/Assisted/dac37585-9926-4e20-8ac1-40addd42f1a8/api_report.json", "JSON", 0, 14, 0, 0, 0, 1, 15
"/Users/sbukhari/Sandbox/CProgram/ASTanalysis/CodexUserStudyData/Assisted/dac37585-9926-4e20-8ac1-40addd42f1a8/list.c", "C", 189, 0, 0, 0, 101, 20, 310
"/Users/sbukhari/Sandbox/CProgram/ASTanalysis/CodexUserStudyData/Assisted/dac37585-9926-4e20-8ac1-40addd42f1a8/orig_testsuite.json", "JSON", 0, 92, 0, 0, 0, 1, 93
"/Users/sbukhari/Sandbox/CProgram/ASTanalysis/CodexUserStudyData/Assisted/dac37585-9926-4e20-8ac1-40addd42f1a8/orig_testsuite_asan.json", "JSON", 0, 92, 0, 0, 0, 1, 93
"/Users/sbukhari/Sandbox/CProgram/ASTanalysis/CodexUserStudyData/Assisted/dac37585-9926-4e20-8ac1-40addd42f1a8/orig_testsuite_asan_noleak.json", "JSON", 0, 92, 0, 0, 0, 1, 93
"/Users/sbukhari/Sandbox/CProgram/ASTanalysis/CodexUserStudyData/Assisted/dac37585-9926-4e20-8ac1-40addd42f1a8/parts/gen_list_add_item_at_pos.c", "C", 42, 0, 0, 0, 21, 6, 69
"/Users/sbukhari/Sandbox/CProgram/ASTanalysis/CodexUserStudyData/Assisted/dac37585-9926-4e20-8ac1-40addd42f1a8/parts/gen_list_cost_sum.c", "C", 18, 0, 0, 0, 8, 5, 31
"/Users/sbukhari/Sandbox/CProgram/ASTanalysis/CodexUserStudyData/Assisted/dac37585-9926-4e20-8ac1-40addd42f1a8/parts/gen_list_deduplicate.c", "C", 18, 0, 0, 0, 10, 5, 33
"/Users/sbukhari/Sandbox/CProgram/ASTanalysis/CodexUserStudyData/Assisted/dac37585-9926-4e20-8ac1-40addd42f1a8/parts/gen_list_find_highest_price_item_position.c", "C", 18, 0, 0, 0, 8, 5, 31
"/Users/sbukhari/Sandbox/CProgram/ASTanalysis/CodexUserStudyData/Assisted/dac37585-9926-4e20-8ac1-40addd42f1a8/parts/gen_list_init.c", "C", 19, 0, 0, 0, 6, 5, 30
"/Users/sbukhari/Sandbox/CProgram/ASTanalysis/CodexUserStudyData/Assisted/dac37585-9926-4e20-8ac1-40addd42f1a8/parts/gen_list_item_to_string.c", "C", 21, 0, 0, 0, 13, 5, 39
"/Users/sbukhari/Sandbox/CProgram/ASTanalysis/CodexUserStudyData/Assisted/dac37585-9926-4e20-8ac1-40addd42f1a8/parts/gen_list_load.c", "C", 18, 0, 0, 0, 12, 5, 35
"/Users/sbukhari/Sandbox/CProgram/ASTanalysis/CodexUserStudyData/Assisted/dac37585-9926-4e20-8ac1-40addd42f1a8/parts/gen_list_print.c", "C", 30, 0, 0, 0, 22, 5, 57
"/Users/sbukhari/Sandbox/CProgram/ASTanalysis/CodexUserStudyData/Assisted/dac37585-9926-4e20-8ac1-40addd42f1a8/parts/gen_list_remove_item_at_pos.c", "C", 41, 0, 0, 0, 17, 5, 63
"/Users/sbukhari/Sandbox/CProgram/ASTanalysis/CodexUserStudyData/Assisted/dac37585-9926-4e20-8ac1-40addd42f1a8/parts/gen_list_save.c", "C", 18, 0, 0, 0, 11, 5, 34
"/Users/sbukhari/Sandbox/CProgram/ASTanalysis/CodexUserStudyData/Assisted/dac37585-9926-4e20-8ac1-40addd42f1a8/parts/gen_list_swap_item_positions.c", "C", 68, 0, 0, 0, 23, 6, 97
"/Users/sbukhari/Sandbox/CProgram/ASTanalysis/CodexUserStudyData/Assisted/dac37585-9926-4e20-8ac1-40addd42f1a8/parts/gen_list_update_item_at_pos.c", "C", 32, 0, 0, 0, 12, 5, 49
"/Users/sbukhari/Sandbox/CProgram/ASTanalysis/CodexUserStudyData/Assisted/dac37585-9926-4e20-8ac1-40addd42f1a8/ref_testsuite.json", "JSON", 0, 323, 0, 0, 0, 1, 324
"/Users/sbukhari/Sandbox/CProgram/ASTanalysis/CodexUserStudyData/Assisted/dac37585-9926-4e20-8ac1-40addd42f1a8/ref_testsuite_asan.json", "JSON", 0, 323, 0, 0, 0, 1, 324
"/Users/sbukhari/Sandbox/CProgram/ASTanalysis/CodexUserStudyData/Assisted/dac37585-9926-4e20-8ac1-40addd42f1a8/ref_testsuite_asan_noleak.json", "JSON", 0, 323, 0, 0, 0, 1, 324
"/Users/sbukhari/Sandbox/CProgram/ASTanalysis/CodexUserStudyData/Assisted/dc47e379-a3ba-464c-aa89-69374080111a/api_report.json", "JSON", 0, 14, 0, 0, 0, 1, 15
"/Users/sbukhari/Sandbox/CProgram/ASTanalysis/CodexUserStudyData/Assisted/dc47e379-a3ba-464c-aa89-69374080111a/list.c", "C", 174, 0, 0, 0, 83, 43, 300
"/Users/sbukhari/Sandbox/CProgram/ASTanalysis/CodexUserStudyData/Assisted/dc47e379-a3ba-464c-aa89-69374080111a/orig_testsuite.json", "JSON", 0, 92, 0, 0, 0, 1, 93
"/Users/sbukhari/Sandbox/CProgram/ASTanalysis/CodexUserStudyData/Assisted/dc47e379-a3ba-464c-aa89-69374080111a/orig_testsuite_asan.json", "JSON", 0, 92, 0, 0, 0, 1, 93
"/Users/sbukhari/Sandbox/CProgram/ASTanalysis/CodexUserStudyData/Assisted/dc47e379-a3ba-464c-aa89-69374080111a/orig_testsuite_asan_noleak.json", "JSON", 0, 92, 0, 0, 0, 1, 93
"/Users/sbukhari/Sandbox/CProgram/ASTanalysis/CodexUserStudyData/Assisted/dc47e379-a3ba-464c-aa89-69374080111a/parts/gen_list_add_item_at_pos.c", "C", 42, 0, 0, 0, 20, 6, 68
"/Users/sbukhari/Sandbox/CProgram/ASTanalysis/CodexUserStudyData/Assisted/dc47e379-a3ba-464c-aa89-69374080111a/parts/gen_list_cost_sum.c", "C", 18, 0, 0, 0, 8, 5, 31
"/Users/sbukhari/Sandbox/CProgram/ASTanalysis/CodexUserStudyData/Assisted/dc47e379-a3ba-464c-aa89-69374080111a/parts/gen_list_deduplicate.c", "C", 18, 0, 0, 0, 11, 7, 36
"/Users/sbukhari/Sandbox/CProgram/ASTanalysis/CodexUserStudyData/Assisted/dc47e379-a3ba-464c-aa89-69374080111a/parts/gen_list_find_highest_price_item_position.c", "C", 18, 0, 0, 0, 8, 5, 31
"/Users/sbukhari/Sandbox/CProgram/ASTanalysis/CodexUserStudyData/Assisted/dc47e379-a3ba-464c-aa89-69374080111a/parts/gen_list_init.c", "C", 19, 0, 0, 0, 6, 6, 31
"/Users/sbukhari/Sandbox/CProgram/ASTanalysis/CodexUserStudyData/Assisted/dc47e379-a3ba-464c-aa89-69374080111a/parts/gen_list_item_to_string.c", "C", 18, 0, 0, 0, 19, 8, 45
"/Users/sbukhari/Sandbox/CProgram/ASTanalysis/CodexUserStudyData/Assisted/dc47e379-a3ba-464c-aa89-69374080111a/parts/gen_list_load.c", "C", 31, 0, 0, 0, 16, 8, 55
"/Users/sbukhari/Sandbox/CProgram/ASTanalysis/CodexUserStudyData/Assisted/dc47e379-a3ba-464c-aa89-69374080111a/parts/gen_list_print.c", "C", 26, 0, 0, 0, 22, 5, 53
"/Users/sbukhari/Sandbox/CProgram/ASTanalysis/CodexUserStudyData/Assisted/dc47e379-a3ba-464c-aa89-69374080111a/parts/gen_list_remove_item_at_pos.c", "C", 34, 0, 0, 0, 14, 7, 55
"/Users/sbukhari/Sandbox/CProgram/ASTanalysis/CodexUserStudyData/Assisted/dc47e379-a3ba-464c-aa89-69374080111a/parts/gen_list_save.c", "C", 18, 0, 0, 0, 11, 5, 34
"/Users/sbukhari/Sandbox/CProgram/ASTanalysis/CodexUserStudyData/Assisted/dc47e379-a3ba-464c-aa89-69374080111a/parts/gen_list_swap_item_positions.c", "C", 17, 0, 0, 0, 8, 5, 30
"/Users/sbukhari/Sandbox/CProgram/ASTanalysis/CodexUserStudyData/Assisted/dc47e379-a3ba-464c-aa89-69374080111a/parts/gen_list_update_item_at_pos.c", "C", 25, 0, 0, 0, 13, 7, 45
"/Users/sbukhari/Sandbox/CProgram/ASTanalysis/CodexUserStudyData/Assisted/dc47e379-a3ba-464c-aa89-69374080111a/ref_testsuite.json", "JSON", 0, 323, 0, 0, 0, 1, 324
"/Users/sbukhari/Sandbox/CProgram/ASTanalysis/CodexUserStudyData/Assisted/dc47e379-a3ba-464c-aa89-69374080111a/ref_testsuite_asan.json", "JSON", 0, 323, 0, 0, 0, 1, 324
"/Users/sbukhari/Sandbox/CProgram/ASTanalysis/CodexUserStudyData/Assisted/dc47e379-a3ba-464c-aa89-69374080111a/ref_testsuite_asan_noleak.json", "JSON", 0, 323, 0, 0, 0, 1, 324
"/Users/sbukhari/Sandbox/CProgram/ASTanalysis/CodexUserStudyData/Assisted/ddac8637-a99c-458d-bff5-916acb92e259/api_report.json", "JSON", 0, 14, 0, 0, 0, 1, 15
"/Users/sbukhari/Sandbox/CProgram/ASTanalysis/CodexUserStudyData/Assisted/ddac8637-a99c-458d-bff5-916acb92e259/list.c", "C", 208, 0, 0, 0, 66, 21, 295
"/Users/sbukhari/Sandbox/CProgram/ASTanalysis/CodexUserStudyData/Assisted/ddac8637-a99c-458d-bff5-916acb92e259/orig_testsuite.json", "JSON", 0, 92, 0, 0, 0, 1, 93
"/Users/sbukhari/Sandbox/CProgram/ASTanalysis/CodexUserStudyData/Assisted/ddac8637-a99c-458d-bff5-916acb92e259/orig_testsuite_asan.json", "JSON", 0, 92, 0, 0, 0, 1, 93
"/Users/sbukhari/Sandbox/CProgram/ASTanalysis/CodexUserStudyData/Assisted/ddac8637-a99c-458d-bff5-916acb92e259/orig_testsuite_asan_noleak.json", "JSON", 0, 92, 0, 0, 0, 1, 93
"/Users/sbukhari/Sandbox/CProgram/ASTanalysis/CodexUserStudyData/Assisted/ddac8637-a99c-458d-bff5-916acb92e259/parts/gen_list_add_item_at_pos.c", "C", 37, 0, 0, 0, 18, 7, 62
"/Users/sbukhari/Sandbox/CProgram/ASTanalysis/CodexUserStudyData/Assisted/ddac8637-a99c-458d-bff5-916acb92e259/parts/gen_list_cost_sum.c", "C", 26, 0, 0, 0, 9, 5, 40
"/Users/sbukhari/Sandbox/CProgram/ASTanalysis/CodexUserStudyData/Assisted/ddac8637-a99c-458d-bff5-916acb92e259/parts/gen_list_deduplicate.c", "C", 38, 0, 0, 0, 14, 5, 57
"/Users/sbukhari/Sandbox/CProgram/ASTanalysis/CodexUserStudyData/Assisted/ddac8637-a99c-458d-bff5-916acb92e259/parts/gen_list_find_highest_price_item_position.c", "C", 29, 0, 0, 0, 8, 5, 42
"/Users/sbukhari/Sandbox/CProgram/ASTanalysis/CodexUserStudyData/Assisted/ddac8637-a99c-458d-bff5-916acb92e259/parts/gen_list_init.c", "C", 20, 0, 0, 0, 6, 6, 32
"/Users/sbukhari/Sandbox/CProgram/ASTanalysis/CodexUserStudyData/Assisted/ddac8637-a99c-458d-bff5-916acb92e259/parts/gen_list_item_to_string.c", "C", 24, 0, 0, 0, 14, 5, 43
"/Users/sbukhari/Sandbox/CProgram/ASTanalysis/CodexUserStudyData/Assisted/ddac8637-a99c-458d-bff5-916acb92e259/parts/gen_list_load.c", "C", 41, 0, 0, 0, 16, 5, 62
"/Users/sbukhari/Sandbox/CProgram/ASTanalysis/CodexUserStudyData/Assisted/ddac8637-a99c-458d-bff5-916acb92e259/parts/gen_list_print.c", "C", 27, 0, 0, 0, 20, 5, 52
"/Users/sbukhari/Sandbox/CProgram/ASTanalysis/CodexUserStudyData/Assisted/ddac8637-a99c-458d-bff5-916acb92e259/parts/gen_list_remove_item_at_pos.c", "C", 33, 0, 0, 0, 10, 5, 48
"/Users/sbukhari/Sandbox/CProgram/ASTanalysis/CodexUserStudyData/Assisted/ddac8637-a99c-458d-bff5-916acb92e259/parts/gen_list_save.c", "C", 28, 0, 0, 0, 14, 6, 48
"/Users/sbukhari/Sandbox/CProgram/ASTanalysis/CodexUserStudyData/Assisted/ddac8637-a99c-458d-bff5-916acb92e259/parts/gen_list_swap_item_positions.c", "C", 39, 0, 0, 0, 12, 6, 57
"/Users/sbukhari/Sandbox/CProgram/ASTanalysis/CodexUserStudyData/Assisted/ddac8637-a99c-458d-bff5-916acb92e259/parts/gen_list_update_item_at_pos.c", "C", 32, 0, 0, 0, 10, 5, 47
"/Users/sbukhari/Sandbox/CProgram/ASTanalysis/CodexUserStudyData/Assisted/ddac8637-a99c-458d-bff5-916acb92e259/ref_testsuite.json", "JSON", 0, 323, 0, 0, 0, 1, 324
"/Users/sbukhari/Sandbox/CProgram/ASTanalysis/CodexUserStudyData/Assisted/ddac8637-a99c-458d-bff5-916acb92e259/ref_testsuite_asan.json", "JSON", 0, 323, 0, 0, 0, 1, 324
"/Users/sbukhari/Sandbox/CProgram/ASTanalysis/CodexUserStudyData/Assisted/ddac8637-a99c-458d-bff5-916acb92e259/ref_testsuite_asan_noleak.json", "JSON", 0, 323, 0, 0, 0, 1, 324
"/Users/sbukhari/Sandbox/CProgram/ASTanalysis/CodexUserStudyData/Assisted/e04ce3f6-46eb-465e-9828-5e768febf9be/api_report.json", "JSON", 0, 14, 0, 0, 0, 1, 15
"/Users/sbukhari/Sandbox/CProgram/ASTanalysis/CodexUserStudyData/Assisted/e04ce3f6-46eb-465e-9828-5e768febf9be/list.c", "C", 264, 0, 0, 0, 55, 55, 374
"/Users/sbukhari/Sandbox/CProgram/ASTanalysis/CodexUserStudyData/Assisted/e04ce3f6-46eb-465e-9828-5e768febf9be/orig_testsuite.json", "JSON", 0, 92, 0, 0, 0, 1, 93
"/Users/sbukhari/Sandbox/CProgram/ASTanalysis/CodexUserStudyData/Assisted/e04ce3f6-46eb-465e-9828-5e768febf9be/orig_testsuite_asan.json", "JSON", 0, 92, 0, 0, 0, 1, 93
"/Users/sbukhari/Sandbox/CProgram/ASTanalysis/CodexUserStudyData/Assisted/e04ce3f6-46eb-465e-9828-5e768febf9be/orig_testsuite_asan_noleak.json", "JSON", 0, 92, 0, 0, 0, 1, 93
"/Users/sbukhari/Sandbox/CProgram/ASTanalysis/CodexUserStudyData/Assisted/e04ce3f6-46eb-465e-9828-5e768febf9be/parts/gen_list_add_item_at_pos.c", "C", 41, 0, 0, 0, 17, 10, 68
"/Users/sbukhari/Sandbox/CProgram/ASTanalysis/CodexUserStudyData/Assisted/e04ce3f6-46eb-465e-9828-5e768febf9be/parts/gen_list_cost_sum.c", "C", 27, 0, 0, 0, 7, 8, 42
"/Users/sbukhari/Sandbox/CProgram/ASTanalysis/CodexUserStudyData/Assisted/e04ce3f6-46eb-465e-9828-5e768febf9be/parts/gen_list_deduplicate.c", "C", 59, 0, 0, 0, 13, 12, 84
"/Users/sbukhari/Sandbox/CProgram/ASTanalysis/CodexUserStudyData/Assisted/e04ce3f6-46eb-465e-9828-5e768febf9be/parts/gen_list_find_highest_price_item_position.c", "C", 32, 0, 0, 0, 7, 6, 45
"/Users/sbukhari/Sandbox/CProgram/ASTanalysis/CodexUserStudyData/Assisted/e04ce3f6-46eb-465e-9828-5e768febf9be/parts/gen_list_init.c", "C", 19, 0, 0, 0, 6, 6, 31
"/Users/sbukhari/Sandbox/CProgram/ASTanalysis/CodexUserStudyData/Assisted/e04ce3f6-46eb-465e-9828-5e768febf9be/parts/gen_list_item_to_string.c", "C", 21, 0, 0, 0, 13, 5, 39
"/Users/sbukhari/Sandbox/CProgram/ASTanalysis/CodexUserStudyData/Assisted/e04ce3f6-46eb-465e-9828-5e768febf9be/parts/gen_list_load.c", "C", 45, 0, 0, 0, 14, 12, 71
"/Users/sbukhari/Sandbox/CProgram/ASTanalysis/CodexUserStudyData/Assisted/e04ce3f6-46eb-465e-9828-5e768febf9be/parts/gen_list_print.c", "C", 28, 0, 0, 0, 20, 5, 53
"/Users/sbukhari/Sandbox/CProgram/ASTanalysis/CodexUserStudyData/Assisted/e04ce3f6-46eb-465e-9828-5e768febf9be/parts/gen_list_remove_item_at_pos.c", "C", 43, 0, 0, 0, 10, 8, 61
"/Users/sbukhari/Sandbox/CProgram/ASTanalysis/CodexUserStudyData/Assisted/e04ce3f6-46eb-465e-9828-5e768febf9be/parts/gen_list_save.c", "C", 30, 0, 0, 0, 12, 9, 51
"/Users/sbukhari/Sandbox/CProgram/ASTanalysis/CodexUserStudyData/Assisted/e04ce3f6-46eb-465e-9828-5e768febf9be/parts/gen_list_swap_item_positions.c", "C", 43, 0, 0, 0, 7, 9, 59
"/Users/sbukhari/Sandbox/CProgram/ASTanalysis/CodexUserStudyData/Assisted/e04ce3f6-46eb-465e-9828-5e768febf9be/parts/gen_list_update_item_at_pos.c", "C", 34, 0, 0, 0, 9, 8, 51
"/Users/sbukhari/Sandbox/CProgram/ASTanalysis/CodexUserStudyData/Assisted/e04ce3f6-46eb-465e-9828-5e768febf9be/ref_testsuite.json", "JSON", 0, 323, 0, 0, 0, 1, 324
"/Users/sbukhari/Sandbox/CProgram/ASTanalysis/CodexUserStudyData/Assisted/e04ce3f6-46eb-465e-9828-5e768febf9be/ref_testsuite_asan.json", "JSON", 0, 323, 0, 0, 0, 1, 324
"/Users/sbukhari/Sandbox/CProgram/ASTanalysis/CodexUserStudyData/Assisted/e04ce3f6-46eb-465e-9828-5e768febf9be/ref_testsuite_asan_noleak.json", "JSON", 0, 323, 0, 0, 0, 1, 324
"/Users/sbukhari/Sandbox/CProgram/ASTanalysis/CodexUserStudyData/Assisted/ec83a892-5cfa-46bf-aab8-673aee747cb8/api_report.json", "JSON", 0, 14, 0, 0, 0, 1, 15
"/Users/sbukhari/Sandbox/CProgram/ASTanalysis/CodexUserStudyData/Assisted/ec83a892-5cfa-46bf-aab8-673aee747cb8/list.c", "C", 243, 0, 0, 0, 53, 18, 314
"/Users/sbukhari/Sandbox/CProgram/ASTanalysis/CodexUserStudyData/Assisted/ec83a892-5cfa-46bf-aab8-673aee747cb8/orig_testsuite.json", "JSON", 0, 92, 0, 0, 0, 1, 93
"/Users/sbukhari/Sandbox/CProgram/ASTanalysis/CodexUserStudyData/Assisted/ec83a892-5cfa-46bf-aab8-673aee747cb8/orig_testsuite_asan.json", "JSON", 0, 92, 0, 0, 0, 1, 93
"/Users/sbukhari/Sandbox/CProgram/ASTanalysis/CodexUserStudyData/Assisted/ec83a892-5cfa-46bf-aab8-673aee747cb8/orig_testsuite_asan_noleak.json", "JSON", 0, 92, 0, 0, 0, 1, 93
"/Users/sbukhari/Sandbox/CProgram/ASTanalysis/CodexUserStudyData/Assisted/ec83a892-5cfa-46bf-aab8-673aee747cb8/parts/gen_list_add_item_at_pos.c", "C", 37, 0, 0, 0, 16, 5, 58
"/Users/sbukhari/Sandbox/CProgram/ASTanalysis/CodexUserStudyData/Assisted/ec83a892-5cfa-46bf-aab8-673aee747cb8/parts/gen_list_cost_sum.c", "C", 27, 0, 0, 0, 7, 5, 39
"/Users/sbukhari/Sandbox/CProgram/ASTanalysis/CodexUserStudyData/Assisted/ec83a892-5cfa-46bf-aab8-673aee747cb8/parts/gen_list_deduplicate.c", "C", 36, 0, 0, 0, 12, 6, 54
"/Users/sbukhari/Sandbox/CProgram/ASTanalysis/CodexUserStudyData/Assisted/ec83a892-5cfa-46bf-aab8-673aee747cb8/parts/gen_list_find_highest_price_item_position.c", "C", 33, 0, 0, 0, 6, 5, 44
"/Users/sbukhari/Sandbox/CProgram/ASTanalysis/CodexUserStudyData/Assisted/ec83a892-5cfa-46bf-aab8-673aee747cb8/parts/gen_list_init.c", "C", 19, 0, 0, 0, 6, 6, 31
"/Users/sbukhari/Sandbox/CProgram/ASTanalysis/CodexUserStudyData/Assisted/ec83a892-5cfa-46bf-aab8-673aee747cb8/parts/gen_list_item_to_string.c", "C", 21, 0, 0, 0, 11, 5, 37
"/Users/sbukhari/Sandbox/CProgram/ASTanalysis/CodexUserStudyData/Assisted/ec83a892-5cfa-46bf-aab8-673aee747cb8/parts/gen_list_load.c", "C", 42, 0, 0, 0, 13, 5, 60
"/Users/sbukhari/Sandbox/CProgram/ASTanalysis/CodexUserStudyData/Assisted/ec83a892-5cfa-46bf-aab8-673aee747cb8/parts/gen_list_print.c", "C", 31, 0, 0, 0, 18, 5, 54
"/Users/sbukhari/Sandbox/CProgram/ASTanalysis/CodexUserStudyData/Assisted/ec83a892-5cfa-46bf-aab8-673aee747cb8/parts/gen_list_remove_item_at_pos.c", "C", 36, 0, 0, 0, 10, 5, 51
"/Users/sbukhari/Sandbox/CProgram/ASTanalysis/CodexUserStudyData/Assisted/ec83a892-5cfa-46bf-aab8-673aee747cb8/parts/gen_list_save.c", "C", 30, 0, 0, 0, 13, 5, 48
"/Users/sbukhari/Sandbox/CProgram/ASTanalysis/CodexUserStudyData/Assisted/ec83a892-5cfa-46bf-aab8-673aee747cb8/parts/gen_list_swap_item_positions.c", "C", 54, 0, 0, 0, 6, 5, 65
"/Users/sbukhari/Sandbox/CProgram/ASTanalysis/CodexUserStudyData/Assisted/ec83a892-5cfa-46bf-aab8-673aee747cb8/parts/gen_list_update_item_at_pos.c", "C", 32, 0, 0, 0, 8, 5, 45
"/Users/sbukhari/Sandbox/CProgram/ASTanalysis/CodexUserStudyData/Assisted/ec83a892-5cfa-46bf-aab8-673aee747cb8/ref_testsuite.json", "JSON", 0, 323, 0, 0, 0, 1, 324
"/Users/sbukhari/Sandbox/CProgram/ASTanalysis/CodexUserStudyData/Assisted/ec83a892-5cfa-46bf-aab8-673aee747cb8/ref_testsuite_asan.json", "JSON", 0, 323, 0, 0, 0, 1, 324
"/Users/sbukhari/Sandbox/CProgram/ASTanalysis/CodexUserStudyData/Assisted/ec83a892-5cfa-46bf-aab8-673aee747cb8/ref_testsuite_asan_noleak.json", "JSON", 0, 323, 0, 0, 0, 1, 324
"/Users/sbukhari/Sandbox/CProgram/ASTanalysis/CodexUserStudyData/Assisted/fd621e01-4962-4699-b49a-012c08563cb5/api_report.json", "JSON", 0, 14, 0, 0, 0, 1, 15
"/Users/sbukhari/Sandbox/CProgram/ASTanalysis/CodexUserStudyData/Assisted/fd621e01-4962-4699-b49a-012c08563cb5/list.c", "C", 90, 0, 0, 0, 89, 18, 197
"/Users/sbukhari/Sandbox/CProgram/ASTanalysis/CodexUserStudyData/Assisted/fd621e01-4962-4699-b49a-012c08563cb5/orig_testsuite.json", "JSON", 0, 92, 0, 0, 0, 1, 93
"/Users/sbukhari/Sandbox/CProgram/ASTanalysis/CodexUserStudyData/Assisted/fd621e01-4962-4699-b49a-012c08563cb5/orig_testsuite_asan.json", "JSON", 0, 92, 0, 0, 0, 1, 93
"/Users/sbukhari/Sandbox/CProgram/ASTanalysis/CodexUserStudyData/Assisted/fd621e01-4962-4699-b49a-012c08563cb5/orig_testsuite_asan_noleak.json", "JSON", 0, 92, 0, 0, 0, 1, 93
"/Users/sbukhari/Sandbox/CProgram/ASTanalysis/CodexUserStudyData/Assisted/fd621e01-4962-4699-b49a-012c08563cb5/parts/gen_list_add_item_at_pos.c", "C", 36, 0, 0, 0, 20, 5, 61
"/Users/sbukhari/Sandbox/CProgram/ASTanalysis/CodexUserStudyData/Assisted/fd621e01-4962-4699-b49a-012c08563cb5/parts/gen_list_cost_sum.c", "C", 18, 0, 0, 0, 8, 5, 31
"/Users/sbukhari/Sandbox/CProgram/ASTanalysis/CodexUserStudyData/Assisted/fd621e01-4962-4699-b49a-012c08563cb5/parts/gen_list_deduplicate.c", "C", 18, 0, 0, 0, 10, 5, 33
"/Users/sbukhari/Sandbox/CProgram/ASTanalysis/CodexUserStudyData/Assisted/fd621e01-4962-4699-b49a-012c08563cb5/parts/gen_list_find_highest_price_item_position.c", "C", 18, 0, 0, 0, 8, 5, 31
"/Users/sbukhari/Sandbox/CProgram/ASTanalysis/CodexUserStudyData/Assisted/fd621e01-4962-4699-b49a-012c08563cb5/parts/gen_list_init.c", "C", 19, 0, 0, 0, 6, 6, 31
"/Users/sbukhari/Sandbox/CProgram/ASTanalysis/CodexUserStudyData/Assisted/fd621e01-4962-4699-b49a-012c08563cb5/parts/gen_list_item_to_string.c", "C", 18, 0, 0, 0, 15, 5, 38
"/Users/sbukhari/Sandbox/CProgram/ASTanalysis/CodexUserStudyData/Assisted/fd621e01-4962-4699-b49a-012c08563cb5/parts/gen_list_load.c", "C", 18, 0, 0, 0, 12, 5, 35
"/Users/sbukhari/Sandbox/CProgram/ASTanalysis/CodexUserStudyData/Assisted/fd621e01-4962-4699-b49a-012c08563cb5/parts/gen_list_print.c", "C", 27, 0, 0, 0, 22, 5, 54
"/Users/sbukhari/Sandbox/CProgram/ASTanalysis/CodexUserStudyData/Assisted/fd621e01-4962-4699-b49a-012c08563cb5/parts/gen_list_remove_item_at_pos.c", "C", 18, 0, 0, 0, 8, 5, 31
"/Users/sbukhari/Sandbox/CProgram/ASTanalysis/CodexUserStudyData/Assisted/fd621e01-4962-4699-b49a-012c08563cb5/parts/gen_list_save.c", "C", 18, 0, 0, 0, 11, 5, 34
"/Users/sbukhari/Sandbox/CProgram/ASTanalysis/CodexUserStudyData/Assisted/fd621e01-4962-4699-b49a-012c08563cb5/parts/gen_list_swap_item_positions.c", "C", 17, 0, 0, 0, 8, 5, 30
"/Users/sbukhari/Sandbox/CProgram/ASTanalysis/CodexUserStudyData/Assisted/fd621e01-4962-4699-b49a-012c08563cb5/parts/gen_list_update_item_at_pos.c", "C", 16, 0, 0, 0, 21, 5, 42
"/Users/sbukhari/Sandbox/CProgram/ASTanalysis/CodexUserStudyData/Assisted/fd621e01-4962-4699-b49a-012c08563cb5/ref_testsuite.json", "JSON", 0, 323, 0, 0, 0, 1, 324
"/Users/sbukhari/Sandbox/CProgram/ASTanalysis/CodexUserStudyData/Assisted/fd621e01-4962-4699-b49a-012c08563cb5/ref_testsuite_asan.json", "JSON", 0, 323, 0, 0, 0, 1, 324
"/Users/sbukhari/Sandbox/CProgram/ASTanalysis/CodexUserStudyData/Assisted/fd621e01-4962-4699-b49a-012c08563cb5/ref_testsuite_asan_noleak.json", "JSON", 0, 323, 0, 0, 0, 1, 324
"/Users/sbukhari/Sandbox/CProgram/ASTanalysis/CodexUserStudyData/Assisted/ff36e2ef-af58-426f-97ae-dc8ba80ff4a0/api_report.json", "JSON", 0, 14, 0, 0, 0, 1, 15
"/Users/sbukhari/Sandbox/CProgram/ASTanalysis/CodexUserStudyData/Assisted/ff36e2ef-af58-426f-97ae-dc8ba80ff4a0/list.c", "C", 232, 0, 0, 0, 67, 47, 346
"/Users/sbukhari/Sandbox/CProgram/ASTanalysis/CodexUserStudyData/Assisted/ff36e2ef-af58-426f-97ae-dc8ba80ff4a0/orig_testsuite.json", "JSON", 0, 92, 0, 0, 0, 1, 93
"/Users/sbukhari/Sandbox/CProgram/ASTanalysis/CodexUserStudyData/Assisted/ff36e2ef-af58-426f-97ae-dc8ba80ff4a0/orig_testsuite_asan.json", "JSON", 0, 92, 0, 0, 0, 1, 93
"/Users/sbukhari/Sandbox/CProgram/ASTanalysis/CodexUserStudyData/Assisted/ff36e2ef-af58-426f-97ae-dc8ba80ff4a0/orig_testsuite_asan_noleak.json", "JSON", 0, 92, 0, 0, 0, 1, 93
"/Users/sbukhari/Sandbox/CProgram/ASTanalysis/CodexUserStudyData/Assisted/ff36e2ef-af58-426f-97ae-dc8ba80ff4a0/parts/gen_list_add_item_at_pos.c", "C", 18, 0, 0, 0, 18, 6, 42
"/Users/sbukhari/Sandbox/CProgram/ASTanalysis/CodexUserStudyData/Assisted/ff36e2ef-af58-426f-97ae-dc8ba80ff4a0/parts/gen_list_cost_sum.c", "C", 18, 0, 0, 0, 8, 6, 32
"/Users/sbukhari/Sandbox/CProgram/ASTanalysis/CodexUserStudyData/Assisted/ff36e2ef-af58-426f-97ae-dc8ba80ff4a0/parts/gen_list_deduplicate.c", "C", 18, 0, 0, 0, 10, 6, 34
"/Users/sbukhari/Sandbox/CProgram/ASTanalysis/CodexUserStudyData/Assisted/ff36e2ef-af58-426f-97ae-dc8ba80ff4a0/parts/gen_list_find_highest_price_item_position.c", "C", 24, 0, 0, 0, 10, 6, 40
"/Users/sbukhari/Sandbox/CProgram/ASTanalysis/CodexUserStudyData/Assisted/ff36e2ef-af58-426f-97ae-dc8ba80ff4a0/parts/gen_list_init.c", "C", 19, 0, 0, 0, 6, 7, 32
"/Users/sbukhari/Sandbox/CProgram/ASTanalysis/CodexUserStudyData/Assisted/ff36e2ef-af58-426f-97ae-dc8ba80ff4a0/parts/gen_list_item_to_string.c", "C", 25, 0, 0, 0, 14, 7, 46
"/Users/sbukhari/Sandbox/CProgram/ASTanalysis/CodexUserStudyData/Assisted/ff36e2ef-af58-426f-97ae-dc8ba80ff4a0/parts/gen_list_load.c", "C", 18, 0, 0, 0, 12, 6, 36
"/Users/sbukhari/Sandbox/CProgram/ASTanalysis/CodexUserStudyData/Assisted/ff36e2ef-af58-426f-97ae-dc8ba80ff4a0/parts/gen_list_print.c", "C", 27, 0, 0, 0, 20, 8, 55
"/Users/sbukhari/Sandbox/CProgram/ASTanalysis/CodexUserStudyData/Assisted/ff36e2ef-af58-426f-97ae-dc8ba80ff4a0/parts/gen_list_remove_item_at_pos.c", "C", 18, 0, 0, 0, 8, 6, 32
"/Users/sbukhari/Sandbox/CProgram/ASTanalysis/CodexUserStudyData/Assisted/ff36e2ef-af58-426f-97ae-dc8ba80ff4a0/parts/gen_list_save.c", "C", 31, 0, 0, 0, 14, 9, 54
"/Users/sbukhari/Sandbox/CProgram/ASTanalysis/CodexUserStudyData/Assisted/ff36e2ef-af58-426f-97ae-dc8ba80ff4a0/parts/gen_list_swap_item_positions.c", "C", 31, 0, 0, 0, 9, 6, 46
"/Users/sbukhari/Sandbox/CProgram/ASTanalysis/CodexUserStudyData/Assisted/ff36e2ef-af58-426f-97ae-dc8ba80ff4a0/parts/gen_list_update_item_at_pos.c", "C", 17, 0, 0, 0, 8, 6, 31
"/Users/sbukhari/Sandbox/CProgram/ASTanalysis/CodexUserStudyData/Assisted/ff36e2ef-af58-426f-97ae-dc8ba80ff4a0/ref_testsuite.json", "JSON", 0, 323, 0, 0, 0, 1, 324
"/Users/sbukhari/Sandbox/CProgram/ASTanalysis/CodexUserStudyData/Assisted/ff36e2ef-af58-426f-97ae-dc8ba80ff4a0/ref_testsuite_asan.json", "JSON", 0, 323, 0, 0, 0, 1, 324
"/Users/sbukhari/Sandbox/CProgram/ASTanalysis/CodexUserStudyData/Assisted/ff36e2ef-af58-426f-97ae-dc8ba80ff4a0/ref_testsuite_asan_noleak.json", "JSON", 0, 323, 0, 0, 0, 1, 324
"/Users/sbukhari/Sandbox/CProgram/ASTanalysis/CodexUserStudyData/Autopilot/cushman-001_00/api_report.json", "JSON", 0, 14, 0, 0, 0, 1, 15
"/Users/sbukhari/Sandbox/CProgram/ASTanalysis/CodexUserStudyData/Autopilot/cushman-001_00/list.c", "C", 207, 0, 0, 0, 55, 17, 279
"/Users/sbukhari/Sandbox/CProgram/ASTanalysis/CodexUserStudyData/Autopilot/cushman-001_00/orig_testsuite.json", "JSON", 0, 92, 0, 0, 0, 1, 93
"/Users/sbukhari/Sandbox/CProgram/ASTanalysis/CodexUserStudyData/Autopilot/cushman-001_00/orig_testsuite_asan.json", "JSON", 0, 92, 0, 0, 0, 1, 93
"/Users/sbukhari/Sandbox/CProgram/ASTanalysis/CodexUserStudyData/Autopilot/cushman-001_00/orig_testsuite_asan_noleak.json", "JSON", 0, 92, 0, 0, 0, 1, 93
"/Users/sbukhari/Sandbox/CProgram/ASTanalysis/CodexUserStudyData/Autopilot/cushman-001_00/parts/gen_list_add_item_at_pos.c", "C", 34, 0, 0, 0, 17, 5, 56
"/Users/sbukhari/Sandbox/CProgram/ASTanalysis/CodexUserStudyData/Autopilot/cushman-001_00/parts/gen_list_cost_sum.c", "C", 28, 0, 0, 0, 6, 5, 39
"/Users/sbukhari/Sandbox/CProgram/ASTanalysis/CodexUserStudyData/Autopilot/cushman-001_00/parts/gen_list_deduplicate.c", "C", 36, 0, 0, 0, 9, 5, 50
"/Users/sbukhari/Sandbox/CProgram/ASTanalysis/CodexUserStudyData/Autopilot/cushman-001_00/parts/gen_list_find_highest_price_item_position.c", "C", 32, 0, 0, 0, 6, 5, 43
"/Users/sbukhari/Sandbox/CProgram/ASTanalysis/CodexUserStudyData/Autopilot/cushman-001_00/parts/gen_list_init.c", "C", 18, 0, 0, 0, 5, 5, 28
"/Users/sbukhari/Sandbox/CProgram/ASTanalysis/CodexUserStudyData/Autopilot/cushman-001_00/parts/gen_list_item_to_string.c", "C", 22, 0, 0, 0, 11, 5, 38
"/Users/sbukhari/Sandbox/CProgram/ASTanalysis/CodexUserStudyData/Autopilot/cushman-001_00/parts/gen_list_load.c", "C", 17, 0, 0, 0, 11, 5, 33
"/Users/sbukhari/Sandbox/CProgram/ASTanalysis/CodexUserStudyData/Autopilot/cushman-001_00/parts/gen_list_print.c", "C", 29, 0, 0, 0, 19, 5, 53
"/Users/sbukhari/Sandbox/CProgram/ASTanalysis/CodexUserStudyData/Autopilot/cushman-001_00/parts/gen_list_remove_item_at_pos.c", "C", 37, 0, 0, 0, 9, 5, 51
"/Users/sbukhari/Sandbox/CProgram/ASTanalysis/CodexUserStudyData/Autopilot/cushman-001_00/parts/gen_list_save.c", "C", 33, 0, 0, 0, 10, 5, 48
"/Users/sbukhari/Sandbox/CProgram/ASTanalysis/CodexUserStudyData/Autopilot/cushman-001_00/parts/gen_list_swap_item_positions.c", "C", 42, 0, 0, 0, 9, 5, 56
"/Users/sbukhari/Sandbox/CProgram/ASTanalysis/CodexUserStudyData/Autopilot/cushman-001_00/parts/gen_list_update_item_at_pos.c", "C", 34, 0, 0, 0, 6, 5, 45
"/Users/sbukhari/Sandbox/CProgram/ASTanalysis/CodexUserStudyData/Autopilot/cushman-001_00/ref_testsuite.json", "JSON", 0, 323, 0, 0, 0, 1, 324
"/Users/sbukhari/Sandbox/CProgram/ASTanalysis/CodexUserStudyData/Autopilot/cushman-001_00/ref_testsuite_asan.json", "JSON", 0, 323, 0, 0, 0, 1, 324
"/Users/sbukhari/Sandbox/CProgram/ASTanalysis/CodexUserStudyData/Autopilot/cushman-001_00/ref_testsuite_asan_noleak.json", "JSON", 0, 323, 0, 0, 0, 1, 324
"/Users/sbukhari/Sandbox/CProgram/ASTanalysis/CodexUserStudyData/Autopilot/cushman-001_01/api_report.json", "JSON", 0, 14, 0, 0, 0, 1, 15
"/Users/sbukhari/Sandbox/CProgram/ASTanalysis/CodexUserStudyData/Autopilot/cushman-001_01/list.c", "C", 262, 0, 0, 0, 53, 17, 332
"/Users/sbukhari/Sandbox/CProgram/ASTanalysis/CodexUserStudyData/Autopilot/cushman-001_01/orig_testsuite.json", "JSON", 0, 92, 0, 0, 0, 1, 93
"/Users/sbukhari/Sandbox/CProgram/ASTanalysis/CodexUserStudyData/Autopilot/cushman-001_01/orig_testsuite_asan.json", "JSON", 0, 92, 0, 0, 0, 1, 93
"/Users/sbukhari/Sandbox/CProgram/ASTanalysis/CodexUserStudyData/Autopilot/cushman-001_01/orig_testsuite_asan_noleak.json", "JSON", 0, 92, 0, 0, 0, 1, 93
"/Users/sbukhari/Sandbox/CProgram/ASTanalysis/CodexUserStudyData/Autopilot/cushman-001_01/parts/gen_list_add_item_at_pos.c", "C", 47, 0, 0, 0, 15, 5, 67
"/Users/sbukhari/Sandbox/CProgram/ASTanalysis/CodexUserStudyData/Autopilot/cushman-001_01/parts/gen_list_cost_sum.c", "C", 27, 0, 0, 0, 6, 5, 38
"/Users/sbukhari/Sandbox/CProgram/ASTanalysis/CodexUserStudyData/Autopilot/cushman-001_01/parts/gen_list_deduplicate.c", "C", 40, 0, 0, 0, 9, 5, 54
"/Users/sbukhari/Sandbox/CProgram/ASTanalysis/CodexUserStudyData/Autopilot/cushman-001_01/parts/gen_list_find_highest_price_item_position.c", "C", 31, 0, 0, 0, 6, 5, 42
"/Users/sbukhari/Sandbox/CProgram/ASTanalysis/CodexUserStudyData/Autopilot/cushman-001_01/parts/gen_list_init.c", "C", 27, 0, 0, 0, 5, 5, 37
"/Users/sbukhari/Sandbox/CProgram/ASTanalysis/CodexUserStudyData/Autopilot/cushman-001_01/parts/gen_list_item_to_string.c", "C", 25, 0, 0, 0, 9, 5, 39
"/Users/sbukhari/Sandbox/CProgram/ASTanalysis/CodexUserStudyData/Autopilot/cushman-001_01/parts/gen_list_load.c", "C", 38, 0, 0, 0, 12, 5, 55
"/Users/sbukhari/Sandbox/CProgram/ASTanalysis/CodexUserStudyData/Autopilot/cushman-001_01/parts/gen_list_print.c", "C", 29, 0, 0, 0, 18, 5, 52
"/Users/sbukhari/Sandbox/CProgram/ASTanalysis/CodexUserStudyData/Autopilot/cushman-001_01/parts/gen_list_remove_item_at_pos.c", "C", 39, 0, 0, 0, 7, 5, 51
"/Users/sbukhari/Sandbox/CProgram/ASTanalysis/CodexUserStudyData/Autopilot/cushman-001_01/parts/gen_list_save.c", "C", 28, 0, 0, 0, 11, 5, 44
"/Users/sbukhari/Sandbox/CProgram/ASTanalysis/CodexUserStudyData/Autopilot/cushman-001_01/parts/gen_list_swap_item_positions.c", "C", 52, 0, 0, 0, 6, 5, 63
"/Users/sbukhari/Sandbox/CProgram/ASTanalysis/CodexUserStudyData/Autopilot/cushman-001_01/parts/gen_list_update_item_at_pos.c", "C", 33, 0, 0, 0, 7, 5, 45
"/Users/sbukhari/Sandbox/CProgram/ASTanalysis/CodexUserStudyData/Autopilot/cushman-001_01/ref_testsuite.json", "JSON", 0, 323, 0, 0, 0, 1, 324
"/Users/sbukhari/Sandbox/CProgram/ASTanalysis/CodexUserStudyData/Autopilot/cushman-001_01/ref_testsuite_asan.json", "JSON", 0, 323, 0, 0, 0, 1, 324
"/Users/sbukhari/Sandbox/CProgram/ASTanalysis/CodexUserStudyData/Autopilot/cushman-001_01/ref_testsuite_asan_noleak.json", "JSON", 0, 323, 0, 0, 0, 1, 324
"/Users/sbukhari/Sandbox/CProgram/ASTanalysis/CodexUserStudyData/Autopilot/cushman-001_02/api_report.json", "JSON", 0, 14, 0, 0, 0, 1, 15
"/Users/sbukhari/Sandbox/CProgram/ASTanalysis/CodexUserStudyData/Autopilot/cushman-001_02/list.c", "C", 229, 0, 0, 0, 86, 17, 332
"/Users/sbukhari/Sandbox/CProgram/ASTanalysis/CodexUserStudyData/Autopilot/cushman-001_02/orig_testsuite.json", "JSON", 0, 92, 0, 0, 0, 1, 93
"/Users/sbukhari/Sandbox/CProgram/ASTanalysis/CodexUserStudyData/Autopilot/cushman-001_02/orig_testsuite_asan.json", "JSON", 0, 92, 0, 0, 0, 1, 93
"/Users/sbukhari/Sandbox/CProgram/ASTanalysis/CodexUserStudyData/Autopilot/cushman-001_02/orig_testsuite_asan_noleak.json", "JSON", 0, 92, 0, 0, 0, 1, 93
"/Users/sbukhari/Sandbox/CProgram/ASTanalysis/CodexUserStudyData/Autopilot/cushman-001_02/parts/gen_list_add_item_at_pos.c", "C", 42, 0, 0, 0, 21, 5, 68
"/Users/sbukhari/Sandbox/CProgram/ASTanalysis/CodexUserStudyData/Autopilot/cushman-001_02/parts/gen_list_cost_sum.c", "C", 31, 0, 0, 0, 10, 5, 46
"/Users/sbukhari/Sandbox/CProgram/ASTanalysis/CodexUserStudyData/Autopilot/cushman-001_02/parts/gen_list_deduplicate.c", "C", 17, 0, 0, 0, 9, 5, 31
"/Users/sbukhari/Sandbox/CProgram/ASTanalysis/CodexUserStudyData/Autopilot/cushman-001_02/parts/gen_list_find_highest_price_item_position.c", "C", 36, 0, 0, 0, 9, 5, 50
"/Users/sbukhari/Sandbox/CProgram/ASTanalysis/CodexUserStudyData/Autopilot/cushman-001_02/parts/gen_list_init.c", "C", 18, 0, 0, 0, 5, 5, 28
"/Users/sbukhari/Sandbox/CProgram/ASTanalysis/CodexUserStudyData/Autopilot/cushman-001_02/parts/gen_list_item_to_string.c", "C", 25, 0, 0, 0, 10, 5, 40
"/Users/sbukhari/Sandbox/CProgram/ASTanalysis/CodexUserStudyData/Autopilot/cushman-001_02/parts/gen_list_load.c", "C", 17, 0, 0, 0, 11, 5, 33
"/Users/sbukhari/Sandbox/CProgram/ASTanalysis/CodexUserStudyData/Autopilot/cushman-001_02/parts/gen_list_print.c", "C", 32, 0, 0, 0, 18, 5, 55
"/Users/sbukhari/Sandbox/CProgram/ASTanalysis/CodexUserStudyData/Autopilot/cushman-001_02/parts/gen_list_remove_item_at_pos.c", "C", 41, 0, 0, 0, 11, 5, 57
"/Users/sbukhari/Sandbox/CProgram/ASTanalysis/CodexUserStudyData/Autopilot/cushman-001_02/parts/gen_list_save.c", "C", 33, 0, 0, 0, 15, 5, 53
"/Users/sbukhari/Sandbox/CProgram/ASTanalysis/CodexUserStudyData/Autopilot/cushman-001_02/parts/gen_list_swap_item_positions.c", "C", 53, 0, 0, 0, 11, 5, 69
"/Users/sbukhari/Sandbox/CProgram/ASTanalysis/CodexUserStudyData/Autopilot/cushman-001_02/parts/gen_list_update_item_at_pos.c", "C", 39, 0, 0, 0, 13, 5, 57
"/Users/sbukhari/Sandbox/CProgram/ASTanalysis/CodexUserStudyData/Autopilot/cushman-001_02/ref_testsuite.json", "JSON", 0, 323, 0, 0, 0, 1, 324
"/Users/sbukhari/Sandbox/CProgram/ASTanalysis/CodexUserStudyData/Autopilot/cushman-001_02/ref_testsuite_asan.json", "JSON", 0, 323, 0, 0, 0, 1, 324
"/Users/sbukhari/Sandbox/CProgram/ASTanalysis/CodexUserStudyData/Autopilot/cushman-001_02/ref_testsuite_asan_noleak.json", "JSON", 0, 323, 0, 0, 0, 1, 324
"/Users/sbukhari/Sandbox/CProgram/ASTanalysis/CodexUserStudyData/Autopilot/cushman-001_03/api_report.json", "JSON", 0, 14, 0, 0, 0, 1, 15
"/Users/sbukhari/Sandbox/CProgram/ASTanalysis/CodexUserStudyData/Autopilot/cushman-001_03/list.c", "C", 251, 0, 0, 0, 126, 28, 405
"/Users/sbukhari/Sandbox/CProgram/ASTanalysis/CodexUserStudyData/Autopilot/cushman-001_03/orig_testsuite.json", "JSON", 0, 92, 0, 0, 0, 1, 93
"/Users/sbukhari/Sandbox/CProgram/ASTanalysis/CodexUserStudyData/Autopilot/cushman-001_03/orig_testsuite_asan.json", "JSON", 0, 92, 0, 0, 0, 1, 93
"/Users/sbukhari/Sandbox/CProgram/ASTanalysis/CodexUserStudyData/Autopilot/cushman-001_03/orig_testsuite_asan_noleak.json", "JSON", 0, 92, 0, 0, 0, 1, 93
"/Users/sbukhari/Sandbox/CProgram/ASTanalysis/CodexUserStudyData/Autopilot/cushman-001_03/parts/gen_list_add_item_at_pos.c", "C", 36, 0, 0, 0, 24, 6, 66
"/Users/sbukhari/Sandbox/CProgram/ASTanalysis/CodexUserStudyData/Autopilot/cushman-001_03/parts/gen_list_cost_sum.c", "C", 36, 0, 0, 0, 18, 5, 59
"/Users/sbukhari/Sandbox/CProgram/ASTanalysis/CodexUserStudyData/Autopilot/cushman-001_03/parts/gen_list_deduplicate.c", "C", 17, 0, 0, 0, 9, 5, 31
"/Users/sbukhari/Sandbox/CProgram/ASTanalysis/CodexUserStudyData/Autopilot/cushman-001_03/parts/gen_list_find_highest_price_item_position.c", "C", 54, 0, 0, 0, 28, 5, 87
"/Users/sbukhari/Sandbox/CProgram/ASTanalysis/CodexUserStudyData/Autopilot/cushman-001_03/parts/gen_list_init.c", "C", 18, 0, 0, 0, 5, 5, 28
"/Users/sbukhari/Sandbox/CProgram/ASTanalysis/CodexUserStudyData/Autopilot/cushman-001_03/parts/gen_list_item_to_string.c", "C", 33, 0, 0, 0, 20, 8, 61
"/Users/sbukhari/Sandbox/CProgram/ASTanalysis/CodexUserStudyData/Autopilot/cushman-001_03/parts/gen_list_load.c", "C", 17, 0, 0, 0, 11, 5, 33
"/Users/sbukhari/Sandbox/CProgram/ASTanalysis/CodexUserStudyData/Autopilot/cushman-001_03/parts/gen_list_print.c", "C", 40, 0, 0, 0, 26, 8, 74
"/Users/sbukhari/Sandbox/CProgram/ASTanalysis/CodexUserStudyData/Autopilot/cushman-001_03/parts/gen_list_remove_item_at_pos.c", "C", 32, 0, 0, 0, 14, 6, 52
"/Users/sbukhari/Sandbox/CProgram/ASTanalysis/CodexUserStudyData/Autopilot/cushman-001_03/parts/gen_list_save.c", "C", 48, 0, 0, 0, 24, 5, 77
"/Users/sbukhari/Sandbox/CProgram/ASTanalysis/CodexUserStudyData/Autopilot/cushman-001_03/parts/gen_list_swap_item_positions.c", "C", 43, 0, 0, 0, 22, 7, 72
"/Users/sbukhari/Sandbox/CProgram/ASTanalysis/CodexUserStudyData/Autopilot/cushman-001_03/parts/gen_list_update_item_at_pos.c", "C", 32, 0, 0, 0, 14, 6, 52
"/Users/sbukhari/Sandbox/CProgram/ASTanalysis/CodexUserStudyData/Autopilot/cushman-001_03/ref_testsuite.json", "JSON", 0, 323, 0, 0, 0, 1, 324
"/Users/sbukhari/Sandbox/CProgram/ASTanalysis/CodexUserStudyData/Autopilot/cushman-001_03/ref_testsuite_asan.json", "JSON", 0, 323, 0, 0, 0, 1, 324
"/Users/sbukhari/Sandbox/CProgram/ASTanalysis/CodexUserStudyData/Autopilot/cushman-001_03/ref_testsuite_asan_noleak.json", "JSON", 0, 323, 0, 0, 0, 1, 324
"/Users/sbukhari/Sandbox/CProgram/ASTanalysis/CodexUserStudyData/Autopilot/cushman-001_04/api_report.json", "JSON", 0, 14, 0, 0, 0, 1, 15
"/Users/sbukhari/Sandbox/CProgram/ASTanalysis/CodexUserStudyData/Autopilot/cushman-001_04/list.c", "C", 228, 0, 0, 0, 57, 17, 302
"/Users/sbukhari/Sandbox/CProgram/ASTanalysis/CodexUserStudyData/Autopilot/cushman-001_04/orig_testsuite.json", "JSON", 0, 92, 0, 0, 0, 1, 93
"/Users/sbukhari/Sandbox/CProgram/ASTanalysis/CodexUserStudyData/Autopilot/cushman-001_04/orig_testsuite_asan.json", "JSON", 0, 92, 0, 0, 0, 1, 93
"/Users/sbukhari/Sandbox/CProgram/ASTanalysis/CodexUserStudyData/Autopilot/cushman-001_04/orig_testsuite_asan_noleak.json", "JSON", 0, 92, 0, 0, 0, 1, 93
"/Users/sbukhari/Sandbox/CProgram/ASTanalysis/CodexUserStudyData/Autopilot/cushman-001_04/parts/gen_list_add_item_at_pos.c", "C", 54, 0, 0, 0, 22, 5, 81
"/Users/sbukhari/Sandbox/CProgram/ASTanalysis/CodexUserStudyData/Autopilot/cushman-001_04/parts/gen_list_cost_sum.c", "C", 28, 0, 0, 0, 6, 5, 39
"/Users/sbukhari/Sandbox/CProgram/ASTanalysis/CodexUserStudyData/Autopilot/cushman-001_04/parts/gen_list_deduplicate.c", "C", 34, 0, 0, 0, 10, 5, 49
"/Users/sbukhari/Sandbox/CProgram/ASTanalysis/CodexUserStudyData/Autopilot/cushman-001_04/parts/gen_list_find_highest_price_item_position.c", "C", 35, 0, 0, 0, 7, 5, 47
"/Users/sbukhari/Sandbox/CProgram/ASTanalysis/CodexUserStudyData/Autopilot/cushman-001_04/parts/gen_list_init.c", "C", 26, 0, 0, 0, 5, 5, 36
"/Users/sbukhari/Sandbox/CProgram/ASTanalysis/CodexUserStudyData/Autopilot/cushman-001_04/parts/gen_list_item_to_string.c", "C", 22, 0, 0, 0, 13, 5, 40
"/Users/sbukhari/Sandbox/CProgram/ASTanalysis/CodexUserStudyData/Autopilot/cushman-001_04/parts/gen_list_load.c", "C", 17, 0, 0, 0, 11, 5, 33
"/Users/sbukhari/Sandbox/CProgram/ASTanalysis/CodexUserStudyData/Autopilot/cushman-001_04/parts/gen_list_print.c", "C", 28, 0, 0, 0, 20, 5, 53
"/Users/sbukhari/Sandbox/CProgram/ASTanalysis/CodexUserStudyData/Autopilot/cushman-001_04/parts/gen_list_remove_item_at_pos.c", "C", 34, 0, 0, 0, 10, 5, 49
"/Users/sbukhari/Sandbox/CProgram/ASTanalysis/CodexUserStudyData/Autopilot/cushman-001_04/parts/gen_list_save.c", "C", 32, 0, 0, 0, 11, 5, 48
"/Users/sbukhari/Sandbox/CProgram/ASTanalysis/CodexUserStudyData/Autopilot/cushman-001_04/parts/gen_list_swap_item_positions.c", "C", 39, 0, 0, 0, 12, 5, 56
"/Users/sbukhari/Sandbox/CProgram/ASTanalysis/CodexUserStudyData/Autopilot/cushman-001_04/parts/gen_list_update_item_at_pos.c", "C", 34, 0, 0, 0, 11, 5, 50
"/Users/sbukhari/Sandbox/CProgram/ASTanalysis/CodexUserStudyData/Autopilot/cushman-001_04/ref_testsuite.json", "JSON", 0, 323, 0, 0, 0, 1, 324
"/Users/sbukhari/Sandbox/CProgram/ASTanalysis/CodexUserStudyData/Autopilot/cushman-001_04/ref_testsuite_asan.json", "JSON", 0, 323, 0, 0, 0, 1, 324
"/Users/sbukhari/Sandbox/CProgram/ASTanalysis/CodexUserStudyData/Autopilot/cushman-001_04/ref_testsuite_asan_noleak.json", "JSON", 0, 323, 0, 0, 0, 1, 324
"/Users/sbukhari/Sandbox/CProgram/ASTanalysis/CodexUserStudyData/Autopilot/cushman-001_05/api_report.json", "JSON", 0, 14, 0, 0, 0, 1, 15
"/Users/sbukhari/Sandbox/CProgram/ASTanalysis/CodexUserStudyData/Autopilot/cushman-001_05/list.c", "C", 252, 0, 0, 0, 126, 77, 455
"/Users/sbukhari/Sandbox/CProgram/ASTanalysis/CodexUserStudyData/Autopilot/cushman-001_05/orig_testsuite.json", "JSON", 0, 92, 0, 0, 0, 1, 93
"/Users/sbukhari/Sandbox/CProgram/ASTanalysis/CodexUserStudyData/Autopilot/cushman-001_05/orig_testsuite_asan.json", "JSON", 0, 92, 0, 0, 0, 1, 93
"/Users/sbukhari/Sandbox/CProgram/ASTanalysis/CodexUserStudyData/Autopilot/cushman-001_05/orig_testsuite_asan_noleak.json", "JSON", 0, 92, 0, 0, 0, 1, 93
"/Users/sbukhari/Sandbox/CProgram/ASTanalysis/CodexUserStudyData/Autopilot/cushman-001_05/parts/gen_list_add_item_at_pos.c", "C", 48, 0, 0, 0, 24, 13, 85
"/Users/sbukhari/Sandbox/CProgram/ASTanalysis/CodexUserStudyData/Autopilot/cushman-001_05/parts/gen_list_cost_sum.c", "C", 29, 0, 0, 0, 10, 9, 48
"/Users/sbukhari/Sandbox/CProgram/ASTanalysis/CodexUserStudyData/Autopilot/cushman-001_05/parts/gen_list_deduplicate.c", "C", 32, 0, 0, 0, 11, 8, 51
"/Users/sbukhari/Sandbox/CProgram/ASTanalysis/CodexUserStudyData/Autopilot/cushman-001_05/parts/gen_list_find_highest_price_item_position.c", "C", 31, 0, 0, 0, 9, 8, 48
"/Users/sbukhari/Sandbox/CProgram/ASTanalysis/CodexUserStudyData/Autopilot/cushman-001_05/parts/gen_list_init.c", "C", 28, 0, 0, 0, 10, 9, 47
"/Users/sbukhari/Sandbox/CProgram/ASTanalysis/CodexUserStudyData/Autopilot/cushman-001_05/parts/gen_list_item_to_string.c", "C", 30, 0, 0, 0, 14, 10, 54
"/Users/sbukhari/Sandbox/CProgram/ASTanalysis/CodexUserStudyData/Autopilot/cushman-001_05/parts/gen_list_load.c", "C", 17, 0, 0, 0, 11, 5, 33
"/Users/sbukhari/Sandbox/CProgram/ASTanalysis/CodexUserStudyData/Autopilot/cushman-001_05/parts/gen_list_print.c", "C", 34, 0, 0, 0, 25, 11, 70
"/Users/sbukhari/Sandbox/CProgram/ASTanalysis/CodexUserStudyData/Autopilot/cushman-001_05/parts/gen_list_remove_item_at_pos.c", "C", 44, 0, 0, 0, 12, 12, 68
"/Users/sbukhari/Sandbox/CProgram/ASTanalysis/CodexUserStudyData/Autopilot/cushman-001_05/parts/gen_list_save.c", "C", 30, 0, 0, 0, 15, 11, 56
"/Users/sbukhari/Sandbox/CProgram/ASTanalysis/CodexUserStudyData/Autopilot/cushman-001_05/parts/gen_list_swap_item_positions.c", "C", 41, 0, 0, 0, 12, 11, 64
"/Users/sbukhari/Sandbox/CProgram/ASTanalysis/CodexUserStudyData/Autopilot/cushman-001_05/parts/gen_list_update_item_at_pos.c", "C", 43, 0, 0, 0, 14, 13, 70
"/Users/sbukhari/Sandbox/CProgram/ASTanalysis/CodexUserStudyData/Autopilot/cushman-001_05/ref_testsuite.json", "JSON", 0, 323, 0, 0, 0, 1, 324
"/Users/sbukhari/Sandbox/CProgram/ASTanalysis/CodexUserStudyData/Autopilot/cushman-001_05/ref_testsuite_asan.json", "JSON", 0, 323, 0, 0, 0, 1, 324
"/Users/sbukhari/Sandbox/CProgram/ASTanalysis/CodexUserStudyData/Autopilot/cushman-001_05/ref_testsuite_asan_noleak.json", "JSON", 0, 323, 0, 0, 0, 1, 324
"/Users/sbukhari/Sandbox/CProgram/ASTanalysis/CodexUserStudyData/Autopilot/cushman-001_06/api_report.json", "JSON", 0, 14, 0, 0, 0, 1, 15
"/Users/sbukhari/Sandbox/CProgram/ASTanalysis/CodexUserStudyData/Autopilot/cushman-001_06/list.c", "C", 150, 0, 0, 0, 72, 34, 256
"/Users/sbukhari/Sandbox/CProgram/ASTanalysis/CodexUserStudyData/Autopilot/cushman-001_06/orig_testsuite.json", "JSON", 0, 92, 0, 0, 0, 1, 93
"/Users/sbukhari/Sandbox/CProgram/ASTanalysis/CodexUserStudyData/Autopilot/cushman-001_06/orig_testsuite_asan.json", "JSON", 0, 92, 0, 0, 0, 1, 93
"/Users/sbukhari/Sandbox/CProgram/ASTanalysis/CodexUserStudyData/Autopilot/cushman-001_06/orig_testsuite_asan_noleak.json", "JSON", 0, 92, 0, 0, 0, 1, 93
"/Users/sbukhari/Sandbox/CProgram/ASTanalysis/CodexUserStudyData/Autopilot/cushman-001_06/parts/gen_list_add_item_at_pos.c", "C", 45, 0, 0, 0, 20, 10, 75
"/Users/sbukhari/Sandbox/CProgram/ASTanalysis/CodexUserStudyData/Autopilot/cushman-001_06/parts/gen_list_cost_sum.c", "C", 17, 0, 0, 0, 5, 5, 27
"/Users/sbukhari/Sandbox/CProgram/ASTanalysis/CodexUserStudyData/Autopilot/cushman-001_06/parts/gen_list_deduplicate.c", "C", 17, 0, 0, 0, 7, 5, 29
"/Users/sbukhari/Sandbox/CProgram/ASTanalysis/CodexUserStudyData/Autopilot/cushman-001_06/parts/gen_list_find_highest_price_item_position.c", "C", 17, 0, 0, 0, 5, 5, 27
"/Users/sbukhari/Sandbox/CProgram/ASTanalysis/CodexUserStudyData/Autopilot/cushman-001_06/parts/gen_list_init.c", "C", 18, 0, 0, 0, 5, 5, 28
"/Users/sbukhari/Sandbox/CProgram/ASTanalysis/CodexUserStudyData/Autopilot/cushman-001_06/parts/gen_list_item_to_string.c", "C", 32, 0, 0, 0, 11, 8, 51
"/Users/sbukhari/Sandbox/CProgram/ASTanalysis/CodexUserStudyData/Autopilot/cushman-001_06/parts/gen_list_load.c", "C", 17, 0, 0, 0, 9, 5, 31
"/Users/sbukhari/Sandbox/CProgram/ASTanalysis/CodexUserStudyData/Autopilot/cushman-001_06/parts/gen_list_print.c", "C", 32, 0, 0, 0, 20, 8, 60
"/Users/sbukhari/Sandbox/CProgram/ASTanalysis/CodexUserStudyData/Autopilot/cushman-001_06/parts/gen_list_remove_item_at_pos.c", "C", 39, 0, 0, 0, 9, 8, 56
"/Users/sbukhari/Sandbox/CProgram/ASTanalysis/CodexUserStudyData/Autopilot/cushman-001_06/parts/gen_list_save.c", "C", 17, 0, 0, 0, 8, 5, 30
"/Users/sbukhari/Sandbox/CProgram/ASTanalysis/CodexUserStudyData/Autopilot/cushman-001_06/parts/gen_list_swap_item_positions.c", "C", 17, 0, 0, 0, 5, 5, 27
"/Users/sbukhari/Sandbox/CProgram/ASTanalysis/CodexUserStudyData/Autopilot/cushman-001_06/parts/gen_list_update_item_at_pos.c", "C", 37, 0, 0, 0, 9, 8, 54
"/Users/sbukhari/Sandbox/CProgram/ASTanalysis/CodexUserStudyData/Autopilot/cushman-001_06/ref_testsuite.json", "JSON", 0, 323, 0, 0, 0, 1, 324
"/Users/sbukhari/Sandbox/CProgram/ASTanalysis/CodexUserStudyData/Autopilot/cushman-001_06/ref_testsuite_asan.json", "JSON", 0, 323, 0, 0, 0, 1, 324
"/Users/sbukhari/Sandbox/CProgram/ASTanalysis/CodexUserStudyData/Autopilot/cushman-001_06/ref_testsuite_asan_noleak.json", "JSON", 0, 323, 0, 0, 0, 1, 324
"/Users/sbukhari/Sandbox/CProgram/ASTanalysis/CodexUserStudyData/Autopilot/cushman-001_07/api_report.json", "JSON", 0, 14, 0, 0, 0, 1, 15
"/Users/sbukhari/Sandbox/CProgram/ASTanalysis/CodexUserStudyData/Autopilot/cushman-001_07/list.c", "C", 275, 0, 0, 0, 56, 51, 382
"/Users/sbukhari/Sandbox/CProgram/ASTanalysis/CodexUserStudyData/Autopilot/cushman-001_07/orig_testsuite.json", "JSON", 0, 92, 0, 0, 0, 1, 93
"/Users/sbukhari/Sandbox/CProgram/ASTanalysis/CodexUserStudyData/Autopilot/cushman-001_07/orig_testsuite_asan.json", "JSON", 0, 92, 0, 0, 0, 1, 93
"/Users/sbukhari/Sandbox/CProgram/ASTanalysis/CodexUserStudyData/Autopilot/cushman-001_07/orig_testsuite_asan_noleak.json", "JSON", 0, 92, 0, 0, 0, 1, 93
"/Users/sbukhari/Sandbox/CProgram/ASTanalysis/CodexUserStudyData/Autopilot/cushman-001_07/parts/gen_list_add_item_at_pos.c", "C", 59, 0, 0, 0, 16, 13, 88
"/Users/sbukhari/Sandbox/CProgram/ASTanalysis/CodexUserStudyData/Autopilot/cushman-001_07/parts/gen_list_cost_sum.c", "C", 27, 0, 0, 0, 5, 7, 39
"/Users/sbukhari/Sandbox/CProgram/ASTanalysis/CodexUserStudyData/Autopilot/cushman-001_07/parts/gen_list_deduplicate.c", "C", 41, 0, 0, 0, 7, 9, 57
"/Users/sbukhari/Sandbox/CProgram/ASTanalysis/CodexUserStudyData/Autopilot/cushman-001_07/parts/gen_list_find_highest_price_item_position.c", "C", 31, 0, 0, 0, 5, 7, 43
"/Users/sbukhari/Sandbox/CProgram/ASTanalysis/CodexUserStudyData/Autopilot/cushman-001_07/parts/gen_list_init.c", "C", 21, 0, 0, 0, 5, 6, 32
"/Users/sbukhari/Sandbox/CProgram/ASTanalysis/CodexUserStudyData/Autopilot/cushman-001_07/parts/gen_list_item_to_string.c", "C", 29, 0, 0, 0, 8, 6, 43
"/Users/sbukhari/Sandbox/CProgram/ASTanalysis/CodexUserStudyData/Autopilot/cushman-001_07/parts/gen_list_load.c", "C", 17, 0, 0, 0, 11, 5, 33
"/Users/sbukhari/Sandbox/CProgram/ASTanalysis/CodexUserStudyData/Autopilot/cushman-001_07/parts/gen_list_print.c", "C", 29, 0, 0, 0, 17, 7, 53
"/Users/sbukhari/Sandbox/CProgram/ASTanalysis/CodexUserStudyData/Autopilot/cushman-001_07/parts/gen_list_remove_item_at_pos.c", "C", 54, 0, 0, 0, 5, 9, 68
"/Users/sbukhari/Sandbox/CProgram/ASTanalysis/CodexUserStudyData/Autopilot/cushman-001_07/parts/gen_list_save.c", "C", 30, 0, 0, 0, 8, 8, 46
"/Users/sbukhari/Sandbox/CProgram/ASTanalysis/CodexUserStudyData/Autopilot/cushman-001_07/parts/gen_list_swap_item_positions.c", "C", 47, 0, 0, 0, 5, 9, 61
"/Users/sbukhari/Sandbox/CProgram/ASTanalysis/CodexUserStudyData/Autopilot/cushman-001_07/parts/gen_list_update_item_at_pos.c", "C", 45, 0, 0, 0, 5, 8, 58
"/Users/sbukhari/Sandbox/CProgram/ASTanalysis/CodexUserStudyData/Autopilot/cushman-001_07/ref_testsuite.json", "JSON", 0, 323, 0, 0, 0, 1, 324
"/Users/sbukhari/Sandbox/CProgram/ASTanalysis/CodexUserStudyData/Autopilot/cushman-001_07/ref_testsuite_asan.json", "JSON", 0, 323, 0, 0, 0, 1, 324
"/Users/sbukhari/Sandbox/CProgram/ASTanalysis/CodexUserStudyData/Autopilot/cushman-001_07/ref_testsuite_asan_noleak.json", "JSON", 0, 323, 0, 0, 0, 1, 324
"/Users/sbukhari/Sandbox/CProgram/ASTanalysis/CodexUserStudyData/Autopilot/cushman-001_08/api_report.json", "JSON", 0, 14, 0, 0, 0, 1, 15
"/Users/sbukhari/Sandbox/CProgram/ASTanalysis/CodexUserStudyData/Autopilot/cushman-001_08/list.c", "C", 193, 0, 0, 0, 78, 64, 335
"/Users/sbukhari/Sandbox/CProgram/ASTanalysis/CodexUserStudyData/Autopilot/cushman-001_08/orig_testsuite.json", "JSON", 0, 92, 0, 0, 0, 1, 93
"/Users/sbukhari/Sandbox/CProgram/ASTanalysis/CodexUserStudyData/Autopilot/cushman-001_08/orig_testsuite_asan.json", "JSON", 0, 92, 0, 0, 0, 1, 93
"/Users/sbukhari/Sandbox/CProgram/ASTanalysis/CodexUserStudyData/Autopilot/cushman-001_08/orig_testsuite_asan_noleak.json", "JSON", 0, 92, 0, 0, 0, 1, 93
"/Users/sbukhari/Sandbox/CProgram/ASTanalysis/CodexUserStudyData/Autopilot/cushman-001_08/parts/gen_list_add_item_at_pos.c", "C", 48, 0, 0, 0, 18, 11, 77
"/Users/sbukhari/Sandbox/CProgram/ASTanalysis/CodexUserStudyData/Autopilot/cushman-001_08/parts/gen_list_cost_sum.c", "C", 27, 0, 0, 0, 7, 9, 43
"/Users/sbukhari/Sandbox/CProgram/ASTanalysis/CodexUserStudyData/Autopilot/cushman-001_08/parts/gen_list_deduplicate.c", "C", 17, 0, 0, 0, 9, 5, 31
"/Users/sbukhari/Sandbox/CProgram/ASTanalysis/CodexUserStudyData/Autopilot/cushman-001_08/parts/gen_list_find_highest_price_item_position.c", "C", 30, 0, 0, 0, 7, 9, 46
"/Users/sbukhari/Sandbox/CProgram/ASTanalysis/CodexUserStudyData/Autopilot/cushman-001_08/parts/gen_list_init.c", "C", 18, 0, 0, 0, 5, 5, 28
"/Users/sbukhari/Sandbox/CProgram/ASTanalysis/CodexUserStudyData/Autopilot/cushman-001_08/parts/gen_list_item_to_string.c", "C", 32, 0, 0, 0, 11, 13, 56
"/Users/sbukhari/Sandbox/CProgram/ASTanalysis/CodexUserStudyData/Autopilot/cushman-001_08/parts/gen_list_load.c", "C", 17, 0, 0, 0, 11, 5, 33
"/Users/sbukhari/Sandbox/CProgram/ASTanalysis/CodexUserStudyData/Autopilot/cushman-001_08/parts/gen_list_print.c", "C", 26, 0, 0, 0, 17, 6, 49
"/Users/sbukhari/Sandbox/CProgram/ASTanalysis/CodexUserStudyData/Autopilot/cushman-001_08/parts/gen_list_remove_item_at_pos.c", "C", 35, 0, 0, 0, 8, 11, 54
"/Users/sbukhari/Sandbox/CProgram/ASTanalysis/CodexUserStudyData/Autopilot/cushman-001_08/parts/gen_list_save.c", "C", 29, 0, 0, 0, 11, 10, 50
"/Users/sbukhari/Sandbox/CProgram/ASTanalysis/CodexUserStudyData/Autopilot/cushman-001_08/parts/gen_list_swap_item_positions.c", "C", 40, 0, 0, 0, 8, 13, 61
"/Users/sbukhari/Sandbox/CProgram/ASTanalysis/CodexUserStudyData/Autopilot/cushman-001_08/parts/gen_list_update_item_at_pos.c", "C", 29, 0, 0, 0, 7, 10, 46
"/Users/sbukhari/Sandbox/CProgram/ASTanalysis/CodexUserStudyData/Autopilot/cushman-001_08/ref_testsuite.json", "JSON", 0, 323, 0, 0, 0, 1, 324
"/Users/sbukhari/Sandbox/CProgram/ASTanalysis/CodexUserStudyData/Autopilot/cushman-001_08/ref_testsuite_asan.json", "JSON", 0, 323, 0, 0, 0, 1, 324
"/Users/sbukhari/Sandbox/CProgram/ASTanalysis/CodexUserStudyData/Autopilot/cushman-001_08/ref_testsuite_asan_noleak.json", "JSON", 0, 323, 0, 0, 0, 1, 324
"/Users/sbukhari/Sandbox/CProgram/ASTanalysis/CodexUserStudyData/Autopilot/cushman-001_09/api_report.json", "JSON", 0, 14, 0, 0, 0, 1, 15
"/Users/sbukhari/Sandbox/CProgram/ASTanalysis/CodexUserStudyData/Autopilot/cushman-001_09/list.c", "C", 236, 0, 0, 0, 55, 17, 308
"/Users/sbukhari/Sandbox/CProgram/ASTanalysis/CodexUserStudyData/Autopilot/cushman-001_09/orig_testsuite.json", "JSON", 0, 92, 0, 0, 0, 1, 93
"/Users/sbukhari/Sandbox/CProgram/ASTanalysis/CodexUserStudyData/Autopilot/cushman-001_09/orig_testsuite_asan.json", "JSON", 0, 92, 0, 0, 0, 1, 93
"/Users/sbukhari/Sandbox/CProgram/ASTanalysis/CodexUserStudyData/Autopilot/cushman-001_09/orig_testsuite_asan_noleak.json", "JSON", 0, 92, 0, 0, 0, 1, 93
"/Users/sbukhari/Sandbox/CProgram/ASTanalysis/CodexUserStudyData/Autopilot/cushman-001_09/parts/gen_list_add_item_at_pos.c", "C", 42, 0, 0, 0, 15, 5, 62
"/Users/sbukhari/Sandbox/CProgram/ASTanalysis/CodexUserStudyData/Autopilot/cushman-001_09/parts/gen_list_cost_sum.c", "C", 28, 0, 0, 0, 5, 5, 38
"/Users/sbukhari/Sandbox/CProgram/ASTanalysis/CodexUserStudyData/Autopilot/cushman-001_09/parts/gen_list_deduplicate.c", "C", 39, 0, 0, 0, 7, 5, 51
"/Users/sbukhari/Sandbox/CProgram/ASTanalysis/CodexUserStudyData/Autopilot/cushman-001_09/parts/gen_list_find_highest_price_item_position.c", "C", 34, 0, 0, 0, 5, 5, 44
"/Users/sbukhari/Sandbox/CProgram/ASTanalysis/CodexUserStudyData/Autopilot/cushman-001_09/parts/gen_list_init.c", "C", 27, 0, 0, 0, 5, 5, 37
"/Users/sbukhari/Sandbox/CProgram/ASTanalysis/CodexUserStudyData/Autopilot/cushman-001_09/parts/gen_list_item_to_string.c", "C", 22, 0, 0, 0, 8, 5, 35
"/Users/sbukhari/Sandbox/CProgram/ASTanalysis/CodexUserStudyData/Autopilot/cushman-001_09/parts/gen_list_load.c", "C", 17, 0, 0, 0, 11, 5, 33
"/Users/sbukhari/Sandbox/CProgram/ASTanalysis/CodexUserStudyData/Autopilot/cushman-001_09/parts/gen_list_print.c", "C", 30, 0, 0, 0, 17, 5, 52
"/Users/sbukhari/Sandbox/CProgram/ASTanalysis/CodexUserStudyData/Autopilot/cushman-001_09/parts/gen_list_remove_item_at_pos.c", "C", 37, 0, 0, 0, 5, 5, 47
"/Users/sbukhari/Sandbox/CProgram/ASTanalysis/CodexUserStudyData/Autopilot/cushman-001_09/parts/gen_list_save.c", "C", 30, 0, 0, 0, 8, 5, 43
"/Users/sbukhari/Sandbox/CProgram/ASTanalysis/CodexUserStudyData/Autopilot/cushman-001_09/parts/gen_list_swap_item_positions.c", "C", 55, 0, 0, 0, 5, 5, 65
"/Users/sbukhari/Sandbox/CProgram/ASTanalysis/CodexUserStudyData/Autopilot/cushman-001_09/parts/gen_list_update_item_at_pos.c", "C", 30, 0, 0, 0, 5, 5, 40
"/Users/sbukhari/Sandbox/CProgram/ASTanalysis/CodexUserStudyData/Autopilot/cushman-001_09/ref_testsuite.json", "JSON", 0, 323, 0, 0, 0, 1, 324
"/Users/sbukhari/Sandbox/CProgram/ASTanalysis/CodexUserStudyData/Autopilot/cushman-001_09/ref_testsuite_asan.json", "JSON", 0, 323, 0, 0, 0, 1, 324
"/Users/sbukhari/Sandbox/CProgram/ASTanalysis/CodexUserStudyData/Autopilot/cushman-001_09/ref_testsuite_asan_noleak.json", "JSON", 0, 323, 0, 0, 0, 1, 324
"/Users/sbukhari/Sandbox/CProgram/ASTanalysis/CodexUserStudyData/Autopilot/davinci-001_00/api_report.json", "JSON", 0, 14, 0, 0, 0, 1, 15
"/Users/sbukhari/Sandbox/CProgram/ASTanalysis/CodexUserStudyData/Autopilot/davinci-001_00/list.c", "C", 334, 0, 0, 0, 53, 17, 404
"/Users/sbukhari/Sandbox/CProgram/ASTanalysis/CodexUserStudyData/Autopilot/davinci-001_00/orig_testsuite.json", "JSON", 0, 92, 0, 0, 0, 1, 93
"/Users/sbukhari/Sandbox/CProgram/ASTanalysis/CodexUserStudyData/Autopilot/davinci-001_00/orig_testsuite_asan.json", "JSON", 0, 92, 0, 0, 0, 1, 93
"/Users/sbukhari/Sandbox/CProgram/ASTanalysis/CodexUserStudyData/Autopilot/davinci-001_00/orig_testsuite_asan_noleak.json", "JSON", 0, 92, 0, 0, 0, 1, 93
"/Users/sbukhari/Sandbox/CProgram/ASTanalysis/CodexUserStudyData/Autopilot/davinci-001_00/parts/gen_list_add_item_at_pos.c", "C", 44, 0, 0, 0, 15, 5, 64
"/Users/sbukhari/Sandbox/CProgram/ASTanalysis/CodexUserStudyData/Autopilot/davinci-001_00/parts/gen_list_cost_sum.c", "C", 28, 0, 0, 0, 5, 5, 38
"/Users/sbukhari/Sandbox/CProgram/ASTanalysis/CodexUserStudyData/Autopilot/davinci-001_00/parts/gen_list_deduplicate.c", "C", 40, 0, 0, 0, 7, 5, 52
"/Users/sbukhari/Sandbox/CProgram/ASTanalysis/CodexUserStudyData/Autopilot/davinci-001_00/parts/gen_list_find_highest_price_item_position.c", "C", 32, 0, 0, 0, 5, 5, 42
"/Users/sbukhari/Sandbox/CProgram/ASTanalysis/CodexUserStudyData/Autopilot/davinci-001_00/parts/gen_list_init.c", "C", 22, 0, 0, 0, 5, 5, 32
"/Users/sbukhari/Sandbox/CProgram/ASTanalysis/CodexUserStudyData/Autopilot/davinci-001_00/parts/gen_list_item_to_string.c", "C", 54, 0, 0, 0, 8, 5, 67
"/Users/sbukhari/Sandbox/CProgram/ASTanalysis/CodexUserStudyData/Autopilot/davinci-001_00/parts/gen_list_load.c", "C", 60, 0, 0, 0, 9, 5, 74
"/Users/sbukhari/Sandbox/CProgram/ASTanalysis/CodexUserStudyData/Autopilot/davinci-001_00/parts/gen_list_print.c", "C", 57, 0, 0, 0, 17, 5, 79
"/Users/sbukhari/Sandbox/CProgram/ASTanalysis/CodexUserStudyData/Autopilot/davinci-001_00/parts/gen_list_remove_item_at_pos.c", "C", 33, 0, 0, 0, 5, 5, 43
"/Users/sbukhari/Sandbox/CProgram/ASTanalysis/CodexUserStudyData/Autopilot/davinci-001_00/parts/gen_list_save.c", "C", 38, 0, 0, 0, 8, 5, 51
"/Users/sbukhari/Sandbox/CProgram/ASTanalysis/CodexUserStudyData/Autopilot/davinci-001_00/parts/gen_list_swap_item_positions.c", "C", 47, 0, 0, 0, 5, 5, 57
"/Users/sbukhari/Sandbox/CProgram/ASTanalysis/CodexUserStudyData/Autopilot/davinci-001_00/parts/gen_list_update_item_at_pos.c", "C", 34, 0, 0, 0, 5, 5, 44
"/Users/sbukhari/Sandbox/CProgram/ASTanalysis/CodexUserStudyData/Autopilot/davinci-001_00/ref_testsuite.json", "JSON", 0, 323, 0, 0, 0, 1, 324
"/Users/sbukhari/Sandbox/CProgram/ASTanalysis/CodexUserStudyData/Autopilot/davinci-001_00/ref_testsuite_asan.json", "JSON", 0, 323, 0, 0, 0, 1, 324
"/Users/sbukhari/Sandbox/CProgram/ASTanalysis/CodexUserStudyData/Autopilot/davinci-001_00/ref_testsuite_asan_noleak.json", "JSON", 0, 323, 0, 0, 0, 1, 324
"/Users/sbukhari/Sandbox/CProgram/ASTanalysis/CodexUserStudyData/Autopilot/davinci-001_01/api_report.json", "JSON", 0, 14, 0, 0, 0, 1, 15
"/Users/sbukhari/Sandbox/CProgram/ASTanalysis/CodexUserStudyData/Autopilot/davinci-001_01/list.c", "C", 315, 0, 0, 0, 108, 17, 440
"/Users/sbukhari/Sandbox/CProgram/ASTanalysis/CodexUserStudyData/Autopilot/davinci-001_01/orig_testsuite.json", "JSON", 0, 92, 0, 0, 0, 1, 93
"/Users/sbukhari/Sandbox/CProgram/ASTanalysis/CodexUserStudyData/Autopilot/davinci-001_01/orig_testsuite_asan.json", "JSON", 0, 92, 0, 0, 0, 1, 93
"/Users/sbukhari/Sandbox/CProgram/ASTanalysis/CodexUserStudyData/Autopilot/davinci-001_01/orig_testsuite_asan_noleak.json", "JSON", 0, 92, 0, 0, 0, 1, 93
"/Users/sbukhari/Sandbox/CProgram/ASTanalysis/CodexUserStudyData/Autopilot/davinci-001_01/parts/gen_list_add_item_at_pos.c", "C", 45, 0, 0, 0, 20, 5, 70
"/Users/sbukhari/Sandbox/CProgram/ASTanalysis/CodexUserStudyData/Autopilot/davinci-001_01/parts/gen_list_cost_sum.c", "C", 29, 0, 0, 0, 8, 5, 42
"/Users/sbukhari/Sandbox/CProgram/ASTanalysis/CodexUserStudyData/Autopilot/davinci-001_01/parts/gen_list_deduplicate.c", "C", 35, 0, 0, 0, 11, 5, 51
"/Users/sbukhari/Sandbox/CProgram/ASTanalysis/CodexUserStudyData/Autopilot/davinci-001_01/parts/gen_list_find_highest_price_item_position.c", "C", 33, 0, 0, 0, 9, 5, 47
"/Users/sbukhari/Sandbox/CProgram/ASTanalysis/CodexUserStudyData/Autopilot/davinci-001_01/parts/gen_list_init.c", "C", 25, 0, 0, 0, 5, 5, 35
"/Users/sbukhari/Sandbox/CProgram/ASTanalysis/CodexUserStudyData/Autopilot/davinci-001_01/parts/gen_list_item_to_string.c", "C", 38, 0, 0, 0, 17, 5, 60
"/Users/sbukhari/Sandbox/CProgram/ASTanalysis/CodexUserStudyData/Autopilot/davinci-001_01/parts/gen_list_load.c", "C", 45, 0, 0, 0, 9, 5, 59
"/Users/sbukhari/Sandbox/CProgram/ASTanalysis/CodexUserStudyData/Autopilot/davinci-001_01/parts/gen_list_print.c", "C", 41, 0, 0, 0, 26, 5, 72
"/Users/sbukhari/Sandbox/CProgram/ASTanalysis/CodexUserStudyData/Autopilot/davinci-001_01/parts/gen_list_remove_item_at_pos.c", "C", 42, 0, 0, 0, 10, 5, 57
"/Users/sbukhari/Sandbox/CProgram/ASTanalysis/CodexUserStudyData/Autopilot/davinci-001_01/parts/gen_list_save.c", "C", 38, 0, 0, 0, 8, 5, 51
"/Users/sbukhari/Sandbox/CProgram/ASTanalysis/CodexUserStudyData/Autopilot/davinci-001_01/parts/gen_list_swap_item_positions.c", "C", 56, 0, 0, 0, 13, 5, 74
"/Users/sbukhari/Sandbox/CProgram/ASTanalysis/CodexUserStudyData/Autopilot/davinci-001_01/parts/gen_list_update_item_at_pos.c", "C", 43, 0, 0, 0, 13, 5, 61
"/Users/sbukhari/Sandbox/CProgram/ASTanalysis/CodexUserStudyData/Autopilot/davinci-001_01/ref_testsuite.json", "JSON", 0, 323, 0, 0, 0, 1, 324
"/Users/sbukhari/Sandbox/CProgram/ASTanalysis/CodexUserStudyData/Autopilot/davinci-001_01/ref_testsuite_asan.json", "JSON", 0, 323, 0, 0, 0, 1, 324
"/Users/sbukhari/Sandbox/CProgram/ASTanalysis/CodexUserStudyData/Autopilot/davinci-001_01/ref_testsuite_asan_noleak.json", "JSON", 0, 323, 0, 0, 0, 1, 324
"/Users/sbukhari/Sandbox/CProgram/ASTanalysis/CodexUserStudyData/Autopilot/davinci-001_02/api_report.json", "JSON", 0, 14, 0, 0, 0, 1, 15
"/Users/sbukhari/Sandbox/CProgram/ASTanalysis/CodexUserStudyData/Autopilot/davinci-001_02/list.c", "C", 122, 0, 0, 0, 80, 31, 233
"/Users/sbukhari/Sandbox/CProgram/ASTanalysis/CodexUserStudyData/Autopilot/davinci-001_02/orig_testsuite.json", "JSON", 0, 92, 0, 0, 0, 1, 93
"/Users/sbukhari/Sandbox/CProgram/ASTanalysis/CodexUserStudyData/Autopilot/davinci-001_02/orig_testsuite_asan.json", "JSON", 0, 92, 0, 0, 0, 1, 93
"/Users/sbukhari/Sandbox/CProgram/ASTanalysis/CodexUserStudyData/Autopilot/davinci-001_02/orig_testsuite_asan_noleak.json", "JSON", 0, 92, 0, 0, 0, 1, 93
"/Users/sbukhari/Sandbox/CProgram/ASTanalysis/CodexUserStudyData/Autopilot/davinci-001_02/parts/gen_list_add_item_at_pos.c", "C", 17, 0, 0, 0, 17, 5, 39
"/Users/sbukhari/Sandbox/CProgram/ASTanalysis/CodexUserStudyData/Autopilot/davinci-001_02/parts/gen_list_cost_sum.c", "C", 17, 0, 0, 0, 7, 5, 29
"/Users/sbukhari/Sandbox/CProgram/ASTanalysis/CodexUserStudyData/Autopilot/davinci-001_02/parts/gen_list_deduplicate.c", "C", 17, 0, 0, 0, 9, 5, 31
"/Users/sbukhari/Sandbox/CProgram/ASTanalysis/CodexUserStudyData/Autopilot/davinci-001_02/parts/gen_list_find_highest_price_item_position.c", "C", 17, 0, 0, 0, 7, 5, 29
"/Users/sbukhari/Sandbox/CProgram/ASTanalysis/CodexUserStudyData/Autopilot/davinci-001_02/parts/gen_list_init.c", "C", 22, 0, 0, 0, 6, 6, 34
"/Users/sbukhari/Sandbox/CProgram/ASTanalysis/CodexUserStudyData/Autopilot/davinci-001_02/parts/gen_list_item_to_string.c", "C", 27, 0, 0, 0, 11, 8, 46
"/Users/sbukhari/Sandbox/CProgram/ASTanalysis/CodexUserStudyData/Autopilot/davinci-001_02/parts/gen_list_load.c", "C", 49, 0, 0, 0, 15, 10, 74
"/Users/sbukhari/Sandbox/CProgram/ASTanalysis/CodexUserStudyData/Autopilot/davinci-001_02/parts/gen_list_print.c", "C", 30, 0, 0, 0, 19, 7, 56
"/Users/sbukhari/Sandbox/CProgram/ASTanalysis/CodexUserStudyData/Autopilot/davinci-001_02/parts/gen_list_remove_item_at_pos.c", "C", 17, 0, 0, 0, 7, 5, 29
"/Users/sbukhari/Sandbox/CProgram/ASTanalysis/CodexUserStudyData/Autopilot/davinci-001_02/parts/gen_list_save.c", "C", 30, 0, 0, 0, 9, 8, 47
"/Users/sbukhari/Sandbox/CProgram/ASTanalysis/CodexUserStudyData/Autopilot/davinci-001_02/parts/gen_list_swap_item_positions.c", "C", 17, 0, 0, 0, 7, 5, 29
"/Users/sbukhari/Sandbox/CProgram/ASTanalysis/CodexUserStudyData/Autopilot/davinci-001_02/parts/gen_list_update_item_at_pos.c", "C", 17, 0, 0, 0, 7, 5, 29
"/Users/sbukhari/Sandbox/CProgram/ASTanalysis/CodexUserStudyData/Autopilot/davinci-001_02/ref_testsuite.json", "JSON", 0, 323, 0, 0, 0, 1, 324
"/Users/sbukhari/Sandbox/CProgram/ASTanalysis/CodexUserStudyData/Autopilot/davinci-001_02/ref_testsuite_asan.json", "JSON", 0, 323, 0, 0, 0, 1, 324
"/Users/sbukhari/Sandbox/CProgram/ASTanalysis/CodexUserStudyData/Autopilot/davinci-001_02/ref_testsuite_asan_noleak.json", "JSON", 0, 323, 0, 0, 0, 1, 324
"/Users/sbukhari/Sandbox/CProgram/ASTanalysis/CodexUserStudyData/Autopilot/davinci-001_03/api_report.json", "JSON", 0, 14, 0, 0, 0, 1, 15
"/Users/sbukhari/Sandbox/CProgram/ASTanalysis/CodexUserStudyData/Autopilot/davinci-001_03/list.c", "C", 236, 0, 0, 0, 54, 17, 307
"/Users/sbukhari/Sandbox/CProgram/ASTanalysis/CodexUserStudyData/Autopilot/davinci-001_03/orig_testsuite.json", "JSON", 0, 92, 0, 0, 0, 1, 93
"/Users/sbukhari/Sandbox/CProgram/ASTanalysis/CodexUserStudyData/Autopilot/davinci-001_03/orig_testsuite_asan.json", "JSON", 0, 92, 0, 0, 0, 1, 93
"/Users/sbukhari/Sandbox/CProgram/ASTanalysis/CodexUserStudyData/Autopilot/davinci-001_03/orig_testsuite_asan_noleak.json", "JSON", 0, 92, 0, 0, 0, 1, 93
"/Users/sbukhari/Sandbox/CProgram/ASTanalysis/CodexUserStudyData/Autopilot/davinci-001_03/parts/gen_list_add_item_at_pos.c", "C", 38, 0, 0, 0, 15, 5, 58
"/Users/sbukhari/Sandbox/CProgram/ASTanalysis/CodexUserStudyData/Autopilot/davinci-001_03/parts/gen_list_cost_sum.c", "C", 24, 0, 0, 0, 5, 5, 34
"/Users/sbukhari/Sandbox/CProgram/ASTanalysis/CodexUserStudyData/Autopilot/davinci-001_03/parts/gen_list_deduplicate.c", "C", 30, 0, 0, 0, 8, 5, 43
"/Users/sbukhari/Sandbox/CProgram/ASTanalysis/CodexUserStudyData/Autopilot/davinci-001_03/parts/gen_list_find_highest_price_item_position.c", "C", 30, 0, 0, 0, 5, 5, 40
"/Users/sbukhari/Sandbox/CProgram/ASTanalysis/CodexUserStudyData/Autopilot/davinci-001_03/parts/gen_list_init.c", "C", 18, 0, 0, 0, 5, 5, 28
"/Users/sbukhari/Sandbox/CProgram/ASTanalysis/CodexUserStudyData/Autopilot/davinci-001_03/parts/gen_list_item_to_string.c", "C", 30, 0, 0, 0, 8, 5, 43
"/Users/sbukhari/Sandbox/CProgram/ASTanalysis/CodexUserStudyData/Autopilot/davinci-001_03/parts/gen_list_load.c", "C", 57, 0, 0, 0, 9, 5, 71
"/Users/sbukhari/Sandbox/CProgram/ASTanalysis/CodexUserStudyData/Autopilot/davinci-001_03/parts/gen_list_print.c", "C", 24, 0, 0, 0, 17, 5, 46
"/Users/sbukhari/Sandbox/CProgram/ASTanalysis/CodexUserStudyData/Autopilot/davinci-001_03/parts/gen_list_remove_item_at_pos.c", "C", 35, 0, 0, 0, 5, 5, 45
"/Users/sbukhari/Sandbox/CProgram/ASTanalysis/CodexUserStudyData/Autopilot/davinci-001_03/parts/gen_list_save.c", "C", 27, 0, 0, 0, 8, 5, 40
"/Users/sbukhari/Sandbox/CProgram/ASTanalysis/CodexUserStudyData/Autopilot/davinci-001_03/parts/gen_list_swap_item_positions.c", "C", 49, 0, 0, 0, 5, 5, 59
"/Users/sbukhari/Sandbox/CProgram/ASTanalysis/CodexUserStudyData/Autopilot/davinci-001_03/parts/gen_list_update_item_at_pos.c", "C", 29, 0, 0, 0, 5, 5, 39
"/Users/sbukhari/Sandbox/CProgram/ASTanalysis/CodexUserStudyData/Autopilot/davinci-001_03/ref_testsuite.json", "JSON", 0, 323, 0, 0, 0, 1, 324
"/Users/sbukhari/Sandbox/CProgram/ASTanalysis/CodexUserStudyData/Autopilot/davinci-001_03/ref_testsuite_asan.json", "JSON", 0, 323, 0, 0, 0, 1, 324
"/Users/sbukhari/Sandbox/CProgram/ASTanalysis/CodexUserStudyData/Autopilot/davinci-001_03/ref_testsuite_asan_noleak.json", "JSON", 0, 323, 0, 0, 0, 1, 324
"/Users/sbukhari/Sandbox/CProgram/ASTanalysis/CodexUserStudyData/Autopilot/davinci-001_04/api_report.json", "JSON", 0, 14, 0, 0, 0, 1, 15
"/Users/sbukhari/Sandbox/CProgram/ASTanalysis/CodexUserStudyData/Autopilot/davinci-001_04/list.c", "C", 236, 0, 0, 0, 53, 28, 317
"/Users/sbukhari/Sandbox/CProgram/ASTanalysis/CodexUserStudyData/Autopilot/davinci-001_04/orig_testsuite.json", "JSON", 0, 92, 0, 0, 0, 1, 93
"/Users/sbukhari/Sandbox/CProgram/ASTanalysis/CodexUserStudyData/Autopilot/davinci-001_04/orig_testsuite_asan.json", "JSON", 0, 92, 0, 0, 0, 1, 93
"/Users/sbukhari/Sandbox/CProgram/ASTanalysis/CodexUserStudyData/Autopilot/davinci-001_04/orig_testsuite_asan_noleak.json", "JSON", 0, 92, 0, 0, 0, 1, 93
"/Users/sbukhari/Sandbox/CProgram/ASTanalysis/CodexUserStudyData/Autopilot/davinci-001_04/parts/gen_list_add_item_at_pos.c", "C", 35, 0, 0, 0, 15, 7, 57
"/Users/sbukhari/Sandbox/CProgram/ASTanalysis/CodexUserStudyData/Autopilot/davinci-001_04/parts/gen_list_cost_sum.c", "C", 27, 0, 0, 0, 5, 5, 37
"/Users/sbukhari/Sandbox/CProgram/ASTanalysis/CodexUserStudyData/Autopilot/davinci-001_04/parts/gen_list_deduplicate.c", "C", 39, 0, 0, 0, 7, 5, 51
"/Users/sbukhari/Sandbox/CProgram/ASTanalysis/CodexUserStudyData/Autopilot/davinci-001_04/parts/gen_list_find_highest_price_item_position.c", "C", 33, 0, 0, 0, 5, 5, 43
"/Users/sbukhari/Sandbox/CProgram/ASTanalysis/CodexUserStudyData/Autopilot/davinci-001_04/parts/gen_list_init.c", "C", 22, 0, 0, 0, 5, 5, 32
"/Users/sbukhari/Sandbox/CProgram/ASTanalysis/CodexUserStudyData/Autopilot/davinci-001_04/parts/gen_list_item_to_string.c", "C", 28, 0, 0, 0, 8, 6, 42
"/Users/sbukhari/Sandbox/CProgram/ASTanalysis/CodexUserStudyData/Autopilot/davinci-001_04/parts/gen_list_load.c", "C", 40, 0, 0, 0, 9, 5, 54
"/Users/sbukhari/Sandbox/CProgram/ASTanalysis/CodexUserStudyData/Autopilot/davinci-001_04/parts/gen_list_print.c", "C", 30, 0, 0, 0, 17, 5, 52
"/Users/sbukhari/Sandbox/CProgram/ASTanalysis/CodexUserStudyData/Autopilot/davinci-001_04/parts/gen_list_remove_item_at_pos.c", "C", 32, 0, 0, 0, 5, 7, 44
"/Users/sbukhari/Sandbox/CProgram/ASTanalysis/CodexUserStudyData/Autopilot/davinci-001_04/parts/gen_list_save.c", "C", 30, 0, 0, 0, 8, 5, 43
"/Users/sbukhari/Sandbox/CProgram/ASTanalysis/CodexUserStudyData/Autopilot/davinci-001_04/parts/gen_list_swap_item_positions.c", "C", 43, 0, 0, 0, 5, 9, 57
"/Users/sbukhari/Sandbox/CProgram/ASTanalysis/CodexUserStudyData/Autopilot/davinci-001_04/parts/gen_list_update_item_at_pos.c", "C", 32, 0, 0, 0, 5, 7, 44
"/Users/sbukhari/Sandbox/CProgram/ASTanalysis/CodexUserStudyData/Autopilot/davinci-001_04/ref_testsuite.json", "JSON", 0, 323, 0, 0, 0, 1, 324
"/Users/sbukhari/Sandbox/CProgram/ASTanalysis/CodexUserStudyData/Autopilot/davinci-001_04/ref_testsuite_asan.json", "JSON", 0, 323, 0, 0, 0, 1, 324
"/Users/sbukhari/Sandbox/CProgram/ASTanalysis/CodexUserStudyData/Autopilot/davinci-001_04/ref_testsuite_asan_noleak.json", "JSON", 0, 323, 0, 0, 0, 1, 324
"/Users/sbukhari/Sandbox/CProgram/ASTanalysis/CodexUserStudyData/Autopilot/davinci-001_05/api_report.json", "JSON", 0, 14, 0, 0, 0, 1, 15
"/Users/sbukhari/Sandbox/CProgram/ASTanalysis/CodexUserStudyData/Autopilot/davinci-001_05/list.c", "C", 186, 0, 0, 0, 89, 47, 322
"/Users/sbukhari/Sandbox/CProgram/ASTanalysis/CodexUserStudyData/Autopilot/davinci-001_05/orig_testsuite.json", "JSON", 0, 92, 0, 0, 0, 1, 93
"/Users/sbukhari/Sandbox/CProgram/ASTanalysis/CodexUserStudyData/Autopilot/davinci-001_05/orig_testsuite_asan.json", "JSON", 0, 92, 0, 0, 0, 1, 93
"/Users/sbukhari/Sandbox/CProgram/ASTanalysis/CodexUserStudyData/Autopilot/davinci-001_05/orig_testsuite_asan_noleak.json", "JSON", 0, 92, 0, 0, 0, 1, 93
"/Users/sbukhari/Sandbox/CProgram/ASTanalysis/CodexUserStudyData/Autopilot/davinci-001_05/parts/gen_list_add_item_at_pos.c", "C", 17, 0, 0, 0, 17, 5, 39
"/Users/sbukhari/Sandbox/CProgram/ASTanalysis/CodexUserStudyData/Autopilot/davinci-001_05/parts/gen_list_cost_sum.c", "C", 32, 0, 0, 0, 8, 9, 49
"/Users/sbukhari/Sandbox/CProgram/ASTanalysis/CodexUserStudyData/Autopilot/davinci-001_05/parts/gen_list_deduplicate.c", "C", 38, 0, 0, 0, 9, 7, 54
"/Users/sbukhari/Sandbox/CProgram/ASTanalysis/CodexUserStudyData/Autopilot/davinci-001_05/parts/gen_list_find_highest_price_item_position.c", "C", 17, 0, 0, 0, 7, 5, 29
"/Users/sbukhari/Sandbox/CProgram/ASTanalysis/CodexUserStudyData/Autopilot/davinci-001_05/parts/gen_list_init.c", "C", 26, 0, 0, 0, 7, 7, 40
"/Users/sbukhari/Sandbox/CProgram/ASTanalysis/CodexUserStudyData/Autopilot/davinci-001_05/parts/gen_list_item_to_string.c", "C", 48, 0, 0, 0, 18, 15, 81
"/Users/sbukhari/Sandbox/CProgram/ASTanalysis/CodexUserStudyData/Autopilot/davinci-001_05/parts/gen_list_load.c", "C", 46, 0, 0, 0, 13, 9, 68
"/Users/sbukhari/Sandbox/CProgram/ASTanalysis/CodexUserStudyData/Autopilot/davinci-001_05/parts/gen_list_print.c", "C", 30, 0, 0, 0, 19, 8, 57
"/Users/sbukhari/Sandbox/CProgram/ASTanalysis/CodexUserStudyData/Autopilot/davinci-001_05/parts/gen_list_remove_item_at_pos.c", "C", 17, 0, 0, 0, 7, 5, 29
"/Users/sbukhari/Sandbox/CProgram/ASTanalysis/CodexUserStudyData/Autopilot/davinci-001_05/parts/gen_list_save.c", "C", 36, 0, 0, 0, 11, 10, 57
"/Users/sbukhari/Sandbox/CProgram/ASTanalysis/CodexUserStudyData/Autopilot/davinci-001_05/parts/gen_list_swap_item_positions.c", "C", 17, 0, 0, 0, 7, 5, 29
"/Users/sbukhari/Sandbox/CProgram/ASTanalysis/CodexUserStudyData/Autopilot/davinci-001_05/parts/gen_list_update_item_at_pos.c", "C", 17, 0, 0, 0, 7, 5, 29
"/Users/sbukhari/Sandbox/CProgram/ASTanalysis/CodexUserStudyData/Autopilot/davinci-001_05/ref_testsuite.json", "JSON", 0, 323, 0, 0, 0, 1, 324
"/Users/sbukhari/Sandbox/CProgram/ASTanalysis/CodexUserStudyData/Autopilot/davinci-001_05/ref_testsuite_asan.json", "JSON", 0, 323, 0, 0, 0, 1, 324
"/Users/sbukhari/Sandbox/CProgram/ASTanalysis/CodexUserStudyData/Autopilot/davinci-001_05/ref_testsuite_asan_noleak.json", "JSON", 0, 323, 0, 0, 0, 1, 324
"/Users/sbukhari/Sandbox/CProgram/ASTanalysis/CodexUserStudyData/Autopilot/davinci-001_06/api_report.json", "JSON", 0, 14, 0, 0, 0, 1, 15
"/Users/sbukhari/Sandbox/CProgram/ASTanalysis/CodexUserStudyData/Autopilot/davinci-001_06/list.c", "C", 308, 0, 0, 0, 53, 17, 378
"/Users/sbukhari/Sandbox/CProgram/ASTanalysis/CodexUserStudyData/Autopilot/davinci-001_06/orig_testsuite.json", "JSON", 0, 92, 0, 0, 0, 1, 93
"/Users/sbukhari/Sandbox/CProgram/ASTanalysis/CodexUserStudyData/Autopilot/davinci-001_06/orig_testsuite_asan.json", "JSON", 0, 92, 0, 0, 0, 1, 93
"/Users/sbukhari/Sandbox/CProgram/ASTanalysis/CodexUserStudyData/Autopilot/davinci-001_06/orig_testsuite_asan_noleak.json", "JSON", 0, 92, 0, 0, 0, 1, 93
"/Users/sbukhari/Sandbox/CProgram/ASTanalysis/CodexUserStudyData/Autopilot/davinci-001_06/parts/gen_list_add_item_at_pos.c", "C", 60, 0, 0, 0, 15, 5, 80
"/Users/sbukhari/Sandbox/CProgram/ASTanalysis/CodexUserStudyData/Autopilot/davinci-001_06/parts/gen_list_cost_sum.c", "C", 27, 0, 0, 0, 5, 5, 37
"/Users/sbukhari/Sandbox/CProgram/ASTanalysis/CodexUserStudyData/Autopilot/davinci-001_06/parts/gen_list_deduplicate.c", "C", 36, 0, 0, 0, 7, 5, 48
"/Users/sbukhari/Sandbox/CProgram/ASTanalysis/CodexUserStudyData/Autopilot/davinci-001_06/parts/gen_list_find_highest_price_item_position.c", "C", 32, 0, 0, 0, 5, 5, 42
"/Users/sbukhari/Sandbox/CProgram/ASTanalysis/CodexUserStudyData/Autopilot/davinci-001_06/parts/gen_list_init.c", "C", 26, 0, 0, 0, 5, 5, 36
"/Users/sbukhari/Sandbox/CProgram/ASTanalysis/CodexUserStudyData/Autopilot/davinci-001_06/parts/gen_list_item_to_string.c", "C", 32, 0, 0, 0, 8, 5, 45
"/Users/sbukhari/Sandbox/CProgram/ASTanalysis/CodexUserStudyData/Autopilot/davinci-001_06/parts/gen_list_load.c", "C", 44, 0, 0, 0, 9, 5, 58
"/Users/sbukhari/Sandbox/CProgram/ASTanalysis/CodexUserStudyData/Autopilot/davinci-001_06/parts/gen_list_print.c", "C", 34, 0, 0, 0, 17, 5, 56
"/Users/sbukhari/Sandbox/CProgram/ASTanalysis/CodexUserStudyData/Autopilot/davinci-001_06/parts/gen_list_remove_item_at_pos.c", "C", 39, 0, 0, 0, 5, 5, 49
"/Users/sbukhari/Sandbox/CProgram/ASTanalysis/CodexUserStudyData/Autopilot/davinci-001_06/parts/gen_list_save.c", "C", 36, 0, 0, 0, 8, 5, 49
"/Users/sbukhari/Sandbox/CProgram/ASTanalysis/CodexUserStudyData/Autopilot/davinci-001_06/parts/gen_list_swap_item_positions.c", "C", 59, 0, 0, 0, 5, 5, 69
"/Users/sbukhari/Sandbox/CProgram/ASTanalysis/CodexUserStudyData/Autopilot/davinci-001_06/parts/gen_list_update_item_at_pos.c", "C", 38, 0, 0, 0, 5, 5, 48
"/Users/sbukhari/Sandbox/CProgram/ASTanalysis/CodexUserStudyData/Autopilot/davinci-001_06/ref_testsuite.json", "JSON", 0, 323, 0, 0, 0, 1, 324
"/Users/sbukhari/Sandbox/CProgram/ASTanalysis/CodexUserStudyData/Autopilot/davinci-001_06/ref_testsuite_asan.json", "JSON", 0, 323, 0, 0, 0, 1, 324
"/Users/sbukhari/Sandbox/CProgram/ASTanalysis/CodexUserStudyData/Autopilot/davinci-001_06/ref_testsuite_asan_noleak.json", "JSON", 0, 323, 0, 0, 0, 1, 324
"/Users/sbukhari/Sandbox/CProgram/ASTanalysis/CodexUserStudyData/Autopilot/davinci-001_07/api_report.json", "JSON", 0, 14, 0, 0, 0, 1, 15
"/Users/sbukhari/Sandbox/CProgram/ASTanalysis/CodexUserStudyData/Autopilot/davinci-001_07/list.c", "C", 222, 0, 0, 0, 54, 72, 348
"/Users/sbukhari/Sandbox/CProgram/ASTanalysis/CodexUserStudyData/Autopilot/davinci-001_07/orig_testsuite.json", "JSON", 0, 92, 0, 0, 0, 1, 93
"/Users/sbukhari/Sandbox/CProgram/ASTanalysis/CodexUserStudyData/Autopilot/davinci-001_07/orig_testsuite_asan.json", "JSON", 0, 92, 0, 0, 0, 1, 93
"/Users/sbukhari/Sandbox/CProgram/ASTanalysis/CodexUserStudyData/Autopilot/davinci-001_07/orig_testsuite_asan_noleak.json", "JSON", 0, 92, 0, 0, 0, 1, 93
"/Users/sbukhari/Sandbox/CProgram/ASTanalysis/CodexUserStudyData/Autopilot/davinci-001_07/parts/gen_list_add_item_at_pos.c", "C", 45, 0, 0, 0, 15, 16, 76
"/Users/sbukhari/Sandbox/CProgram/ASTanalysis/CodexUserStudyData/Autopilot/davinci-001_07/parts/gen_list_cost_sum.c", "C", 26, 0, 0, 0, 5, 7, 38
"/Users/sbukhari/Sandbox/CProgram/ASTanalysis/CodexUserStudyData/Autopilot/davinci-001_07/parts/gen_list_deduplicate.c", "C", 34, 0, 0, 0, 7, 9, 50
"/Users/sbukhari/Sandbox/CProgram/ASTanalysis/CodexUserStudyData/Autopilot/davinci-001_07/parts/gen_list_find_highest_price_item_position.c", "C", 32, 0, 0, 0, 5, 10, 47
"/Users/sbukhari/Sandbox/CProgram/ASTanalysis/CodexUserStudyData/Autopilot/davinci-001_07/parts/gen_list_init.c", "C", 21, 0, 0, 0, 5, 8, 34
"/Users/sbukhari/Sandbox/CProgram/ASTanalysis/CodexUserStudyData/Autopilot/davinci-001_07/parts/gen_list_item_to_string.c", "C", 25, 0, 0, 0, 8, 8, 41
"/Users/sbukhari/Sandbox/CProgram/ASTanalysis/CodexUserStudyData/Autopilot/davinci-001_07/parts/gen_list_load.c", "C", 42, 0, 0, 0, 10, 12, 64
"/Users/sbukhari/Sandbox/CProgram/ASTanalysis/CodexUserStudyData/Autopilot/davinci-001_07/parts/gen_list_print.c", "C", 27, 0, 0, 0, 17, 8, 52
"/Users/sbukhari/Sandbox/CProgram/ASTanalysis/CodexUserStudyData/Autopilot/davinci-001_07/parts/gen_list_remove_item_at_pos.c", "C", 30, 0, 0, 0, 5, 9, 44
"/Users/sbukhari/Sandbox/CProgram/ASTanalysis/CodexUserStudyData/Autopilot/davinci-001_07/parts/gen_list_save.c", "C", 28, 0, 0, 0, 8, 9, 45
"/Users/sbukhari/Sandbox/CProgram/ASTanalysis/CodexUserStudyData/Autopilot/davinci-001_07/parts/gen_list_swap_item_positions.c", "C", 36, 0, 0, 0, 5, 10, 51
"/Users/sbukhari/Sandbox/CProgram/ASTanalysis/CodexUserStudyData/Autopilot/davinci-001_07/parts/gen_list_update_item_at_pos.c", "C", 31, 0, 0, 0, 5, 9, 45
"/Users/sbukhari/Sandbox/CProgram/ASTanalysis/CodexUserStudyData/Autopilot/davinci-001_07/ref_testsuite.json", "JSON", 0, 323, 0, 0, 0, 1, 324
"/Users/sbukhari/Sandbox/CProgram/ASTanalysis/CodexUserStudyData/Autopilot/davinci-001_07/ref_testsuite_asan.json", "JSON", 0, 323, 0, 0, 0, 1, 324
"/Users/sbukhari/Sandbox/CProgram/ASTanalysis/CodexUserStudyData/Autopilot/davinci-001_07/ref_testsuite_asan_noleak.json", "JSON", 0, 323, 0, 0, 0, 1, 324
"/Users/sbukhari/Sandbox/CProgram/ASTanalysis/CodexUserStudyData/Autopilot/davinci-001_08/api_report.json", "JSON", 0, 14, 0, 0, 0, 1, 15
"/Users/sbukhari/Sandbox/CProgram/ASTanalysis/CodexUserStudyData/Autopilot/davinci-001_08/list.c", "C", 290, 0, 0, 0, 53, 71, 414
"/Users/sbukhari/Sandbox/CProgram/ASTanalysis/CodexUserStudyData/Autopilot/davinci-001_08/orig_testsuite.json", "JSON", 0, 92, 0, 0, 0, 1, 93
"/Users/sbukhari/Sandbox/CProgram/ASTanalysis/CodexUserStudyData/Autopilot/davinci-001_08/orig_testsuite_asan.json", "JSON", 0, 92, 0, 0, 0, 1, 93
"/Users/sbukhari/Sandbox/CProgram/ASTanalysis/CodexUserStudyData/Autopilot/davinci-001_08/orig_testsuite_asan_noleak.json", "JSON", 0, 92, 0, 0, 0, 1, 93
"/Users/sbukhari/Sandbox/CProgram/ASTanalysis/CodexUserStudyData/Autopilot/davinci-001_08/parts/gen_list_add_item_at_pos.c", "C", 44, 0, 0, 0, 15, 10, 69
"/Users/sbukhari/Sandbox/CProgram/ASTanalysis/CodexUserStudyData/Autopilot/davinci-001_08/parts/gen_list_cost_sum.c", "C", 24, 0, 0, 0, 5, 7, 36
"/Users/sbukhari/Sandbox/CProgram/ASTanalysis/CodexUserStudyData/Autopilot/davinci-001_08/parts/gen_list_deduplicate.c", "C", 36, 0, 0, 0, 7, 9, 52
"/Users/sbukhari/Sandbox/CProgram/ASTanalysis/CodexUserStudyData/Autopilot/davinci-001_08/parts/gen_list_find_highest_price_item_position.c", "C", 32, 0, 0, 0, 5, 9, 46
"/Users/sbukhari/Sandbox/CProgram/ASTanalysis/CodexUserStudyData/Autopilot/davinci-001_08/parts/gen_list_init.c", "C", 18, 0, 0, 0, 5, 5, 28
"/Users/sbukhari/Sandbox/CProgram/ASTanalysis/CodexUserStudyData/Autopilot/davinci-001_08/parts/gen_list_item_to_string.c", "C", 36, 0, 0, 0, 8, 9, 53
"/Users/sbukhari/Sandbox/CProgram/ASTanalysis/CodexUserStudyData/Autopilot/davinci-001_08/parts/gen_list_load.c", "C", 51, 0, 0, 0, 9, 13, 73
"/Users/sbukhari/Sandbox/CProgram/ASTanalysis/CodexUserStudyData/Autopilot/davinci-001_08/parts/gen_list_print.c", "C", 43, 0, 0, 0, 17, 12, 72
"/Users/sbukhari/Sandbox/CProgram/ASTanalysis/CodexUserStudyData/Autopilot/davinci-001_08/parts/gen_list_remove_item_at_pos.c", "C", 32, 0, 0, 0, 5, 9, 46
"/Users/sbukhari/Sandbox/CProgram/ASTanalysis/CodexUserStudyData/Autopilot/davinci-001_08/parts/gen_list_save.c", "C", 29, 0, 0, 0, 8, 9, 46
"/Users/sbukhari/Sandbox/CProgram/ASTanalysis/CodexUserStudyData/Autopilot/davinci-001_08/parts/gen_list_swap_item_positions.c", "C", 63, 0, 0, 0, 5, 14, 82
"/Users/sbukhari/Sandbox/CProgram/ASTanalysis/CodexUserStudyData/Autopilot/davinci-001_08/parts/gen_list_update_item_at_pos.c", "C", 37, 0, 0, 0, 5, 8, 50
"/Users/sbukhari/Sandbox/CProgram/ASTanalysis/CodexUserStudyData/Autopilot/davinci-001_08/ref_testsuite.json", "JSON", 0, 323, 0, 0, 0, 1, 324
"/Users/sbukhari/Sandbox/CProgram/ASTanalysis/CodexUserStudyData/Autopilot/davinci-001_08/ref_testsuite_asan.json", "JSON", 0, 323, 0, 0, 0, 1, 324
"/Users/sbukhari/Sandbox/CProgram/ASTanalysis/CodexUserStudyData/Autopilot/davinci-001_08/ref_testsuite_asan_noleak.json", "JSON", 0, 323, 0, 0, 0, 1, 324
"/Users/sbukhari/Sandbox/CProgram/ASTanalysis/CodexUserStudyData/Autopilot/davinci-001_09/api_report.json", "JSON", 0, 14, 0, 0, 0, 1, 15
"/Users/sbukhari/Sandbox/CProgram/ASTanalysis/CodexUserStudyData/Autopilot/davinci-001_09/list.c", "C", 136, 0, 0, 0, 88, 44, 268
"/Users/sbukhari/Sandbox/CProgram/ASTanalysis/CodexUserStudyData/Autopilot/davinci-001_09/orig_testsuite.json", "JSON", 0, 92, 0, 0, 0, 1, 93
"/Users/sbukhari/Sandbox/CProgram/ASTanalysis/CodexUserStudyData/Autopilot/davinci-001_09/orig_testsuite_asan.json", "JSON", 0, 92, 0, 0, 0, 1, 93
"/Users/sbukhari/Sandbox/CProgram/ASTanalysis/CodexUserStudyData/Autopilot/davinci-001_09/orig_testsuite_asan_noleak.json", "JSON", 0, 92, 0, 0, 0, 1, 93
"/Users/sbukhari/Sandbox/CProgram/ASTanalysis/CodexUserStudyData/Autopilot/davinci-001_09/parts/gen_list_add_item_at_pos.c", "C", 17, 0, 0, 0, 17, 5, 39
"/Users/sbukhari/Sandbox/CProgram/ASTanalysis/CodexUserStudyData/Autopilot/davinci-001_09/parts/gen_list_cost_sum.c", "C", 27, 0, 0, 0, 9, 9, 45
"/Users/sbukhari/Sandbox/CProgram/ASTanalysis/CodexUserStudyData/Autopilot/davinci-001_09/parts/gen_list_deduplicate.c", "C", 39, 0, 0, 0, 9, 8, 56
"/Users/sbukhari/Sandbox/CProgram/ASTanalysis/CodexUserStudyData/Autopilot/davinci-001_09/parts/gen_list_find_highest_price_item_position.c", "C", 17, 0, 0, 0, 7, 5, 29
"/Users/sbukhari/Sandbox/CProgram/ASTanalysis/CodexUserStudyData/Autopilot/davinci-001_09/parts/gen_list_init.c", "C", 24, 0, 0, 0, 8, 7, 39
"/Users/sbukhari/Sandbox/CProgram/ASTanalysis/CodexUserStudyData/Autopilot/davinci-001_09/parts/gen_list_item_to_string.c", "C", 29, 0, 0, 0, 14, 11, 54
"/Users/sbukhari/Sandbox/CProgram/ASTanalysis/CodexUserStudyData/Autopilot/davinci-001_09/parts/gen_list_load.c", "C", 28, 0, 0, 0, 12, 9, 49
"/Users/sbukhari/Sandbox/CProgram/ASTanalysis/CodexUserStudyData/Autopilot/davinci-001_09/parts/gen_list_print.c", "C", 31, 0, 0, 0, 21, 9, 61
"/Users/sbukhari/Sandbox/CProgram/ASTanalysis/CodexUserStudyData/Autopilot/davinci-001_09/parts/gen_list_remove_item_at_pos.c", "C", 17, 0, 0, 0, 7, 5, 29
"/Users/sbukhari/Sandbox/CProgram/ASTanalysis/CodexUserStudyData/Autopilot/davinci-001_09/parts/gen_list_save.c", "C", 28, 0, 0, 0, 11, 9, 48
"/Users/sbukhari/Sandbox/CProgram/ASTanalysis/CodexUserStudyData/Autopilot/davinci-001_09/parts/gen_list_swap_item_positions.c", "C", 17, 0, 0, 0, 7, 5, 29
"/Users/sbukhari/Sandbox/CProgram/ASTanalysis/CodexUserStudyData/Autopilot/davinci-001_09/parts/gen_list_update_item_at_pos.c", "C", 17, 0, 0, 0, 7, 5, 29
"/Users/sbukhari/Sandbox/CProgram/ASTanalysis/CodexUserStudyData/Autopilot/davinci-001_09/ref_testsuite.json", "JSON", 0, 323, 0, 0, 0, 1, 324
"/Users/sbukhari/Sandbox/CProgram/ASTanalysis/CodexUserStudyData/Autopilot/davinci-001_09/ref_testsuite_asan.json", "JSON", 0, 323, 0, 0, 0, 1, 324
"/Users/sbukhari/Sandbox/CProgram/ASTanalysis/CodexUserStudyData/Autopilot/davinci-001_09/ref_testsuite_asan_noleak.json", "JSON", 0, 323, 0, 0, 0, 1, 324
"/Users/sbukhari/Sandbox/CProgram/ASTanalysis/CodexUserStudyData/Autopilot/davinci-002_00/api_report.json", "JSON", 0, 14, 0, 0, 0, 1, 15
"/Users/sbukhari/Sandbox/CProgram/ASTanalysis/CodexUserStudyData/Autopilot/davinci-002_00/list.c", "C", 249, 0, 0, 0, 53, 17, 319
"/Users/sbukhari/Sandbox/CProgram/ASTanalysis/CodexUserStudyData/Autopilot/davinci-002_00/orig_testsuite.json", "JSON", 0, 92, 0, 0, 0, 1, 93
"/Users/sbukhari/Sandbox/CProgram/ASTanalysis/CodexUserStudyData/Autopilot/davinci-002_00/orig_testsuite_asan.json", "JSON", 0, 92, 0, 0, 0, 1, 93
"/Users/sbukhari/Sandbox/CProgram/ASTanalysis/CodexUserStudyData/Autopilot/davinci-002_00/orig_testsuite_asan_noleak.json", "JSON", 0, 92, 0, 0, 0, 1, 93
"/Users/sbukhari/Sandbox/CProgram/ASTanalysis/CodexUserStudyData/Autopilot/davinci-002_00/parts/gen_list_add_item_at_pos.c", "C", 39, 0, 0, 0, 15, 5, 59
"/Users/sbukhari/Sandbox/CProgram/ASTanalysis/CodexUserStudyData/Autopilot/davinci-002_00/parts/gen_list_cost_sum.c", "C", 25, 0, 0, 0, 5, 5, 35
"/Users/sbukhari/Sandbox/CProgram/ASTanalysis/CodexUserStudyData/Autopilot/davinci-002_00/parts/gen_list_deduplicate.c", "C", 34, 0, 0, 0, 7, 5, 46
"/Users/sbukhari/Sandbox/CProgram/ASTanalysis/CodexUserStudyData/Autopilot/davinci-002_00/parts/gen_list_find_highest_price_item_position.c", "C", 33, 0, 0, 0, 5, 5, 43
"/Users/sbukhari/Sandbox/CProgram/ASTanalysis/CodexUserStudyData/Autopilot/davinci-002_00/parts/gen_list_init.c", "C", 18, 0, 0, 0, 5, 5, 28
"/Users/sbukhari/Sandbox/CProgram/ASTanalysis/CodexUserStudyData/Autopilot/davinci-002_00/parts/gen_list_item_to_string.c", "C", 25, 0, 0, 0, 8, 5, 38
"/Users/sbukhari/Sandbox/CProgram/ASTanalysis/CodexUserStudyData/Autopilot/davinci-002_00/parts/gen_list_load.c", "C", 60, 0, 0, 0, 9, 5, 74
"/Users/sbukhari/Sandbox/CProgram/ASTanalysis/CodexUserStudyData/Autopilot/davinci-002_00/parts/gen_list_print.c", "C", 28, 0, 0, 0, 17, 5, 50
"/Users/sbukhari/Sandbox/CProgram/ASTanalysis/CodexUserStudyData/Autopilot/davinci-002_00/parts/gen_list_remove_item_at_pos.c", "C", 34, 0, 0, 0, 5, 5, 44
"/Users/sbukhari/Sandbox/CProgram/ASTanalysis/CodexUserStudyData/Autopilot/davinci-002_00/parts/gen_list_save.c", "C", 26, 0, 0, 0, 8, 5, 39
"/Users/sbukhari/Sandbox/CProgram/ASTanalysis/CodexUserStudyData/Autopilot/davinci-002_00/parts/gen_list_swap_item_positions.c", "C", 47, 0, 0, 0, 5, 5, 57
"/Users/sbukhari/Sandbox/CProgram/ASTanalysis/CodexUserStudyData/Autopilot/davinci-002_00/parts/gen_list_update_item_at_pos.c", "C", 35, 0, 0, 0, 5, 5, 45
"/Users/sbukhari/Sandbox/CProgram/ASTanalysis/CodexUserStudyData/Autopilot/davinci-002_00/ref_testsuite.json", "JSON", 0, 323, 0, 0, 0, 1, 324
"/Users/sbukhari/Sandbox/CProgram/ASTanalysis/CodexUserStudyData/Autopilot/davinci-002_00/ref_testsuite_asan.json", "JSON", 0, 323, 0, 0, 0, 1, 324
"/Users/sbukhari/Sandbox/CProgram/ASTanalysis/CodexUserStudyData/Autopilot/davinci-002_00/ref_testsuite_asan_noleak.json", "JSON", 0, 323, 0, 0, 0, 1, 324
"/Users/sbukhari/Sandbox/CProgram/ASTanalysis/CodexUserStudyData/Autopilot/davinci-002_01/api_report.json", "JSON", 0, 14, 0, 0, 0, 1, 15
"/Users/sbukhari/Sandbox/CProgram/ASTanalysis/CodexUserStudyData/Autopilot/davinci-002_01/list.c", "C", 308, 0, 0, 0, 55, 23, 386
"/Users/sbukhari/Sandbox/CProgram/ASTanalysis/CodexUserStudyData/Autopilot/davinci-002_01/orig_testsuite.json", "JSON", 0, 92, 0, 0, 0, 1, 93
"/Users/sbukhari/Sandbox/CProgram/ASTanalysis/CodexUserStudyData/Autopilot/davinci-002_01/orig_testsuite_asan.json", "JSON", 0, 92, 0, 0, 0, 1, 93
"/Users/sbukhari/Sandbox/CProgram/ASTanalysis/CodexUserStudyData/Autopilot/davinci-002_01/orig_testsuite_asan_noleak.json", "JSON", 0, 92, 0, 0, 0, 1, 93
"/Users/sbukhari/Sandbox/CProgram/ASTanalysis/CodexUserStudyData/Autopilot/davinci-002_01/parts/gen_list_add_item_at_pos.c", "C", 58, 0, 0, 0, 15, 6, 79
"/Users/sbukhari/Sandbox/CProgram/ASTanalysis/CodexUserStudyData/Autopilot/davinci-002_01/parts/gen_list_cost_sum.c", "C", 26, 0, 0, 0, 5, 5, 36
"/Users/sbukhari/Sandbox/CProgram/ASTanalysis/CodexUserStudyData/Autopilot/davinci-002_01/parts/gen_list_deduplicate.c", "C", 32, 0, 0, 0, 7, 5, 44
"/Users/sbukhari/Sandbox/CProgram/ASTanalysis/CodexUserStudyData/Autopilot/davinci-002_01/parts/gen_list_find_highest_price_item_position.c", "C", 33, 0, 0, 0, 5, 5, 43
"/Users/sbukhari/Sandbox/CProgram/ASTanalysis/CodexUserStudyData/Autopilot/davinci-002_01/parts/gen_list_init.c", "C", 18, 0, 0, 0, 5, 5, 28
"/Users/sbukhari/Sandbox/CProgram/ASTanalysis/CodexUserStudyData/Autopilot/davinci-002_01/parts/gen_list_item_to_string.c", "C", 26, 0, 0, 0, 8, 5, 39
"/Users/sbukhari/Sandbox/CProgram/ASTanalysis/CodexUserStudyData/Autopilot/davinci-002_01/parts/gen_list_load.c", "C", 51, 0, 0, 0, 10, 6, 67
"/Users/sbukhari/Sandbox/CProgram/ASTanalysis/CodexUserStudyData/Autopilot/davinci-002_01/parts/gen_list_print.c", "C", 31, 0, 0, 0, 17, 5, 53
"/Users/sbukhari/Sandbox/CProgram/ASTanalysis/CodexUserStudyData/Autopilot/davinci-002_01/parts/gen_list_remove_item_at_pos.c", "C", 43, 0, 0, 0, 5, 6, 54
"/Users/sbukhari/Sandbox/CProgram/ASTanalysis/CodexUserStudyData/Autopilot/davinci-002_01/parts/gen_list_save.c", "C", 33, 0, 0, 0, 9, 6, 48
"/Users/sbukhari/Sandbox/CProgram/ASTanalysis/CodexUserStudyData/Autopilot/davinci-002_01/parts/gen_list_swap_item_positions.c", "C", 66, 0, 0, 0, 5, 6, 77
"/Users/sbukhari/Sandbox/CProgram/ASTanalysis/CodexUserStudyData/Autopilot/davinci-002_01/parts/gen_list_update_item_at_pos.c", "C", 46, 0, 0, 0, 5, 6, 57
"/Users/sbukhari/Sandbox/CProgram/ASTanalysis/CodexUserStudyData/Autopilot/davinci-002_01/ref_testsuite.json", "JSON", 0, 323, 0, 0, 0, 1, 324
"/Users/sbukhari/Sandbox/CProgram/ASTanalysis/CodexUserStudyData/Autopilot/davinci-002_01/ref_testsuite_asan.json", "JSON", 0, 323, 0, 0, 0, 1, 324
"/Users/sbukhari/Sandbox/CProgram/ASTanalysis/CodexUserStudyData/Autopilot/davinci-002_01/ref_testsuite_asan_noleak.json", "JSON", 0, 323, 0, 0, 0, 1, 324
"/Users/sbukhari/Sandbox/CProgram/ASTanalysis/CodexUserStudyData/Autopilot/davinci-002_02/api_report.json", "JSON", 0, 14, 0, 0, 0, 1, 15
"/Users/sbukhari/Sandbox/CProgram/ASTanalysis/CodexUserStudyData/Autopilot/davinci-002_02/list.c", "C", 239, 0, 0, 0, 53, 17, 309
"/Users/sbukhari/Sandbox/CProgram/ASTanalysis/CodexUserStudyData/Autopilot/davinci-002_02/orig_testsuite.json", "JSON", 0, 92, 0, 0, 0, 1, 93
"/Users/sbukhari/Sandbox/CProgram/ASTanalysis/CodexUserStudyData/Autopilot/davinci-002_02/orig_testsuite_asan.json", "JSON", 0, 92, 0, 0, 0, 1, 93
"/Users/sbukhari/Sandbox/CProgram/ASTanalysis/CodexUserStudyData/Autopilot/davinci-002_02/orig_testsuite_asan_noleak.json", "JSON", 0, 92, 0, 0, 0, 1, 93
"/Users/sbukhari/Sandbox/CProgram/ASTanalysis/CodexUserStudyData/Autopilot/davinci-002_02/parts/gen_list_add_item_at_pos.c", "C", 47, 0, 0, 0, 15, 5, 67
"/Users/sbukhari/Sandbox/CProgram/ASTanalysis/CodexUserStudyData/Autopilot/davinci-002_02/parts/gen_list_cost_sum.c", "C", 27, 0, 0, 0, 5, 5, 37
"/Users/sbukhari/Sandbox/CProgram/ASTanalysis/CodexUserStudyData/Autopilot/davinci-002_02/parts/gen_list_deduplicate.c", "C", 33, 0, 0, 0, 7, 5, 45
"/Users/sbukhari/Sandbox/CProgram/ASTanalysis/CodexUserStudyData/Autopilot/davinci-002_02/parts/gen_list_find_highest_price_item_position.c", "C", 33, 0, 0, 0, 5, 5, 43
"/Users/sbukhari/Sandbox/CProgram/ASTanalysis/CodexUserStudyData/Autopilot/davinci-002_02/parts/gen_list_init.c", "C", 23, 0, 0, 0, 5, 5, 33
"/Users/sbukhari/Sandbox/CProgram/ASTanalysis/CodexUserStudyData/Autopilot/davinci-002_02/parts/gen_list_item_to_string.c", "C", 21, 0, 0, 0, 8, 5, 34
"/Users/sbukhari/Sandbox/CProgram/ASTanalysis/CodexUserStudyData/Autopilot/davinci-002_02/parts/gen_list_load.c", "C", 37, 0, 0, 0, 9, 5, 51
"/Users/sbukhari/Sandbox/CProgram/ASTanalysis/CodexUserStudyData/Autopilot/davinci-002_02/parts/gen_list_print.c", "C", 28, 0, 0, 0, 17, 5, 50
"/Users/sbukhari/Sandbox/CProgram/ASTanalysis/CodexUserStudyData/Autopilot/davinci-002_02/parts/gen_list_remove_item_at_pos.c", "C", 36, 0, 0, 0, 5, 5, 46
"/Users/sbukhari/Sandbox/CProgram/ASTanalysis/CodexUserStudyData/Autopilot/davinci-002_02/parts/gen_list_save.c", "C", 27, 0, 0, 0, 8, 5, 40
"/Users/sbukhari/Sandbox/CProgram/ASTanalysis/CodexUserStudyData/Autopilot/davinci-002_02/parts/gen_list_swap_item_positions.c", "C", 47, 0, 0, 0, 5, 5, 57
"/Users/sbukhari/Sandbox/CProgram/ASTanalysis/CodexUserStudyData/Autopilot/davinci-002_02/parts/gen_list_update_item_at_pos.c", "C", 35, 0, 0, 0, 5, 5, 45
"/Users/sbukhari/Sandbox/CProgram/ASTanalysis/CodexUserStudyData/Autopilot/davinci-002_02/ref_testsuite.json", "JSON", 0, 323, 0, 0, 0, 1, 324
"/Users/sbukhari/Sandbox/CProgram/ASTanalysis/CodexUserStudyData/Autopilot/davinci-002_02/ref_testsuite_asan.json", "JSON", 0, 323, 0, 0, 0, 1, 324
"/Users/sbukhari/Sandbox/CProgram/ASTanalysis/CodexUserStudyData/Autopilot/davinci-002_02/ref_testsuite_asan_noleak.json", "JSON", 0, 323, 0, 0, 0, 1, 324
"/Users/sbukhari/Sandbox/CProgram/ASTanalysis/CodexUserStudyData/Autopilot/davinci-002_03/api_report.json", "JSON", 0, 14, 0, 0, 0, 1, 15
"/Users/sbukhari/Sandbox/CProgram/ASTanalysis/CodexUserStudyData/Autopilot/davinci-002_03/list.c", "C", 242, 0, 0, 0, 53, 32, 327
"/Users/sbukhari/Sandbox/CProgram/ASTanalysis/CodexUserStudyData/Autopilot/davinci-002_03/orig_testsuite.json", "JSON", 0, 92, 0, 0, 0, 1, 93
"/Users/sbukhari/Sandbox/CProgram/ASTanalysis/CodexUserStudyData/Autopilot/davinci-002_03/orig_testsuite_asan.json", "JSON", 0, 92, 0, 0, 0, 1, 93
"/Users/sbukhari/Sandbox/CProgram/ASTanalysis/CodexUserStudyData/Autopilot/davinci-002_03/orig_testsuite_asan_noleak.json", "JSON", 0, 92, 0, 0, 0, 1, 93
"/Users/sbukhari/Sandbox/CProgram/ASTanalysis/CodexUserStudyData/Autopilot/davinci-002_03/parts/gen_list_add_item_at_pos.c", "C", 47, 0, 0, 0, 15, 8, 70
"/Users/sbukhari/Sandbox/CProgram/ASTanalysis/CodexUserStudyData/Autopilot/davinci-002_03/parts/gen_list_cost_sum.c", "C", 27, 0, 0, 0, 5, 6, 38
"/Users/sbukhari/Sandbox/CProgram/ASTanalysis/CodexUserStudyData/Autopilot/davinci-002_03/parts/gen_list_deduplicate.c", "C", 37, 0, 0, 0, 7, 6, 50
"/Users/sbukhari/Sandbox/CProgram/ASTanalysis/CodexUserStudyData/Autopilot/davinci-002_03/parts/gen_list_find_highest_price_item_position.c", "C", 31, 0, 0, 0, 5, 6, 42
"/Users/sbukhari/Sandbox/CProgram/ASTanalysis/CodexUserStudyData/Autopilot/davinci-002_03/parts/gen_list_init.c", "C", 18, 0, 0, 0, 5, 5, 28
"/Users/sbukhari/Sandbox/CProgram/ASTanalysis/CodexUserStudyData/Autopilot/davinci-002_03/parts/gen_list_item_to_string.c", "C", 18, 0, 0, 0, 8, 5, 31
"/Users/sbukhari/Sandbox/CProgram/ASTanalysis/CodexUserStudyData/Autopilot/davinci-002_03/parts/gen_list_load.c", "C", 32, 0, 0, 0, 9, 6, 47
"/Users/sbukhari/Sandbox/CProgram/ASTanalysis/CodexUserStudyData/Autopilot/davinci-002_03/parts/gen_list_print.c", "C", 25, 0, 0, 0, 17, 5, 47
"/Users/sbukhari/Sandbox/CProgram/ASTanalysis/CodexUserStudyData/Autopilot/davinci-002_03/parts/gen_list_remove_item_at_pos.c", "C", 38, 0, 0, 0, 5, 6, 49
"/Users/sbukhari/Sandbox/CProgram/ASTanalysis/CodexUserStudyData/Autopilot/davinci-002_03/parts/gen_list_save.c", "C", 30, 0, 0, 0, 8, 6, 44
"/Users/sbukhari/Sandbox/CProgram/ASTanalysis/CodexUserStudyData/Autopilot/davinci-002_03/parts/gen_list_swap_item_positions.c", "C", 64, 0, 0, 0, 5, 11, 80
"/Users/sbukhari/Sandbox/CProgram/ASTanalysis/CodexUserStudyData/Autopilot/davinci-002_03/parts/gen_list_update_item_at_pos.c", "C", 30, 0, 0, 0, 5, 5, 40
"/Users/sbukhari/Sandbox/CProgram/ASTanalysis/CodexUserStudyData/Autopilot/davinci-002_03/ref_testsuite.json", "JSON", 0, 323, 0, 0, 0, 1, 324
"/Users/sbukhari/Sandbox/CProgram/ASTanalysis/CodexUserStudyData/Autopilot/davinci-002_03/ref_testsuite_asan.json", "JSON", 0, 323, 0, 0, 0, 1, 324
"/Users/sbukhari/Sandbox/CProgram/ASTanalysis/CodexUserStudyData/Autopilot/davinci-002_03/ref_testsuite_asan_noleak.json", "JSON", 0, 323, 0, 0, 0, 1, 324
"/Users/sbukhari/Sandbox/CProgram/ASTanalysis/CodexUserStudyData/Autopilot/davinci-002_04/api_report.json", "JSON", 0, 14, 0, 0, 0, 1, 15
"/Users/sbukhari/Sandbox/CProgram/ASTanalysis/CodexUserStudyData/Autopilot/davinci-002_04/list.c", "C", 267, 0, 0, 0, 53, 17, 337
"/Users/sbukhari/Sandbox/CProgram/ASTanalysis/CodexUserStudyData/Autopilot/davinci-002_04/orig_testsuite.json", "JSON", 0, 92, 0, 0, 0, 1, 93
"/Users/sbukhari/Sandbox/CProgram/ASTanalysis/CodexUserStudyData/Autopilot/davinci-002_04/orig_testsuite_asan.json", "JSON", 0, 92, 0, 0, 0, 1, 93
"/Users/sbukhari/Sandbox/CProgram/ASTanalysis/CodexUserStudyData/Autopilot/davinci-002_04/orig_testsuite_asan_noleak.json", "JSON", 0, 92, 0, 0, 0, 1, 93
"/Users/sbukhari/Sandbox/CProgram/ASTanalysis/CodexUserStudyData/Autopilot/davinci-002_04/parts/gen_list_add_item_at_pos.c", "C", 45, 0, 0, 0, 15, 5, 65
"/Users/sbukhari/Sandbox/CProgram/ASTanalysis/CodexUserStudyData/Autopilot/davinci-002_04/parts/gen_list_cost_sum.c", "C", 26, 0, 0, 0, 5, 5, 36
"/Users/sbukhari/Sandbox/CProgram/ASTanalysis/CodexUserStudyData/Autopilot/davinci-002_04/parts/gen_list_deduplicate.c", "C", 46, 0, 0, 0, 7, 5, 58
"/Users/sbukhari/Sandbox/CProgram/ASTanalysis/CodexUserStudyData/Autopilot/davinci-002_04/parts/gen_list_find_highest_price_item_position.c", "C", 33, 0, 0, 0, 5, 5, 43
"/Users/sbukhari/Sandbox/CProgram/ASTanalysis/CodexUserStudyData/Autopilot/davinci-002_04/parts/gen_list_init.c", "C", 18, 0, 0, 0, 5, 5, 28
"/Users/sbukhari/Sandbox/CProgram/ASTanalysis/CodexUserStudyData/Autopilot/davinci-002_04/parts/gen_list_item_to_string.c", "C", 21, 0, 0, 0, 8, 5, 34
"/Users/sbukhari/Sandbox/CProgram/ASTanalysis/CodexUserStudyData/Autopilot/davinci-002_04/parts/gen_list_load.c", "C", 52, 0, 0, 0, 9, 5, 66
"/Users/sbukhari/Sandbox/CProgram/ASTanalysis/CodexUserStudyData/Autopilot/davinci-002_04/parts/gen_list_print.c", "C", 28, 0, 0, 0, 17, 5, 50
"/Users/sbukhari/Sandbox/CProgram/ASTanalysis/CodexUserStudyData/Autopilot/davinci-002_04/parts/gen_list_remove_item_at_pos.c", "C", 39, 0, 0, 0, 5, 5, 49
"/Users/sbukhari/Sandbox/CProgram/ASTanalysis/CodexUserStudyData/Autopilot/davinci-002_04/parts/gen_list_save.c", "C", 31, 0, 0, 0, 8, 5, 44
"/Users/sbukhari/Sandbox/CProgram/ASTanalysis/CodexUserStudyData/Autopilot/davinci-002_04/parts/gen_list_swap_item_positions.c", "C", 50, 0, 0, 0, 5, 5, 60
"/Users/sbukhari/Sandbox/CProgram/ASTanalysis/CodexUserStudyData/Autopilot/davinci-002_04/parts/gen_list_update_item_at_pos.c", "C", 33, 0, 0, 0, 5, 5, 43
"/Users/sbukhari/Sandbox/CProgram/ASTanalysis/CodexUserStudyData/Autopilot/davinci-002_04/ref_testsuite.json", "JSON", 0, 323, 0, 0, 0, 1, 324
"/Users/sbukhari/Sandbox/CProgram/ASTanalysis/CodexUserStudyData/Autopilot/davinci-002_04/ref_testsuite_asan.json", "JSON", 0, 323, 0, 0, 0, 1, 324
"/Users/sbukhari/Sandbox/CProgram/ASTanalysis/CodexUserStudyData/Autopilot/davinci-002_04/ref_testsuite_asan_noleak.json", "JSON", 0, 323, 0, 0, 0, 1, 324
"/Users/sbukhari/Sandbox/CProgram/ASTanalysis/CodexUserStudyData/Autopilot/davinci-002_05/api_report.json", "JSON", 0, 14, 0, 0, 0, 1, 15
"/Users/sbukhari/Sandbox/CProgram/ASTanalysis/CodexUserStudyData/Autopilot/davinci-002_05/list.c", "C", 229, 0, 0, 0, 53, 17, 299
"/Users/sbukhari/Sandbox/CProgram/ASTanalysis/CodexUserStudyData/Autopilot/davinci-002_05/orig_testsuite.json", "JSON", 0, 92, 0, 0, 0, 1, 93
"/Users/sbukhari/Sandbox/CProgram/ASTanalysis/CodexUserStudyData/Autopilot/davinci-002_05/orig_testsuite_asan.json", "JSON", 0, 92, 0, 0, 0, 1, 93
"/Users/sbukhari/Sandbox/CProgram/ASTanalysis/CodexUserStudyData/Autopilot/davinci-002_05/orig_testsuite_asan_noleak.json", "JSON", 0, 92, 0, 0, 0, 1, 93
"/Users/sbukhari/Sandbox/CProgram/ASTanalysis/CodexUserStudyData/Autopilot/davinci-002_05/parts/gen_list_add_item_at_pos.c", "C", 43, 0, 0, 0, 15, 5, 63
"/Users/sbukhari/Sandbox/CProgram/ASTanalysis/CodexUserStudyData/Autopilot/davinci-002_05/parts/gen_list_cost_sum.c", "C", 22, 0, 0, 0, 5, 5, 32
"/Users/sbukhari/Sandbox/CProgram/ASTanalysis/CodexUserStudyData/Autopilot/davinci-002_05/parts/gen_list_deduplicate.c", "C", 35, 0, 0, 0, 7, 5, 47
"/Users/sbukhari/Sandbox/CProgram/ASTanalysis/CodexUserStudyData/Autopilot/davinci-002_05/parts/gen_list_find_highest_price_item_position.c", "C", 29, 0, 0, 0, 5, 5, 39
"/Users/sbukhari/Sandbox/CProgram/ASTanalysis/CodexUserStudyData/Autopilot/davinci-002_05/parts/gen_list_init.c", "C", 18, 0, 0, 0, 5, 5, 28
"/Users/sbukhari/Sandbox/CProgram/ASTanalysis/CodexUserStudyData/Autopilot/davinci-002_05/parts/gen_list_item_to_string.c", "C", 21, 0, 0, 0, 8, 5, 34
"/Users/sbukhari/Sandbox/CProgram/ASTanalysis/CodexUserStudyData/Autopilot/davinci-002_05/parts/gen_list_load.c", "C", 30, 0, 0, 0, 9, 5, 44
"/Users/sbukhari/Sandbox/CProgram/ASTanalysis/CodexUserStudyData/Autopilot/davinci-002_05/parts/gen_list_print.c", "C", 25, 0, 0, 0, 17, 5, 47
"/Users/sbukhari/Sandbox/CProgram/ASTanalysis/CodexUserStudyData/Autopilot/davinci-002_05/parts/gen_list_remove_item_at_pos.c", "C", 34, 0, 0, 0, 5, 5, 44
"/Users/sbukhari/Sandbox/CProgram/ASTanalysis/CodexUserStudyData/Autopilot/davinci-002_05/parts/gen_list_save.c", "C", 27, 0, 0, 0, 8, 5, 40
"/Users/sbukhari/Sandbox/CProgram/ASTanalysis/CodexUserStudyData/Autopilot/davinci-002_05/parts/gen_list_swap_item_positions.c", "C", 68, 0, 0, 0, 5, 5, 78
"/Users/sbukhari/Sandbox/CProgram/ASTanalysis/CodexUserStudyData/Autopilot/davinci-002_05/parts/gen_list_update_item_at_pos.c", "C", 32, 0, 0, 0, 5, 5, 42
"/Users/sbukhari/Sandbox/CProgram/ASTanalysis/CodexUserStudyData/Autopilot/davinci-002_05/ref_testsuite.json", "JSON", 0, 323, 0, 0, 0, 1, 324
"/Users/sbukhari/Sandbox/CProgram/ASTanalysis/CodexUserStudyData/Autopilot/davinci-002_05/ref_testsuite_asan.json", "JSON", 0, 323, 0, 0, 0, 1, 324
"/Users/sbukhari/Sandbox/CProgram/ASTanalysis/CodexUserStudyData/Autopilot/davinci-002_05/ref_testsuite_asan_noleak.json", "JSON", 0, 323, 0, 0, 0, 1, 324
"/Users/sbukhari/Sandbox/CProgram/ASTanalysis/CodexUserStudyData/Autopilot/davinci-002_06/api_report.json", "JSON", 0, 14, 0, 0, 0, 1, 15
"/Users/sbukhari/Sandbox/CProgram/ASTanalysis/CodexUserStudyData/Autopilot/davinci-002_06/list.c", "C", 278, 0, 0, 0, 53, 49, 380
"/Users/sbukhari/Sandbox/CProgram/ASTanalysis/CodexUserStudyData/Autopilot/davinci-002_06/orig_testsuite.json", "JSON", 0, 92, 0, 0, 0, 1, 93
"/Users/sbukhari/Sandbox/CProgram/ASTanalysis/CodexUserStudyData/Autopilot/davinci-002_06/orig_testsuite_asan.json", "JSON", 0, 92, 0, 0, 0, 1, 93
"/Users/sbukhari/Sandbox/CProgram/ASTanalysis/CodexUserStudyData/Autopilot/davinci-002_06/orig_testsuite_asan_noleak.json", "JSON", 0, 92, 0, 0, 0, 1, 93
"/Users/sbukhari/Sandbox/CProgram/ASTanalysis/CodexUserStudyData/Autopilot/davinci-002_06/parts/gen_list_add_item_at_pos.c", "C", 56, 0, 0, 0, 15, 8, 79
"/Users/sbukhari/Sandbox/CProgram/ASTanalysis/CodexUserStudyData/Autopilot/davinci-002_06/parts/gen_list_cost_sum.c", "C", 27, 0, 0, 0, 5, 7, 39
"/Users/sbukhari/Sandbox/CProgram/ASTanalysis/CodexUserStudyData/Autopilot/davinci-002_06/parts/gen_list_deduplicate.c", "C", 34, 0, 0, 0, 7, 6, 47
"/Users/sbukhari/Sandbox/CProgram/ASTanalysis/CodexUserStudyData/Autopilot/davinci-002_06/parts/gen_list_find_highest_price_item_position.c", "C", 33, 0, 0, 0, 5, 7, 45
"/Users/sbukhari/Sandbox/CProgram/ASTanalysis/CodexUserStudyData/Autopilot/davinci-002_06/parts/gen_list_init.c", "C", 21, 0, 0, 0, 5, 6, 32
"/Users/sbukhari/Sandbox/CProgram/ASTanalysis/CodexUserStudyData/Autopilot/davinci-002_06/parts/gen_list_item_to_string.c", "C", 23, 0, 0, 0, 8, 7, 38
"/Users/sbukhari/Sandbox/CProgram/ASTanalysis/CodexUserStudyData/Autopilot/davinci-002_06/parts/gen_list_load.c", "C", 36, 0, 0, 0, 9, 6, 51
"/Users/sbukhari/Sandbox/CProgram/ASTanalysis/CodexUserStudyData/Autopilot/davinci-002_06/parts/gen_list_print.c", "C", 29, 0, 0, 0, 17, 7, 53
"/Users/sbukhari/Sandbox/CProgram/ASTanalysis/CodexUserStudyData/Autopilot/davinci-002_06/parts/gen_list_remove_item_at_pos.c", "C", 41, 0, 0, 0, 5, 8, 54
"/Users/sbukhari/Sandbox/CProgram/ASTanalysis/CodexUserStudyData/Autopilot/davinci-002_06/parts/gen_list_save.c", "C", 31, 0, 0, 0, 8, 6, 45
"/Users/sbukhari/Sandbox/CProgram/ASTanalysis/CodexUserStudyData/Autopilot/davinci-002_06/parts/gen_list_swap_item_positions.c", "C", 66, 0, 0, 0, 5, 16, 87
"/Users/sbukhari/Sandbox/CProgram/ASTanalysis/CodexUserStudyData/Autopilot/davinci-002_06/parts/gen_list_update_item_at_pos.c", "C", 36, 0, 0, 0, 5, 8, 49
"/Users/sbukhari/Sandbox/CProgram/ASTanalysis/CodexUserStudyData/Autopilot/davinci-002_06/ref_testsuite.json", "JSON", 0, 323, 0, 0, 0, 1, 324
"/Users/sbukhari/Sandbox/CProgram/ASTanalysis/CodexUserStudyData/Autopilot/davinci-002_06/ref_testsuite_asan.json", "JSON", 0, 323, 0, 0, 0, 1, 324
"/Users/sbukhari/Sandbox/CProgram/ASTanalysis/CodexUserStudyData/Autopilot/davinci-002_06/ref_testsuite_asan_noleak.json", "JSON", 0, 323, 0, 0, 0, 1, 324
"/Users/sbukhari/Sandbox/CProgram/ASTanalysis/CodexUserStudyData/Autopilot/davinci-002_07/api_report.json", "JSON", 0, 14, 0, 0, 0, 1, 15
"/Users/sbukhari/Sandbox/CProgram/ASTanalysis/CodexUserStudyData/Autopilot/davinci-002_07/list.c", "C", 236, 0, 0, 0, 53, 18, 307
"/Users/sbukhari/Sandbox/CProgram/ASTanalysis/CodexUserStudyData/Autopilot/davinci-002_07/orig_testsuite.json", "JSON", 0, 92, 0, 0, 0, 1, 93
"/Users/sbukhari/Sandbox/CProgram/ASTanalysis/CodexUserStudyData/Autopilot/davinci-002_07/orig_testsuite_asan.json", "JSON", 0, 92, 0, 0, 0, 1, 93
"/Users/sbukhari/Sandbox/CProgram/ASTanalysis/CodexUserStudyData/Autopilot/davinci-002_07/orig_testsuite_asan_noleak.json", "JSON", 0, 92, 0, 0, 0, 1, 93
"/Users/sbukhari/Sandbox/CProgram/ASTanalysis/CodexUserStudyData/Autopilot/davinci-002_07/parts/gen_list_add_item_at_pos.c", "C", 37, 0, 0, 0, 15, 5, 57
"/Users/sbukhari/Sandbox/CProgram/ASTanalysis/CodexUserStudyData/Autopilot/davinci-002_07/parts/gen_list_cost_sum.c", "C", 23, 0, 0, 0, 5, 5, 33
"/Users/sbukhari/Sandbox/CProgram/ASTanalysis/CodexUserStudyData/Autopilot/davinci-002_07/parts/gen_list_deduplicate.c", "C", 32, 0, 0, 0, 7, 5, 44
"/Users/sbukhari/Sandbox/CProgram/ASTanalysis/CodexUserStudyData/Autopilot/davinci-002_07/parts/gen_list_find_highest_price_item_position.c", "C", 26, 0, 0, 0, 5, 5, 36
"/Users/sbukhari/Sandbox/CProgram/ASTanalysis/CodexUserStudyData/Autopilot/davinci-002_07/parts/gen_list_init.c", "C", 18, 0, 0, 0, 5, 5, 28
"/Users/sbukhari/Sandbox/CProgram/ASTanalysis/CodexUserStudyData/Autopilot/davinci-002_07/parts/gen_list_item_to_string.c", "C", 26, 0, 0, 0, 8, 6, 40
"/Users/sbukhari/Sandbox/CProgram/ASTanalysis/CodexUserStudyData/Autopilot/davinci-002_07/parts/gen_list_load.c", "C", 49, 0, 0, 0, 9, 5, 63
"/Users/sbukhari/Sandbox/CProgram/ASTanalysis/CodexUserStudyData/Autopilot/davinci-002_07/parts/gen_list_print.c", "C", 26, 0, 0, 0, 17, 5, 48
"/Users/sbukhari/Sandbox/CProgram/ASTanalysis/CodexUserStudyData/Autopilot/davinci-002_07/parts/gen_list_remove_item_at_pos.c", "C", 37, 0, 0, 0, 5, 5, 47
"/Users/sbukhari/Sandbox/CProgram/ASTanalysis/CodexUserStudyData/Autopilot/davinci-002_07/parts/gen_list_save.c", "C", 27, 0, 0, 0, 8, 5, 40
"/Users/sbukhari/Sandbox/CProgram/ASTanalysis/CodexUserStudyData/Autopilot/davinci-002_07/parts/gen_list_swap_item_positions.c", "C", 58, 0, 0, 0, 5, 5, 68
"/Users/sbukhari/Sandbox/CProgram/ASTanalysis/CodexUserStudyData/Autopilot/davinci-002_07/parts/gen_list_update_item_at_pos.c", "C", 32, 0, 0, 0, 5, 5, 42
"/Users/sbukhari/Sandbox/CProgram/ASTanalysis/CodexUserStudyData/Autopilot/davinci-002_07/ref_testsuite.json", "JSON", 0, 323, 0, 0, 0, 1, 324
"/Users/sbukhari/Sandbox/CProgram/ASTanalysis/CodexUserStudyData/Autopilot/davinci-002_07/ref_testsuite_asan.json", "JSON", 0, 323, 0, 0, 0, 1, 324
"/Users/sbukhari/Sandbox/CProgram/ASTanalysis/CodexUserStudyData/Autopilot/davinci-002_07/ref_testsuite_asan_noleak.json", "JSON", 0, 323, 0, 0, 0, 1, 324
"/Users/sbukhari/Sandbox/CProgram/ASTanalysis/CodexUserStudyData/Autopilot/davinci-002_08/api_report.json", "JSON", 0, 14, 0, 0, 0, 1, 15
"/Users/sbukhari/Sandbox/CProgram/ASTanalysis/CodexUserStudyData/Autopilot/davinci-002_08/list.c", "C", 251, 0, 0, 0, 53, 30, 334
"/Users/sbukhari/Sandbox/CProgram/ASTanalysis/CodexUserStudyData/Autopilot/davinci-002_08/orig_testsuite.json", "JSON", 0, 92, 0, 0, 0, 1, 93
"/Users/sbukhari/Sandbox/CProgram/ASTanalysis/CodexUserStudyData/Autopilot/davinci-002_08/orig_testsuite_asan.json", "JSON", 0, 92, 0, 0, 0, 1, 93
"/Users/sbukhari/Sandbox/CProgram/ASTanalysis/CodexUserStudyData/Autopilot/davinci-002_08/orig_testsuite_asan_noleak.json", "JSON", 0, 92, 0, 0, 0, 1, 93
"/Users/sbukhari/Sandbox/CProgram/ASTanalysis/CodexUserStudyData/Autopilot/davinci-002_08/parts/gen_list_add_item_at_pos.c", "C", 52, 0, 0, 0, 15, 8, 75
"/Users/sbukhari/Sandbox/CProgram/ASTanalysis/CodexUserStudyData/Autopilot/davinci-002_08/parts/gen_list_cost_sum.c", "C", 24, 0, 0, 0, 5, 5, 34
"/Users/sbukhari/Sandbox/CProgram/ASTanalysis/CodexUserStudyData/Autopilot/davinci-002_08/parts/gen_list_deduplicate.c", "C", 36, 0, 0, 0, 7, 5, 48
"/Users/sbukhari/Sandbox/CProgram/ASTanalysis/CodexUserStudyData/Autopilot/davinci-002_08/parts/gen_list_find_highest_price_item_position.c", "C", 30, 0, 0, 0, 5, 5, 40
"/Users/sbukhari/Sandbox/CProgram/ASTanalysis/CodexUserStudyData/Autopilot/davinci-002_08/parts/gen_list_init.c", "C", 21, 0, 0, 0, 5, 5, 31
"/Users/sbukhari/Sandbox/CProgram/ASTanalysis/CodexUserStudyData/Autopilot/davinci-002_08/parts/gen_list_item_to_string.c", "C", 21, 0, 0, 0, 8, 5, 34
"/Users/sbukhari/Sandbox/CProgram/ASTanalysis/CodexUserStudyData/Autopilot/davinci-002_08/parts/gen_list_load.c", "C", 31, 0, 0, 0, 9, 5, 45
"/Users/sbukhari/Sandbox/CProgram/ASTanalysis/CodexUserStudyData/Autopilot/davinci-002_08/parts/gen_list_print.c", "C", 27, 0, 0, 0, 17, 5, 49
"/Users/sbukhari/Sandbox/CProgram/ASTanalysis/CodexUserStudyData/Autopilot/davinci-002_08/parts/gen_list_remove_item_at_pos.c", "C", 40, 0, 0, 0, 5, 8, 53
"/Users/sbukhari/Sandbox/CProgram/ASTanalysis/CodexUserStudyData/Autopilot/davinci-002_08/parts/gen_list_save.c", "C", 28, 0, 0, 0, 8, 5, 41
"/Users/sbukhari/Sandbox/CProgram/ASTanalysis/CodexUserStudyData/Autopilot/davinci-002_08/parts/gen_list_swap_item_positions.c", "C", 62, 0, 0, 0, 5, 10, 77
"/Users/sbukhari/Sandbox/CProgram/ASTanalysis/CodexUserStudyData/Autopilot/davinci-002_08/parts/gen_list_update_item_at_pos.c", "C", 34, 0, 0, 0, 5, 7, 46
"/Users/sbukhari/Sandbox/CProgram/ASTanalysis/CodexUserStudyData/Autopilot/davinci-002_08/ref_testsuite.json", "JSON", 0, 323, 0, 0, 0, 1, 324
"/Users/sbukhari/Sandbox/CProgram/ASTanalysis/CodexUserStudyData/Autopilot/davinci-002_08/ref_testsuite_asan.json", "JSON", 0, 323, 0, 0, 0, 1, 324
"/Users/sbukhari/Sandbox/CProgram/ASTanalysis/CodexUserStudyData/Autopilot/davinci-002_08/ref_testsuite_asan_noleak.json", "JSON", 0, 323, 0, 0, 0, 1, 324
"/Users/sbukhari/Sandbox/CProgram/ASTanalysis/CodexUserStudyData/Autopilot/davinci-002_09/api_report.json", "JSON", 0, 14, 0, 0, 0, 1, 15
"/Users/sbukhari/Sandbox/CProgram/ASTanalysis/CodexUserStudyData/Autopilot/davinci-002_09/list.c", "C", 240, 0, 0, 0, 53, 21, 314
"/Users/sbukhari/Sandbox/CProgram/ASTanalysis/CodexUserStudyData/Autopilot/davinci-002_09/orig_testsuite.json", "JSON", 0, 92, 0, 0, 0, 1, 93
"/Users/sbukhari/Sandbox/CProgram/ASTanalysis/CodexUserStudyData/Autopilot/davinci-002_09/orig_testsuite_asan.json", "JSON", 0, 92, 0, 0, 0, 1, 93
"/Users/sbukhari/Sandbox/CProgram/ASTanalysis/CodexUserStudyData/Autopilot/davinci-002_09/orig_testsuite_asan_noleak.json", "JSON", 0, 92, 0, 0, 0, 1, 93
"/Users/sbukhari/Sandbox/CProgram/ASTanalysis/CodexUserStudyData/Autopilot/davinci-002_09/parts/gen_list_add_item_at_pos.c", "C", 38, 0, 0, 0, 15, 6, 59
"/Users/sbukhari/Sandbox/CProgram/ASTanalysis/CodexUserStudyData/Autopilot/davinci-002_09/parts/gen_list_cost_sum.c", "C", 25, 0, 0, 0, 5, 5, 35
"/Users/sbukhari/Sandbox/CProgram/ASTanalysis/CodexUserStudyData/Autopilot/davinci-002_09/parts/gen_list_deduplicate.c", "C", 50, 0, 0, 0, 7, 5, 62
"/Users/sbukhari/Sandbox/CProgram/ASTanalysis/CodexUserStudyData/Autopilot/davinci-002_09/parts/gen_list_find_highest_price_item_position.c", "C", 32, 0, 0, 0, 5, 5, 42
"/Users/sbukhari/Sandbox/CProgram/ASTanalysis/CodexUserStudyData/Autopilot/davinci-002_09/parts/gen_list_init.c", "C", 18, 0, 0, 0, 5, 5, 28
"/Users/sbukhari/Sandbox/CProgram/ASTanalysis/CodexUserStudyData/Autopilot/davinci-002_09/parts/gen_list_item_to_string.c", "C", 24, 0, 0, 0, 8, 5, 37
"/Users/sbukhari/Sandbox/CProgram/ASTanalysis/CodexUserStudyData/Autopilot/davinci-002_09/parts/gen_list_load.c", "C", 42, 0, 0, 0, 9, 7, 58
"/Users/sbukhari/Sandbox/CProgram/ASTanalysis/CodexUserStudyData/Autopilot/davinci-002_09/parts/gen_list_print.c", "C", 24, 0, 0, 0, 17, 5, 46
"/Users/sbukhari/Sandbox/CProgram/ASTanalysis/CodexUserStudyData/Autopilot/davinci-002_09/parts/gen_list_remove_item_at_pos.c", "C", 33, 0, 0, 0, 5, 5, 43
"/Users/sbukhari/Sandbox/CProgram/ASTanalysis/CodexUserStudyData/Autopilot/davinci-002_09/parts/gen_list_save.c", "C", 26, 0, 0, 0, 8, 6, 40
"/Users/sbukhari/Sandbox/CProgram/ASTanalysis/CodexUserStudyData/Autopilot/davinci-002_09/parts/gen_list_swap_item_positions.c", "C", 52, 0, 0, 0, 5, 5, 62
"/Users/sbukhari/Sandbox/CProgram/ASTanalysis/CodexUserStudyData/Autopilot/davinci-002_09/parts/gen_list_update_item_at_pos.c", "C", 31, 0, 0, 0, 5, 5, 41
"/Users/sbukhari/Sandbox/CProgram/ASTanalysis/CodexUserStudyData/Autopilot/davinci-002_09/ref_testsuite.json", "JSON", 0, 323, 0, 0, 0, 1, 324
"/Users/sbukhari/Sandbox/CProgram/ASTanalysis/CodexUserStudyData/Autopilot/davinci-002_09/ref_testsuite_asan.json", "JSON", 0, 323, 0, 0, 0, 1, 324
"/Users/sbukhari/Sandbox/CProgram/ASTanalysis/CodexUserStudyData/Autopilot/davinci-002_09/ref_testsuite_asan_noleak.json", "JSON", 0, 323, 0, 0, 0, 1, 324
"/Users/sbukhari/Sandbox/CProgram/ASTanalysis/CodexUserStudyData/Control/035a8eed-29c0-4606-814d-4cb786d0b9de/api_report.json", "JSON", 0, 14, 0, 0, 0, 1, 15
"/Users/sbukhari/Sandbox/CProgram/ASTanalysis/CodexUserStudyData/Control/035a8eed-29c0-4606-814d-4cb786d0b9de/list.c", "C", 213, 0, 0, 0, 52, 50, 315
"/Users/sbukhari/Sandbox/CProgram/ASTanalysis/CodexUserStudyData/Control/035a8eed-29c0-4606-814d-4cb786d0b9de/orig_testsuite.json", "JSON", 0, 92, 0, 0, 0, 1, 93
"/Users/sbukhari/Sandbox/CProgram/ASTanalysis/CodexUserStudyData/Control/035a8eed-29c0-4606-814d-4cb786d0b9de/orig_testsuite_asan.json", "JSON", 0, 92, 0, 0, 0, 1, 93
"/Users/sbukhari/Sandbox/CProgram/ASTanalysis/CodexUserStudyData/Control/035a8eed-29c0-4606-814d-4cb786d0b9de/orig_testsuite_asan_noleak.json", "JSON", 0, 92, 0, 0, 0, 1, 93
"/Users/sbukhari/Sandbox/CProgram/ASTanalysis/CodexUserStudyData/Control/035a8eed-29c0-4606-814d-4cb786d0b9de/parts/gen_list_add_item_at_pos.c", "C", 43, 0, 0, 0, 17, 7, 67
"/Users/sbukhari/Sandbox/CProgram/ASTanalysis/CodexUserStudyData/Control/035a8eed-29c0-4606-814d-4cb786d0b9de/parts/gen_list_cost_sum.c", "C", 24, 0, 0, 0, 7, 8, 39
"/Users/sbukhari/Sandbox/CProgram/ASTanalysis/CodexUserStudyData/Control/035a8eed-29c0-4606-814d-4cb786d0b9de/parts/gen_list_deduplicate.c", "C", 34, 0, 0, 0, 12, 7, 53
"/Users/sbukhari/Sandbox/CProgram/ASTanalysis/CodexUserStudyData/Control/035a8eed-29c0-4606-814d-4cb786d0b9de/parts/gen_list_find_highest_price_item_position.c", "C", 26, 0, 0, 0, 8, 9, 43
"/Users/sbukhari/Sandbox/CProgram/ASTanalysis/CodexUserStudyData/Control/035a8eed-29c0-4606-814d-4cb786d0b9de/parts/gen_list_init.c", "C", 19, 0, 0, 0, 6, 6, 31
"/Users/sbukhari/Sandbox/CProgram/ASTanalysis/CodexUserStudyData/Control/035a8eed-29c0-4606-814d-4cb786d0b9de/parts/gen_list_item_to_string.c", "C", 20, 0, 0, 0, 12, 5, 37
"/Users/sbukhari/Sandbox/CProgram/ASTanalysis/CodexUserStudyData/Control/035a8eed-29c0-4606-814d-4cb786d0b9de/parts/gen_list_load.c", "C", 38, 0, 0, 0, 17, 10, 65
"/Users/sbukhari/Sandbox/CProgram/ASTanalysis/CodexUserStudyData/Control/035a8eed-29c0-4606-814d-4cb786d0b9de/parts/gen_list_print.c", "C", 23, 0, 0, 0, 19, 5, 47
"/Users/sbukhari/Sandbox/CProgram/ASTanalysis/CodexUserStudyData/Control/035a8eed-29c0-4606-814d-4cb786d0b9de/parts/gen_list_remove_item_at_pos.c", "C", 35, 0, 0, 0, 10, 8, 53
"/Users/sbukhari/Sandbox/CProgram/ASTanalysis/CodexUserStudyData/Control/035a8eed-29c0-4606-814d-4cb786d0b9de/parts/gen_list_save.c", "C", 28, 0, 0, 0, 12, 10, 50
"/Users/sbukhari/Sandbox/CProgram/ASTanalysis/CodexUserStudyData/Control/035a8eed-29c0-4606-814d-4cb786d0b9de/parts/gen_list_swap_item_positions.c", "C", 50, 0, 0, 0, 7, 14, 71
"/Users/sbukhari/Sandbox/CProgram/ASTanalysis/CodexUserStudyData/Control/035a8eed-29c0-4606-814d-4cb786d0b9de/parts/gen_list_update_item_at_pos.c", "C", 28, 0, 0, 0, 9, 5, 42
"/Users/sbukhari/Sandbox/CProgram/ASTanalysis/CodexUserStudyData/Control/035a8eed-29c0-4606-814d-4cb786d0b9de/ref_testsuite.json", "JSON", 0, 323, 0, 0, 0, 1, 324
"/Users/sbukhari/Sandbox/CProgram/ASTanalysis/CodexUserStudyData/Control/035a8eed-29c0-4606-814d-4cb786d0b9de/ref_testsuite_asan.json", "JSON", 0, 323, 0, 0, 0, 1, 324
"/Users/sbukhari/Sandbox/CProgram/ASTanalysis/CodexUserStudyData/Control/035a8eed-29c0-4606-814d-4cb786d0b9de/ref_testsuite_asan_noleak.json", "JSON", 0, 323, 0, 0, 0, 1, 324
"/Users/sbukhari/Sandbox/CProgram/ASTanalysis/CodexUserStudyData/Control/1f53c71a-e1b9-4b65-a11e-c15f3c38a6cf/api_report.json", "JSON", 0, 14, 0, 0, 0, 1, 15
"/Users/sbukhari/Sandbox/CProgram/ASTanalysis/CodexUserStudyData/Control/1f53c71a-e1b9-4b65-a11e-c15f3c38a6cf/list.c", "C", 246, 0, 0, 0, 113, 87, 446
"/Users/sbukhari/Sandbox/CProgram/ASTanalysis/CodexUserStudyData/Control/1f53c71a-e1b9-4b65-a11e-c15f3c38a6cf/orig_testsuite.json", "JSON", 0, 92, 0, 0, 0, 1, 93
"/Users/sbukhari/Sandbox/CProgram/ASTanalysis/CodexUserStudyData/Control/1f53c71a-e1b9-4b65-a11e-c15f3c38a6cf/orig_testsuite_asan.json", "JSON", 0, 92, 0, 0, 0, 1, 93
"/Users/sbukhari/Sandbox/CProgram/ASTanalysis/CodexUserStudyData/Control/1f53c71a-e1b9-4b65-a11e-c15f3c38a6cf/orig_testsuite_asan_noleak.json", "JSON", 0, 92, 0, 0, 0, 1, 93
"/Users/sbukhari/Sandbox/CProgram/ASTanalysis/CodexUserStudyData/Control/1f53c71a-e1b9-4b65-a11e-c15f3c38a6cf/parts/gen_list_add_item_at_pos.c", "C", 43, 0, 0, 0, 26, 14, 83
"/Users/sbukhari/Sandbox/CProgram/ASTanalysis/CodexUserStudyData/Control/1f53c71a-e1b9-4b65-a11e-c15f3c38a6cf/parts/gen_list_cost_sum.c", "C", 25, 0, 0, 0, 11, 9, 45
"/Users/sbukhari/Sandbox/CProgram/ASTanalysis/CodexUserStudyData/Control/1f53c71a-e1b9-4b65-a11e-c15f3c38a6cf/parts/gen_list_deduplicate.c", "C", 40, 0, 0, 0, 16, 13, 69
"/Users/sbukhari/Sandbox/CProgram/ASTanalysis/CodexUserStudyData/Control/1f53c71a-e1b9-4b65-a11e-c15f3c38a6cf/parts/gen_list_find_highest_price_item_position.c", "C", 33, 0, 0, 0, 13, 10, 56
"/Users/sbukhari/Sandbox/CProgram/ASTanalysis/CodexUserStudyData/Control/1f53c71a-e1b9-4b65-a11e-c15f3c38a6cf/parts/gen_list_init.c", "C", 19, 0, 0, 0, 6, 6, 31
"/Users/sbukhari/Sandbox/CProgram/ASTanalysis/CodexUserStudyData/Control/1f53c71a-e1b9-4b65-a11e-c15f3c38a6cf/parts/gen_list_item_to_string.c", "C", 24, 0, 0, 0, 16, 8, 48
"/Users/sbukhari/Sandbox/CProgram/ASTanalysis/CodexUserStudyData/Control/1f53c71a-e1b9-4b65-a11e-c15f3c38a6cf/parts/gen_list_load.c", "C", 39, 0, 0, 0, 21, 13, 73
"/Users/sbukhari/Sandbox/CProgram/ASTanalysis/CodexUserStudyData/Control/1f53c71a-e1b9-4b65-a11e-c15f3c38a6cf/parts/gen_list_print.c", "C", 29, 0, 0, 0, 21, 8, 58
"/Users/sbukhari/Sandbox/CProgram/ASTanalysis/CodexUserStudyData/Control/1f53c71a-e1b9-4b65-a11e-c15f3c38a6cf/parts/gen_list_remove_item_at_pos.c", "C", 39, 0, 0, 0, 14, 14, 67
"/Users/sbukhari/Sandbox/CProgram/ASTanalysis/CodexUserStudyData/Control/1f53c71a-e1b9-4b65-a11e-c15f3c38a6cf/parts/gen_list_save.c", "C", 29, 0, 0, 0, 17, 10, 56
"/Users/sbukhari/Sandbox/CProgram/ASTanalysis/CodexUserStudyData/Control/1f53c71a-e1b9-4b65-a11e-c15f3c38a6cf/parts/gen_list_swap_item_positions.c", "C", 47, 0, 0, 0, 13, 16, 76
"/Users/sbukhari/Sandbox/CProgram/ASTanalysis/CodexUserStudyData/Control/1f53c71a-e1b9-4b65-a11e-c15f3c38a6cf/parts/gen_list_update_item_at_pos.c", "C", 34, 0, 0, 0, 13, 11, 58
"/Users/sbukhari/Sandbox/CProgram/ASTanalysis/CodexUserStudyData/Control/1f53c71a-e1b9-4b65-a11e-c15f3c38a6cf/ref_testsuite.json", "JSON", 0, 323, 0, 0, 0, 1, 324
"/Users/sbukhari/Sandbox/CProgram/ASTanalysis/CodexUserStudyData/Control/1f53c71a-e1b9-4b65-a11e-c15f3c38a6cf/ref_testsuite_asan.json", "JSON", 0, 323, 0, 0, 0, 1, 324
"/Users/sbukhari/Sandbox/CProgram/ASTanalysis/CodexUserStudyData/Control/1f53c71a-e1b9-4b65-a11e-c15f3c38a6cf/ref_testsuite_asan_noleak.json", "JSON", 0, 323, 0, 0, 0, 1, 324
"/Users/sbukhari/Sandbox/CProgram/ASTanalysis/CodexUserStudyData/Control/275f0df3-1f22-43e1-b37c-147169908268/api_report.json", "JSON", 0, 14, 0, 0, 0, 1, 15
"/Users/sbukhari/Sandbox/CProgram/ASTanalysis/CodexUserStudyData/Control/275f0df3-1f22-43e1-b37c-147169908268/list.c", "C", 120, 0, 0, 0, 40, 17, 177
"/Users/sbukhari/Sandbox/CProgram/ASTanalysis/CodexUserStudyData/Control/275f0df3-1f22-43e1-b37c-147169908268/orig_testsuite.json", "JSON", 0, 92, 0, 0, 0, 1, 93
"/Users/sbukhari/Sandbox/CProgram/ASTanalysis/CodexUserStudyData/Control/275f0df3-1f22-43e1-b37c-147169908268/orig_testsuite_asan.json", "JSON", 0, 92, 0, 0, 0, 1, 93
"/Users/sbukhari/Sandbox/CProgram/ASTanalysis/CodexUserStudyData/Control/275f0df3-1f22-43e1-b37c-147169908268/orig_testsuite_asan_noleak.json", "JSON", 0, 92, 0, 0, 0, 1, 93
"/Users/sbukhari/Sandbox/CProgram/ASTanalysis/CodexUserStudyData/Control/275f0df3-1f22-43e1-b37c-147169908268/parts/gen_list_add_item_at_pos.c", "C", 18, 0, 0, 0, 18, 5, 41
"/Users/sbukhari/Sandbox/CProgram/ASTanalysis/CodexUserStudyData/Control/275f0df3-1f22-43e1-b37c-147169908268/parts/gen_list_cost_sum.c", "C", 18, 0, 0, 0, 8, 5, 31
"/Users/sbukhari/Sandbox/CProgram/ASTanalysis/CodexUserStudyData/Control/275f0df3-1f22-43e1-b37c-147169908268/parts/gen_list_deduplicate.c", "C", 18, 0, 0, 0, 10, 5, 33
"/Users/sbukhari/Sandbox/CProgram/ASTanalysis/CodexUserStudyData/Control/275f0df3-1f22-43e1-b37c-147169908268/parts/gen_list_find_highest_price_item_position.c", "C", 29, 0, 0, 0, 9, 5, 43
"/Users/sbukhari/Sandbox/CProgram/ASTanalysis/CodexUserStudyData/Control/275f0df3-1f22-43e1-b37c-147169908268/parts/gen_list_init.c", "C", 19, 0, 0, 0, 6, 6, 31
"/Users/sbukhari/Sandbox/CProgram/ASTanalysis/CodexUserStudyData/Control/275f0df3-1f22-43e1-b37c-147169908268/parts/gen_list_item_to_string.c", "C", 18, 0, 0, 0, 11, 5, 34
"/Users/sbukhari/Sandbox/CProgram/ASTanalysis/CodexUserStudyData/Control/275f0df3-1f22-43e1-b37c-147169908268/parts/gen_list_load.c", "C", 18, 0, 0, 0, 12, 5, 35
"/Users/sbukhari/Sandbox/CProgram/ASTanalysis/CodexUserStudyData/Control/275f0df3-1f22-43e1-b37c-147169908268/parts/gen_list_print.c", "C", 26, 0, 0, 0, 22, 5, 53
"/Users/sbukhari/Sandbox/CProgram/ASTanalysis/CodexUserStudyData/Control/275f0df3-1f22-43e1-b37c-147169908268/parts/gen_list_remove_item_at_pos.c", "C", 18, 0, 0, 0, 8, 5, 31
"/Users/sbukhari/Sandbox/CProgram/ASTanalysis/CodexUserStudyData/Control/275f0df3-1f22-43e1-b37c-147169908268/parts/gen_list_save.c", "C", 18, 0, 0, 0, 11, 5, 34
"/Users/sbukhari/Sandbox/CProgram/ASTanalysis/CodexUserStudyData/Control/275f0df3-1f22-43e1-b37c-147169908268/parts/gen_list_swap_item_positions.c", "C", 34, 0, 0, 0, 9, 7, 50
"/Users/sbukhari/Sandbox/CProgram/ASTanalysis/CodexUserStudyData/Control/275f0df3-1f22-43e1-b37c-147169908268/parts/gen_list_update_item_at_pos.c", "C", 17, 0, 0, 0, 8, 5, 30
"/Users/sbukhari/Sandbox/CProgram/ASTanalysis/CodexUserStudyData/Control/275f0df3-1f22-43e1-b37c-147169908268/ref_testsuite.json", "JSON", 0, 323, 0, 0, 0, 1, 324
"/Users/sbukhari/Sandbox/CProgram/ASTanalysis/CodexUserStudyData/Control/275f0df3-1f22-43e1-b37c-147169908268/ref_testsuite_asan.json", "JSON", 0, 323, 0, 0, 0, 1, 324
"/Users/sbukhari/Sandbox/CProgram/ASTanalysis/CodexUserStudyData/Control/275f0df3-1f22-43e1-b37c-147169908268/ref_testsuite_asan_noleak.json", "JSON", 0, 323, 0, 0, 0, 1, 324
"/Users/sbukhari/Sandbox/CProgram/ASTanalysis/CodexUserStudyData/Control/32999001-1b8b-40d0-8776-0dc7fbd264ac/api_report.json", "JSON", 0, 14, 0, 0, 0, 1, 15
"/Users/sbukhari/Sandbox/CProgram/ASTanalysis/CodexUserStudyData/Control/32999001-1b8b-40d0-8776-0dc7fbd264ac/list.c", "C", 202, 0, 0, 0, 69, 36, 307
"/Users/sbukhari/Sandbox/CProgram/ASTanalysis/CodexUserStudyData/Control/32999001-1b8b-40d0-8776-0dc7fbd264ac/orig_testsuite.json", "JSON", 0, 92, 0, 0, 0, 1, 93
"/Users/sbukhari/Sandbox/CProgram/ASTanalysis/CodexUserStudyData/Control/32999001-1b8b-40d0-8776-0dc7fbd264ac/orig_testsuite_asan.json", "JSON", 0, 92, 0, 0, 0, 1, 93
"/Users/sbukhari/Sandbox/CProgram/ASTanalysis/CodexUserStudyData/Control/32999001-1b8b-40d0-8776-0dc7fbd264ac/orig_testsuite_asan_noleak.json", "JSON", 0, 92, 0, 0, 0, 1, 93
"/Users/sbukhari/Sandbox/CProgram/ASTanalysis/CodexUserStudyData/Control/32999001-1b8b-40d0-8776-0dc7fbd264ac/parts/gen_list_add_item_at_pos.c", "C", 18, 0, 0, 0, 18, 5, 41
"/Users/sbukhari/Sandbox/CProgram/ASTanalysis/CodexUserStudyData/Control/32999001-1b8b-40d0-8776-0dc7fbd264ac/parts/gen_list_cost_sum.c", "C", 18, 0, 0, 0, 8, 5, 31
"/Users/sbukhari/Sandbox/CProgram/ASTanalysis/CodexUserStudyData/Control/32999001-1b8b-40d0-8776-0dc7fbd264ac/parts/gen_list_deduplicate.c", "C", 18, 0, 0, 0, 10, 5, 33
"/Users/sbukhari/Sandbox/CProgram/ASTanalysis/CodexUserStudyData/Control/32999001-1b8b-40d0-8776-0dc7fbd264ac/parts/gen_list_find_highest_price_item_position.c", "C", 18, 0, 0, 0, 8, 5, 31
"/Users/sbukhari/Sandbox/CProgram/ASTanalysis/CodexUserStudyData/Control/32999001-1b8b-40d0-8776-0dc7fbd264ac/parts/gen_list_init.c", "C", 19, 0, 0, 0, 6, 6, 31
"/Users/sbukhari/Sandbox/CProgram/ASTanalysis/CodexUserStudyData/Control/32999001-1b8b-40d0-8776-0dc7fbd264ac/parts/gen_list_item_to_string.c", "C", 17, 0, 0, 0, 11, 5, 33
"/Users/sbukhari/Sandbox/CProgram/ASTanalysis/CodexUserStudyData/Control/32999001-1b8b-40d0-8776-0dc7fbd264ac/parts/gen_list_load.c", "C", 18, 0, 0, 0, 12, 5, 35
"/Users/sbukhari/Sandbox/CProgram/ASTanalysis/CodexUserStudyData/Control/32999001-1b8b-40d0-8776-0dc7fbd264ac/parts/gen_list_print.c", "C", 17, 0, 0, 0, 20, 5, 42
"/Users/sbukhari/Sandbox/CProgram/ASTanalysis/CodexUserStudyData/Control/32999001-1b8b-40d0-8776-0dc7fbd264ac/parts/gen_list_remove_item_at_pos.c", "C", 18, 0, 0, 0, 8, 5, 31
"/Users/sbukhari/Sandbox/CProgram/ASTanalysis/CodexUserStudyData/Control/32999001-1b8b-40d0-8776-0dc7fbd264ac/parts/gen_list_save.c", "C", 19, 0, 0, 0, 9, 5, 33
"/Users/sbukhari/Sandbox/CProgram/ASTanalysis/CodexUserStudyData/Control/32999001-1b8b-40d0-8776-0dc7fbd264ac/parts/gen_list_swap_item_positions.c", "C", 17, 0, 0, 0, 8, 5, 30
"/Users/sbukhari/Sandbox/CProgram/ASTanalysis/CodexUserStudyData/Control/32999001-1b8b-40d0-8776-0dc7fbd264ac/parts/gen_list_update_item_at_pos.c", "C", 17, 0, 0, 0, 8, 5, 30
"/Users/sbukhari/Sandbox/CProgram/ASTanalysis/CodexUserStudyData/Control/32999001-1b8b-40d0-8776-0dc7fbd264ac/ref_testsuite.json", "JSON", 0, 323, 0, 0, 0, 1, 324
"/Users/sbukhari/Sandbox/CProgram/ASTanalysis/CodexUserStudyData/Control/32999001-1b8b-40d0-8776-0dc7fbd264ac/ref_testsuite_asan.json", "JSON", 0, 323, 0, 0, 0, 1, 324
"/Users/sbukhari/Sandbox/CProgram/ASTanalysis/CodexUserStudyData/Control/32999001-1b8b-40d0-8776-0dc7fbd264ac/ref_testsuite_asan_noleak.json", "JSON", 0, 323, 0, 0, 0, 1, 324
"/Users/sbukhari/Sandbox/CProgram/ASTanalysis/CodexUserStudyData/Control/394b3e22-bd6f-4c90-9300-5826a9d033ad/api_report.json", "JSON", 0, 14, 0, 0, 0, 1, 15
"/Users/sbukhari/Sandbox/CProgram/ASTanalysis/CodexUserStudyData/Control/394b3e22-bd6f-4c90-9300-5826a9d033ad/list.c", "C", 84, 0, 0, 0, 74, 17, 175
"/Users/sbukhari/Sandbox/CProgram/ASTanalysis/CodexUserStudyData/Control/394b3e22-bd6f-4c90-9300-5826a9d033ad/orig_testsuite.json", "JSON", 0, 92, 0, 0, 0, 1, 93
"/Users/sbukhari/Sandbox/CProgram/ASTanalysis/CodexUserStudyData/Control/394b3e22-bd6f-4c90-9300-5826a9d033ad/orig_testsuite_asan.json", "JSON", 0, 92, 0, 0, 0, 1, 93
"/Users/sbukhari/Sandbox/CProgram/ASTanalysis/CodexUserStudyData/Control/394b3e22-bd6f-4c90-9300-5826a9d033ad/orig_testsuite_asan_noleak.json", "JSON", 0, 92, 0, 0, 0, 1, 93
"/Users/sbukhari/Sandbox/CProgram/ASTanalysis/CodexUserStudyData/Control/394b3e22-bd6f-4c90-9300-5826a9d033ad/parts/gen_list_add_item_at_pos.c", "C", 18, 0, 0, 0, 18, 5, 41
"/Users/sbukhari/Sandbox/CProgram/ASTanalysis/CodexUserStudyData/Control/394b3e22-bd6f-4c90-9300-5826a9d033ad/parts/gen_list_cost_sum.c", "C", 18, 0, 0, 0, 8, 5, 31
"/Users/sbukhari/Sandbox/CProgram/ASTanalysis/CodexUserStudyData/Control/394b3e22-bd6f-4c90-9300-5826a9d033ad/parts/gen_list_deduplicate.c", "C", 18, 0, 0, 0, 10, 5, 33
"/Users/sbukhari/Sandbox/CProgram/ASTanalysis/CodexUserStudyData/Control/394b3e22-bd6f-4c90-9300-5826a9d033ad/parts/gen_list_find_highest_price_item_position.c", "C", 18, 0, 0, 0, 8, 5, 31
"/Users/sbukhari/Sandbox/CProgram/ASTanalysis/CodexUserStudyData/Control/394b3e22-bd6f-4c90-9300-5826a9d033ad/parts/gen_list_init.c", "C", 19, 0, 0, 0, 6, 6, 31
"/Users/sbukhari/Sandbox/CProgram/ASTanalysis/CodexUserStudyData/Control/394b3e22-bd6f-4c90-9300-5826a9d033ad/parts/gen_list_item_to_string.c", "C", 17, 0, 0, 0, 11, 5, 33
"/Users/sbukhari/Sandbox/CProgram/ASTanalysis/CodexUserStudyData/Control/394b3e22-bd6f-4c90-9300-5826a9d033ad/parts/gen_list_load.c", "C", 18, 0, 0, 0, 12, 5, 35
"/Users/sbukhari/Sandbox/CProgram/ASTanalysis/CodexUserStudyData/Control/394b3e22-bd6f-4c90-9300-5826a9d033ad/parts/gen_list_print.c", "C", 30, 0, 0, 0, 21, 5, 56
"/Users/sbukhari/Sandbox/CProgram/ASTanalysis/CodexUserStudyData/Control/394b3e22-bd6f-4c90-9300-5826a9d033ad/parts/gen_list_remove_item_at_pos.c", "C", 18, 0, 0, 0, 8, 5, 31
"/Users/sbukhari/Sandbox/CProgram/ASTanalysis/CodexUserStudyData/Control/394b3e22-bd6f-4c90-9300-5826a9d033ad/parts/gen_list_save.c", "C", 18, 0, 0, 0, 11, 5, 34
"/Users/sbukhari/Sandbox/CProgram/ASTanalysis/CodexUserStudyData/Control/394b3e22-bd6f-4c90-9300-5826a9d033ad/parts/gen_list_swap_item_positions.c", "C", 18, 0, 0, 0, 8, 5, 31
"/Users/sbukhari/Sandbox/CProgram/ASTanalysis/CodexUserStudyData/Control/394b3e22-bd6f-4c90-9300-5826a9d033ad/parts/gen_list_update_item_at_pos.c", "C", 18, 0, 0, 0, 8, 5, 31
"/Users/sbukhari/Sandbox/CProgram/ASTanalysis/CodexUserStudyData/Control/394b3e22-bd6f-4c90-9300-5826a9d033ad/ref_testsuite.json", "JSON", 0, 323, 0, 0, 0, 1, 324
"/Users/sbukhari/Sandbox/CProgram/ASTanalysis/CodexUserStudyData/Control/394b3e22-bd6f-4c90-9300-5826a9d033ad/ref_testsuite_asan.json", "JSON", 0, 323, 0, 0, 0, 1, 324
"/Users/sbukhari/Sandbox/CProgram/ASTanalysis/CodexUserStudyData/Control/394b3e22-bd6f-4c90-9300-5826a9d033ad/ref_testsuite_asan_noleak.json", "JSON", 0, 323, 0, 0, 0, 1, 324
"/Users/sbukhari/Sandbox/CProgram/ASTanalysis/CodexUserStudyData/Control/40a638f7-3fe3-43b0-b6cd-c47427778724/api_report.json", "JSON", 0, 14, 0, 0, 0, 1, 15
"/Users/sbukhari/Sandbox/CProgram/ASTanalysis/CodexUserStudyData/Control/40a638f7-3fe3-43b0-b6cd-c47427778724/list.c", "C", 151, 0, 0, 0, 75, 22, 248
"/Users/sbukhari/Sandbox/CProgram/ASTanalysis/CodexUserStudyData/Control/40a638f7-3fe3-43b0-b6cd-c47427778724/orig_testsuite.json", "JSON", 0, 92, 0, 0, 0, 1, 93
"/Users/sbukhari/Sandbox/CProgram/ASTanalysis/CodexUserStudyData/Control/40a638f7-3fe3-43b0-b6cd-c47427778724/orig_testsuite_asan.json", "JSON", 0, 92, 0, 0, 0, 1, 93
"/Users/sbukhari/Sandbox/CProgram/ASTanalysis/CodexUserStudyData/Control/40a638f7-3fe3-43b0-b6cd-c47427778724/orig_testsuite_asan_noleak.json", "JSON", 0, 92, 0, 0, 0, 1, 93
"/Users/sbukhari/Sandbox/CProgram/ASTanalysis/CodexUserStudyData/Control/40a638f7-3fe3-43b0-b6cd-c47427778724/parts/gen_list_add_item_at_pos.c", "C", 38, 0, 0, 0, 19, 5, 62
"/Users/sbukhari/Sandbox/CProgram/ASTanalysis/CodexUserStudyData/Control/40a638f7-3fe3-43b0-b6cd-c47427778724/parts/gen_list_cost_sum.c", "C", 25, 0, 0, 0, 9, 5, 39
"/Users/sbukhari/Sandbox/CProgram/ASTanalysis/CodexUserStudyData/Control/40a638f7-3fe3-43b0-b6cd-c47427778724/parts/gen_list_deduplicate.c", "C", 19, 0, 0, 0, 10, 5, 34
"/Users/sbukhari/Sandbox/CProgram/ASTanalysis/CodexUserStudyData/Control/40a638f7-3fe3-43b0-b6cd-c47427778724/parts/gen_list_find_highest_price_item_position.c", "C", 30, 0, 0, 0, 10, 5, 45
"/Users/sbukhari/Sandbox/CProgram/ASTanalysis/CodexUserStudyData/Control/40a638f7-3fe3-43b0-b6cd-c47427778724/parts/gen_list_init.c", "C", 20, 0, 0, 0, 6, 6, 32
"/Users/sbukhari/Sandbox/CProgram/ASTanalysis/CodexUserStudyData/Control/40a638f7-3fe3-43b0-b6cd-c47427778724/parts/gen_list_item_to_string.c", "C", 22, 0, 0, 0, 15, 5, 42
"/Users/sbukhari/Sandbox/CProgram/ASTanalysis/CodexUserStudyData/Control/40a638f7-3fe3-43b0-b6cd-c47427778724/parts/gen_list_load.c", "C", 19, 0, 0, 0, 12, 6, 37
"/Users/sbukhari/Sandbox/CProgram/ASTanalysis/CodexUserStudyData/Control/40a638f7-3fe3-43b0-b6cd-c47427778724/parts/gen_list_print.c", "C", 28, 0, 0, 0, 22, 5, 55
"/Users/sbukhari/Sandbox/CProgram/ASTanalysis/CodexUserStudyData/Control/40a638f7-3fe3-43b0-b6cd-c47427778724/parts/gen_list_remove_item_at_pos.c", "C", 30, 0, 0, 0, 13, 5, 48
"/Users/sbukhari/Sandbox/CProgram/ASTanalysis/CodexUserStudyData/Control/40a638f7-3fe3-43b0-b6cd-c47427778724/parts/gen_list_save.c", "C", 33, 0, 0, 0, 16, 6, 55
"/Users/sbukhari/Sandbox/CProgram/ASTanalysis/CodexUserStudyData/Control/40a638f7-3fe3-43b0-b6cd-c47427778724/parts/gen_list_swap_item_positions.c", "C", 18, 0, 0, 0, 8, 6, 32
"/Users/sbukhari/Sandbox/CProgram/ASTanalysis/CodexUserStudyData/Control/40a638f7-3fe3-43b0-b6cd-c47427778724/parts/gen_list_update_item_at_pos.c", "C", 35, 0, 0, 0, 14, 6, 55
"/Users/sbukhari/Sandbox/CProgram/ASTanalysis/CodexUserStudyData/Control/40a638f7-3fe3-43b0-b6cd-c47427778724/ref_testsuite.json", "JSON", 0, 323, 0, 0, 0, 1, 324
"/Users/sbukhari/Sandbox/CProgram/ASTanalysis/CodexUserStudyData/Control/40a638f7-3fe3-43b0-b6cd-c47427778724/ref_testsuite_asan.json", "JSON", 0, 323, 0, 0, 0, 1, 324
"/Users/sbukhari/Sandbox/CProgram/ASTanalysis/CodexUserStudyData/Control/40a638f7-3fe3-43b0-b6cd-c47427778724/ref_testsuite_asan_noleak.json", "JSON", 0, 323, 0, 0, 0, 1, 324
"/Users/sbukhari/Sandbox/CProgram/ASTanalysis/CodexUserStudyData/Control/4992045a-4e79-4768-a0e8-8a8219c7b8d5/api_report.json", "JSON", 0, 14, 0, 0, 0, 1, 15
"/Users/sbukhari/Sandbox/CProgram/ASTanalysis/CodexUserStudyData/Control/4992045a-4e79-4768-a0e8-8a8219c7b8d5/list.c", "C", 86, 0, 0, 0, 86, 21, 193
"/Users/sbukhari/Sandbox/CProgram/ASTanalysis/CodexUserStudyData/Control/4992045a-4e79-4768-a0e8-8a8219c7b8d5/orig_testsuite.json", "JSON", 0, 92, 0, 0, 0, 1, 93
"/Users/sbukhari/Sandbox/CProgram/ASTanalysis/CodexUserStudyData/Control/4992045a-4e79-4768-a0e8-8a8219c7b8d5/orig_testsuite_asan.json", "JSON", 0, 92, 0, 0, 0, 1, 93
"/Users/sbukhari/Sandbox/CProgram/ASTanalysis/CodexUserStudyData/Control/4992045a-4e79-4768-a0e8-8a8219c7b8d5/orig_testsuite_asan_noleak.json", "JSON", 0, 92, 0, 0, 0, 1, 93
"/Users/sbukhari/Sandbox/CProgram/ASTanalysis/CodexUserStudyData/Control/4992045a-4e79-4768-a0e8-8a8219c7b8d5/parts/gen_list_add_item_at_pos.c", "C", 38, 0, 0, 0, 29, 8, 75
"/Users/sbukhari/Sandbox/CProgram/ASTanalysis/CodexUserStudyData/Control/4992045a-4e79-4768-a0e8-8a8219c7b8d5/parts/gen_list_cost_sum.c", "C", 18, 0, 0, 0, 17, 7, 42
"/Users/sbukhari/Sandbox/CProgram/ASTanalysis/CodexUserStudyData/Control/4992045a-4e79-4768-a0e8-8a8219c7b8d5/parts/gen_list_deduplicate.c", "C", 18, 0, 0, 0, 19, 7, 44
"/Users/sbukhari/Sandbox/CProgram/ASTanalysis/CodexUserStudyData/Control/4992045a-4e79-4768-a0e8-8a8219c7b8d5/parts/gen_list_find_highest_price_item_position.c", "C", 18, 0, 0, 0, 17, 7, 42
"/Users/sbukhari/Sandbox/CProgram/ASTanalysis/CodexUserStudyData/Control/4992045a-4e79-4768-a0e8-8a8219c7b8d5/parts/gen_list_init.c", "C", 19, 0, 0, 0, 15, 8, 42
"/Users/sbukhari/Sandbox/CProgram/ASTanalysis/CodexUserStudyData/Control/4992045a-4e79-4768-a0e8-8a8219c7b8d5/parts/gen_list_item_to_string.c", "C", 21, 0, 0, 0, 23, 7, 51
"/Users/sbukhari/Sandbox/CProgram/ASTanalysis/CodexUserStudyData/Control/4992045a-4e79-4768-a0e8-8a8219c7b8d5/parts/gen_list_load.c", "C", 18, 0, 0, 0, 21, 7, 46
"/Users/sbukhari/Sandbox/CProgram/ASTanalysis/CodexUserStudyData/Control/4992045a-4e79-4768-a0e8-8a8219c7b8d5/parts/gen_list_print.c", "C", 28, 0, 0, 0, 31, 7, 66
"/Users/sbukhari/Sandbox/CProgram/ASTanalysis/CodexUserStudyData/Control/4992045a-4e79-4768-a0e8-8a8219c7b8d5/parts/gen_list_remove_item_at_pos.c", "C", 18, 0, 0, 0, 17, 7, 42
"/Users/sbukhari/Sandbox/CProgram/ASTanalysis/CodexUserStudyData/Control/4992045a-4e79-4768-a0e8-8a8219c7b8d5/parts/gen_list_save.c", "C", 18, 0, 0, 0, 20, 7, 45
"/Users/sbukhari/Sandbox/CProgram/ASTanalysis/CodexUserStudyData/Control/4992045a-4e79-4768-a0e8-8a8219c7b8d5/parts/gen_list_swap_item_positions.c", "C", 17, 0, 0, 0, 17, 7, 41
"/Users/sbukhari/Sandbox/CProgram/ASTanalysis/CodexUserStudyData/Control/4992045a-4e79-4768-a0e8-8a8219c7b8d5/parts/gen_list_update_item_at_pos.c", "C", 17, 0, 0, 0, 17, 8, 42
"/Users/sbukhari/Sandbox/CProgram/ASTanalysis/CodexUserStudyData/Control/4992045a-4e79-4768-a0e8-8a8219c7b8d5/ref_testsuite.json", "JSON", 0, 323, 0, 0, 0, 1, 324
"/Users/sbukhari/Sandbox/CProgram/ASTanalysis/CodexUserStudyData/Control/4992045a-4e79-4768-a0e8-8a8219c7b8d5/ref_testsuite_asan.json", "JSON", 0, 323, 0, 0, 0, 1, 324
"/Users/sbukhari/Sandbox/CProgram/ASTanalysis/CodexUserStudyData/Control/4992045a-4e79-4768-a0e8-8a8219c7b8d5/ref_testsuite_asan_noleak.json", "JSON", 0, 323, 0, 0, 0, 1, 324
"/Users/sbukhari/Sandbox/CProgram/ASTanalysis/CodexUserStudyData/Control/549eca81-c8f8-4237-9237-220ab72ac8cf/api_report.json", "JSON", 0, 14, 0, 0, 0, 1, 15
"/Users/sbukhari/Sandbox/CProgram/ASTanalysis/CodexUserStudyData/Control/549eca81-c8f8-4237-9237-220ab72ac8cf/list.c", "C", 197, 0, 0, 0, 93, 35, 325
"/Users/sbukhari/Sandbox/CProgram/ASTanalysis/CodexUserStudyData/Control/549eca81-c8f8-4237-9237-220ab72ac8cf/orig_testsuite.json", "JSON", 0, 92, 0, 0, 0, 1, 93
"/Users/sbukhari/Sandbox/CProgram/ASTanalysis/CodexUserStudyData/Control/549eca81-c8f8-4237-9237-220ab72ac8cf/orig_testsuite_asan.json", "JSON", 0, 92, 0, 0, 0, 1, 93
"/Users/sbukhari/Sandbox/CProgram/ASTanalysis/CodexUserStudyData/Control/549eca81-c8f8-4237-9237-220ab72ac8cf/orig_testsuite_asan_noleak.json", "JSON", 0, 92, 0, 0, 0, 1, 93
"/Users/sbukhari/Sandbox/CProgram/ASTanalysis/CodexUserStudyData/Control/549eca81-c8f8-4237-9237-220ab72ac8cf/parts/gen_list_add_item_at_pos.c", "C", 37, 0, 0, 0, 20, 6, 63
"/Users/sbukhari/Sandbox/CProgram/ASTanalysis/CodexUserStudyData/Control/549eca81-c8f8-4237-9237-220ab72ac8cf/parts/gen_list_cost_sum.c", "C", 25, 0, 0, 0, 9, 6, 40
"/Users/sbukhari/Sandbox/CProgram/ASTanalysis/CodexUserStudyData/Control/549eca81-c8f8-4237-9237-220ab72ac8cf/parts/gen_list_deduplicate.c", "C", 31, 0, 0, 0, 13, 6, 50
"/Users/sbukhari/Sandbox/CProgram/ASTanalysis/CodexUserStudyData/Control/549eca81-c8f8-4237-9237-220ab72ac8cf/parts/gen_list_find_highest_price_item_position.c", "C", 18, 0, 0, 0, 25, 6, 49
"/Users/sbukhari/Sandbox/CProgram/ASTanalysis/CodexUserStudyData/Control/549eca81-c8f8-4237-9237-220ab72ac8cf/parts/gen_list_init.c", "C", 19, 0, 0, 0, 6, 6, 31
"/Users/sbukhari/Sandbox/CProgram/ASTanalysis/CodexUserStudyData/Control/549eca81-c8f8-4237-9237-220ab72ac8cf/parts/gen_list_item_to_string.c", "C", 19, 0, 0, 0, 14, 5, 38
"/Users/sbukhari/Sandbox/CProgram/ASTanalysis/CodexUserStudyData/Control/549eca81-c8f8-4237-9237-220ab72ac8cf/parts/gen_list_load.c", "C", 34, 0, 0, 0, 17, 9, 60
"/Users/sbukhari/Sandbox/CProgram/ASTanalysis/CodexUserStudyData/Control/549eca81-c8f8-4237-9237-220ab72ac8cf/parts/gen_list_print.c", "C", 24, 0, 0, 0, 23, 5, 52
"/Users/sbukhari/Sandbox/CProgram/ASTanalysis/CodexUserStudyData/Control/549eca81-c8f8-4237-9237-220ab72ac8cf/parts/gen_list_remove_item_at_pos.c", "C", 36, 0, 0, 0, 12, 5, 53
"/Users/sbukhari/Sandbox/CProgram/ASTanalysis/CodexUserStudyData/Control/549eca81-c8f8-4237-9237-220ab72ac8cf/parts/gen_list_save.c", "C", 26, 0, 0, 0, 16, 5, 47
"/Users/sbukhari/Sandbox/CProgram/ASTanalysis/CodexUserStudyData/Control/549eca81-c8f8-4237-9237-220ab72ac8cf/parts/gen_list_swap_item_positions.c", "C", 56, 0, 0, 0, 14, 14, 84
"/Users/sbukhari/Sandbox/CProgram/ASTanalysis/CodexUserStudyData/Control/549eca81-c8f8-4237-9237-220ab72ac8cf/parts/gen_list_update_item_at_pos.c", "C", 27, 0, 0, 0, 11, 6, 44
"/Users/sbukhari/Sandbox/CProgram/ASTanalysis/CodexUserStudyData/Control/549eca81-c8f8-4237-9237-220ab72ac8cf/ref_testsuite.json", "JSON", 0, 323, 0, 0, 0, 1, 324
"/Users/sbukhari/Sandbox/CProgram/ASTanalysis/CodexUserStudyData/Control/549eca81-c8f8-4237-9237-220ab72ac8cf/ref_testsuite_asan.json", "JSON", 0, 323, 0, 0, 0, 1, 324
"/Users/sbukhari/Sandbox/CProgram/ASTanalysis/CodexUserStudyData/Control/549eca81-c8f8-4237-9237-220ab72ac8cf/ref_testsuite_asan_noleak.json", "JSON", 0, 323, 0, 0, 0, 1, 324
"/Users/sbukhari/Sandbox/CProgram/ASTanalysis/CodexUserStudyData/Control/599ce961-34d5-427d-83bd-8ca692a7e766/api_report.json", "JSON", 0, 14, 0, 0, 0, 1, 15
"/Users/sbukhari/Sandbox/CProgram/ASTanalysis/CodexUserStudyData/Control/599ce961-34d5-427d-83bd-8ca692a7e766/list.c", "C", 95, 0, 0, 0, 76, 19, 190
"/Users/sbukhari/Sandbox/CProgram/ASTanalysis/CodexUserStudyData/Control/599ce961-34d5-427d-83bd-8ca692a7e766/orig_testsuite.json", "JSON", 0, 92, 0, 0, 0, 1, 93
"/Users/sbukhari/Sandbox/CProgram/ASTanalysis/CodexUserStudyData/Control/599ce961-34d5-427d-83bd-8ca692a7e766/orig_testsuite_asan.json", "JSON", 0, 92, 0, 0, 0, 1, 93
"/Users/sbukhari/Sandbox/CProgram/ASTanalysis/CodexUserStudyData/Control/599ce961-34d5-427d-83bd-8ca692a7e766/orig_testsuite_asan_noleak.json", "JSON", 0, 92, 0, 0, 0, 1, 93
"/Users/sbukhari/Sandbox/CProgram/ASTanalysis/CodexUserStudyData/Control/599ce961-34d5-427d-83bd-8ca692a7e766/parts/gen_list_add_item_at_pos.c", "C", 32, 0, 0, 0, 25, 6, 63
"/Users/sbukhari/Sandbox/CProgram/ASTanalysis/CodexUserStudyData/Control/599ce961-34d5-427d-83bd-8ca692a7e766/parts/gen_list_cost_sum.c", "C", 18, 0, 0, 0, 8, 5, 31
"/Users/sbukhari/Sandbox/CProgram/ASTanalysis/CodexUserStudyData/Control/599ce961-34d5-427d-83bd-8ca692a7e766/parts/gen_list_deduplicate.c", "C", 18, 0, 0, 0, 10, 5, 33
"/Users/sbukhari/Sandbox/CProgram/ASTanalysis/CodexUserStudyData/Control/599ce961-34d5-427d-83bd-8ca692a7e766/parts/gen_list_find_highest_price_item_position.c", "C", 18, 0, 0, 0, 8, 5, 31
"/Users/sbukhari/Sandbox/CProgram/ASTanalysis/CodexUserStudyData/Control/599ce961-34d5-427d-83bd-8ca692a7e766/parts/gen_list_init.c", "C", 19, 0, 0, 0, 6, 6, 31
"/Users/sbukhari/Sandbox/CProgram/ASTanalysis/CodexUserStudyData/Control/599ce961-34d5-427d-83bd-8ca692a7e766/parts/gen_list_item_to_string.c", "C", 31, 0, 0, 0, 14, 5, 50
"/Users/sbukhari/Sandbox/CProgram/ASTanalysis/CodexUserStudyData/Control/599ce961-34d5-427d-83bd-8ca692a7e766/parts/gen_list_load.c", "C", 18, 0, 0, 0, 12, 5, 35
"/Users/sbukhari/Sandbox/CProgram/ASTanalysis/CodexUserStudyData/Control/599ce961-34d5-427d-83bd-8ca692a7e766/parts/gen_list_print.c", "C", 26, 0, 0, 0, 23, 5, 54
"/Users/sbukhari/Sandbox/CProgram/ASTanalysis/CodexUserStudyData/Control/599ce961-34d5-427d-83bd-8ca692a7e766/parts/gen_list_remove_item_at_pos.c", "C", 18, 0, 0, 0, 8, 5, 31
"/Users/sbukhari/Sandbox/CProgram/ASTanalysis/CodexUserStudyData/Control/599ce961-34d5-427d-83bd-8ca692a7e766/parts/gen_list_save.c", "C", 18, 0, 0, 0, 11, 5, 34
"/Users/sbukhari/Sandbox/CProgram/ASTanalysis/CodexUserStudyData/Control/599ce961-34d5-427d-83bd-8ca692a7e766/parts/gen_list_swap_item_positions.c", "C", 17, 0, 0, 0, 8, 5, 30
"/Users/sbukhari/Sandbox/CProgram/ASTanalysis/CodexUserStudyData/Control/599ce961-34d5-427d-83bd-8ca692a7e766/parts/gen_list_update_item_at_pos.c", "C", 17, 0, 0, 0, 8, 5, 30
"/Users/sbukhari/Sandbox/CProgram/ASTanalysis/CodexUserStudyData/Control/599ce961-34d5-427d-83bd-8ca692a7e766/ref_testsuite.json", "JSON", 0, 323, 0, 0, 0, 1, 324
"/Users/sbukhari/Sandbox/CProgram/ASTanalysis/CodexUserStudyData/Control/599ce961-34d5-427d-83bd-8ca692a7e766/ref_testsuite_asan.json", "JSON", 0, 323, 0, 0, 0, 1, 324
"/Users/sbukhari/Sandbox/CProgram/ASTanalysis/CodexUserStudyData/Control/599ce961-34d5-427d-83bd-8ca692a7e766/ref_testsuite_asan_noleak.json", "JSON", 0, 323, 0, 0, 0, 1, 324
"/Users/sbukhari/Sandbox/CProgram/ASTanalysis/CodexUserStudyData/Control/632e58e4-4e9b-4311-a12a-13fbc92ad3a3/api_report.json", "JSON", 0, 14, 0, 0, 0, 1, 15
"/Users/sbukhari/Sandbox/CProgram/ASTanalysis/CodexUserStudyData/Control/632e58e4-4e9b-4311-a12a-13fbc92ad3a3/list.c", "C", 64, 0, 0, 0, 72, 17, 153
"/Users/sbukhari/Sandbox/CProgram/ASTanalysis/CodexUserStudyData/Control/632e58e4-4e9b-4311-a12a-13fbc92ad3a3/orig_testsuite.json", "JSON", 0, 92, 0, 0, 0, 1, 93
"/Users/sbukhari/Sandbox/CProgram/ASTanalysis/CodexUserStudyData/Control/632e58e4-4e9b-4311-a12a-13fbc92ad3a3/orig_testsuite_asan.json", "JSON", 0, 92, 0, 0, 0, 1, 93
"/Users/sbukhari/Sandbox/CProgram/ASTanalysis/CodexUserStudyData/Control/632e58e4-4e9b-4311-a12a-13fbc92ad3a3/orig_testsuite_asan_noleak.json", "JSON", 0, 92, 0, 0, 0, 1, 93
"/Users/sbukhari/Sandbox/CProgram/ASTanalysis/CodexUserStudyData/Control/632e58e4-4e9b-4311-a12a-13fbc92ad3a3/parts/gen_list_add_item_at_pos.c", "C", 18, 0, 0, 0, 18, 5, 41
"/Users/sbukhari/Sandbox/CProgram/ASTanalysis/CodexUserStudyData/Control/632e58e4-4e9b-4311-a12a-13fbc92ad3a3/parts/gen_list_cost_sum.c", "C", 18, 0, 0, 0, 8, 5, 31
"/Users/sbukhari/Sandbox/CProgram/ASTanalysis/CodexUserStudyData/Control/632e58e4-4e9b-4311-a12a-13fbc92ad3a3/parts/gen_list_deduplicate.c", "C", 18, 0, 0, 0, 10, 5, 33
"/Users/sbukhari/Sandbox/CProgram/ASTanalysis/CodexUserStudyData/Control/632e58e4-4e9b-4311-a12a-13fbc92ad3a3/parts/gen_list_find_highest_price_item_position.c", "C", 18, 0, 0, 0, 8, 5, 31
"/Users/sbukhari/Sandbox/CProgram/ASTanalysis/CodexUserStudyData/Control/632e58e4-4e9b-4311-a12a-13fbc92ad3a3/parts/gen_list_init.c", "C", 19, 0, 0, 0, 6, 6, 31
"/Users/sbukhari/Sandbox/CProgram/ASTanalysis/CodexUserStudyData/Control/632e58e4-4e9b-4311-a12a-13fbc92ad3a3/parts/gen_list_item_to_string.c", "C", 17, 0, 0, 0, 11, 5, 33
"/Users/sbukhari/Sandbox/CProgram/ASTanalysis/CodexUserStudyData/Control/632e58e4-4e9b-4311-a12a-13fbc92ad3a3/parts/gen_list_load.c", "C", 18, 0, 0, 0, 12, 5, 35
"/Users/sbukhari/Sandbox/CProgram/ASTanalysis/CodexUserStudyData/Control/632e58e4-4e9b-4311-a12a-13fbc92ad3a3/parts/gen_list_print.c", "C", 17, 0, 0, 0, 20, 5, 42
"/Users/sbukhari/Sandbox/CProgram/ASTanalysis/CodexUserStudyData/Control/632e58e4-4e9b-4311-a12a-13fbc92ad3a3/parts/gen_list_remove_item_at_pos.c", "C", 18, 0, 0, 0, 8, 5, 31
"/Users/sbukhari/Sandbox/CProgram/ASTanalysis/CodexUserStudyData/Control/632e58e4-4e9b-4311-a12a-13fbc92ad3a3/parts/gen_list_save.c", "C", 18, 0, 0, 0, 11, 5, 34
"/Users/sbukhari/Sandbox/CProgram/ASTanalysis/CodexUserStudyData/Control/632e58e4-4e9b-4311-a12a-13fbc92ad3a3/parts/gen_list_swap_item_positions.c", "C", 17, 0, 0, 0, 8, 5, 30
"/Users/sbukhari/Sandbox/CProgram/ASTanalysis/CodexUserStudyData/Control/632e58e4-4e9b-4311-a12a-13fbc92ad3a3/parts/gen_list_update_item_at_pos.c", "C", 17, 0, 0, 0, 8, 5, 30
"/Users/sbukhari/Sandbox/CProgram/ASTanalysis/CodexUserStudyData/Control/632e58e4-4e9b-4311-a12a-13fbc92ad3a3/ref_testsuite.json", "JSON", 0, 323, 0, 0, 0, 1, 324
"/Users/sbukhari/Sandbox/CProgram/ASTanalysis/CodexUserStudyData/Control/632e58e4-4e9b-4311-a12a-13fbc92ad3a3/ref_testsuite_asan.json", "JSON", 0, 323, 0, 0, 0, 1, 324
"/Users/sbukhari/Sandbox/CProgram/ASTanalysis/CodexUserStudyData/Control/632e58e4-4e9b-4311-a12a-13fbc92ad3a3/ref_testsuite_asan_noleak.json", "JSON", 0, 323, 0, 0, 0, 1, 324
"/Users/sbukhari/Sandbox/CProgram/ASTanalysis/CodexUserStudyData/Control/74a8a6f6-fdda-4725-b99d-e6089cf74b51/api_report.json", "JSON", 0, 14, 0, 0, 0, 1, 15
"/Users/sbukhari/Sandbox/CProgram/ASTanalysis/CodexUserStudyData/Control/74a8a6f6-fdda-4725-b99d-e6089cf74b51/list.c", "C", 70, 0, 0, 0, 59, 17, 146
"/Users/sbukhari/Sandbox/CProgram/ASTanalysis/CodexUserStudyData/Control/74a8a6f6-fdda-4725-b99d-e6089cf74b51/orig_testsuite.json", "JSON", 0, 92, 0, 0, 0, 1, 93
"/Users/sbukhari/Sandbox/CProgram/ASTanalysis/CodexUserStudyData/Control/74a8a6f6-fdda-4725-b99d-e6089cf74b51/orig_testsuite_asan.json", "JSON", 0, 92, 0, 0, 0, 1, 93
"/Users/sbukhari/Sandbox/CProgram/ASTanalysis/CodexUserStudyData/Control/74a8a6f6-fdda-4725-b99d-e6089cf74b51/orig_testsuite_asan_noleak.json", "JSON", 0, 92, 0, 0, 0, 1, 93
"/Users/sbukhari/Sandbox/CProgram/ASTanalysis/CodexUserStudyData/Control/74a8a6f6-fdda-4725-b99d-e6089cf74b51/parts/gen_list_add_item_at_pos.c", "C", 26, 0, 0, 0, 18, 8, 52
"/Users/sbukhari/Sandbox/CProgram/ASTanalysis/CodexUserStudyData/Control/74a8a6f6-fdda-4725-b99d-e6089cf74b51/parts/gen_list_cost_sum.c", "C", 18, 0, 0, 0, 8, 5, 31
"/Users/sbukhari/Sandbox/CProgram/ASTanalysis/CodexUserStudyData/Control/74a8a6f6-fdda-4725-b99d-e6089cf74b51/parts/gen_list_deduplicate.c", "C", 18, 0, 0, 0, 5, 4, 27
"/Users/sbukhari/Sandbox/CProgram/ASTanalysis/CodexUserStudyData/Control/74a8a6f6-fdda-4725-b99d-e6089cf74b51/parts/gen_list_find_highest_price_item_position.c", "C", 18, 0, 0, 0, 8, 5, 31
"/Users/sbukhari/Sandbox/CProgram/ASTanalysis/CodexUserStudyData/Control/74a8a6f6-fdda-4725-b99d-e6089cf74b51/parts/gen_list_init.c", "C", 19, 0, 0, 0, 6, 6, 31
"/Users/sbukhari/Sandbox/CProgram/ASTanalysis/CodexUserStudyData/Control/74a8a6f6-fdda-4725-b99d-e6089cf74b51/parts/gen_list_item_to_string.c", "C", 17, 0, 0, 0, 11, 5, 33
"/Users/sbukhari/Sandbox/CProgram/ASTanalysis/CodexUserStudyData/Control/74a8a6f6-fdda-4725-b99d-e6089cf74b51/parts/gen_list_load.c", "C", 18, 0, 0, 0, 12, 5, 35
"/Users/sbukhari/Sandbox/CProgram/ASTanalysis/CodexUserStudyData/Control/74a8a6f6-fdda-4725-b99d-e6089cf74b51/parts/gen_list_print.c", "C", 25, 0, 0, 0, 19, 5, 49
"/Users/sbukhari/Sandbox/CProgram/ASTanalysis/CodexUserStudyData/Control/74a8a6f6-fdda-4725-b99d-e6089cf74b51/parts/gen_list_remove_item_at_pos.c", "C", 18, 0, 0, 0, 8, 5, 31
"/Users/sbukhari/Sandbox/CProgram/ASTanalysis/CodexUserStudyData/Control/74a8a6f6-fdda-4725-b99d-e6089cf74b51/parts/gen_list_save.c", "C", 18, 0, 0, 0, 11, 5, 34
"/Users/sbukhari/Sandbox/CProgram/ASTanalysis/CodexUserStudyData/Control/74a8a6f6-fdda-4725-b99d-e6089cf74b51/parts/gen_list_swap_item_positions.c", "C", 17, 0, 0, 0, 8, 5, 30
"/Users/sbukhari/Sandbox/CProgram/ASTanalysis/CodexUserStudyData/Control/74a8a6f6-fdda-4725-b99d-e6089cf74b51/parts/gen_list_update_item_at_pos.c", "C", 17, 0, 0, 0, 8, 5, 30
"/Users/sbukhari/Sandbox/CProgram/ASTanalysis/CodexUserStudyData/Control/74a8a6f6-fdda-4725-b99d-e6089cf74b51/ref_testsuite.json", "JSON", 0, 323, 0, 0, 0, 1, 324
"/Users/sbukhari/Sandbox/CProgram/ASTanalysis/CodexUserStudyData/Control/74a8a6f6-fdda-4725-b99d-e6089cf74b51/ref_testsuite_asan.json", "JSON", 0, 323, 0, 0, 0, 1, 324
"/Users/sbukhari/Sandbox/CProgram/ASTanalysis/CodexUserStudyData/Control/74a8a6f6-fdda-4725-b99d-e6089cf74b51/ref_testsuite_asan_noleak.json", "JSON", 0, 323, 0, 0, 0, 1, 324
"/Users/sbukhari/Sandbox/CProgram/ASTanalysis/CodexUserStudyData/Control/752045ea-d911-4015-a0e5-66f513cb8751/api_report.json", "JSON", 0, 14, 0, 0, 0, 1, 15
"/Users/sbukhari/Sandbox/CProgram/ASTanalysis/CodexUserStudyData/Control/752045ea-d911-4015-a0e5-66f513cb8751/list.c", "C", 73, 0, 0, 0, 83, 19, 175
"/Users/sbukhari/Sandbox/CProgram/ASTanalysis/CodexUserStudyData/Control/752045ea-d911-4015-a0e5-66f513cb8751/orig_testsuite.json", "JSON", 0, 92, 0, 0, 0, 1, 93
"/Users/sbukhari/Sandbox/CProgram/ASTanalysis/CodexUserStudyData/Control/752045ea-d911-4015-a0e5-66f513cb8751/orig_testsuite_asan.json", "JSON", 0, 92, 0, 0, 0, 1, 93
"/Users/sbukhari/Sandbox/CProgram/ASTanalysis/CodexUserStudyData/Control/752045ea-d911-4015-a0e5-66f513cb8751/orig_testsuite_asan_noleak.json", "JSON", 0, 92, 0, 0, 0, 1, 93
"/Users/sbukhari/Sandbox/CProgram/ASTanalysis/CodexUserStudyData/Control/752045ea-d911-4015-a0e5-66f513cb8751/parts/gen_list_add_item_at_pos.c", "C", 22, 0, 0, 0, 21, 5, 48
"/Users/sbukhari/Sandbox/CProgram/ASTanalysis/CodexUserStudyData/Control/752045ea-d911-4015-a0e5-66f513cb8751/parts/gen_list_cost_sum.c", "C", 18, 0, 0, 0, 8, 5, 31
"/Users/sbukhari/Sandbox/CProgram/ASTanalysis/CodexUserStudyData/Control/752045ea-d911-4015-a0e5-66f513cb8751/parts/gen_list_deduplicate.c", "C", 18, 0, 0, 0, 10, 5, 33
"/Users/sbukhari/Sandbox/CProgram/ASTanalysis/CodexUserStudyData/Control/752045ea-d911-4015-a0e5-66f513cb8751/parts/gen_list_find_highest_price_item_position.c", "C", 18, 0, 0, 0, 8, 5, 31
"/Users/sbukhari/Sandbox/CProgram/ASTanalysis/CodexUserStudyData/Control/752045ea-d911-4015-a0e5-66f513cb8751/parts/gen_list_init.c", "C", 19, 0, 0, 0, 6, 6, 31
"/Users/sbukhari/Sandbox/CProgram/ASTanalysis/CodexUserStudyData/Control/752045ea-d911-4015-a0e5-66f513cb8751/parts/gen_list_item_to_string.c", "C", 17, 0, 0, 0, 11, 5, 33
"/Users/sbukhari/Sandbox/CProgram/ASTanalysis/CodexUserStudyData/Control/752045ea-d911-4015-a0e5-66f513cb8751/parts/gen_list_load.c", "C", 18, 0, 0, 0, 12, 5, 35
"/Users/sbukhari/Sandbox/CProgram/ASTanalysis/CodexUserStudyData/Control/752045ea-d911-4015-a0e5-66f513cb8751/parts/gen_list_print.c", "C", 26, 0, 0, 0, 20, 5, 51
"/Users/sbukhari/Sandbox/CProgram/ASTanalysis/CodexUserStudyData/Control/752045ea-d911-4015-a0e5-66f513cb8751/parts/gen_list_remove_item_at_pos.c", "C", 18, 0, 0, 0, 10, 5, 33
"/Users/sbukhari/Sandbox/CProgram/ASTanalysis/CodexUserStudyData/Control/752045ea-d911-4015-a0e5-66f513cb8751/parts/gen_list_save.c", "C", 18, 0, 0, 0, 11, 5, 34
"/Users/sbukhari/Sandbox/CProgram/ASTanalysis/CodexUserStudyData/Control/752045ea-d911-4015-a0e5-66f513cb8751/parts/gen_list_swap_item_positions.c", "C", 17, 0, 0, 0, 8, 5, 30
"/Users/sbukhari/Sandbox/CProgram/ASTanalysis/CodexUserStudyData/Control/752045ea-d911-4015-a0e5-66f513cb8751/parts/gen_list_update_item_at_pos.c", "C", 19, 0, 0, 0, 19, 6, 44
"/Users/sbukhari/Sandbox/CProgram/ASTanalysis/CodexUserStudyData/Control/752045ea-d911-4015-a0e5-66f513cb8751/ref_testsuite.json", "JSON", 0, 323, 0, 0, 0, 1, 324
"/Users/sbukhari/Sandbox/CProgram/ASTanalysis/CodexUserStudyData/Control/752045ea-d911-4015-a0e5-66f513cb8751/ref_testsuite_asan.json", "JSON", 0, 323, 0, 0, 0, 1, 324
"/Users/sbukhari/Sandbox/CProgram/ASTanalysis/CodexUserStudyData/Control/752045ea-d911-4015-a0e5-66f513cb8751/ref_testsuite_asan_noleak.json", "JSON", 0, 323, 0, 0, 0, 1, 324
"/Users/sbukhari/Sandbox/CProgram/ASTanalysis/CodexUserStudyData/Control/833d22d1-766e-4e96-af92-180a3c4a2d99/api_report.json", "JSON", 0, 14, 0, 0, 0, 1, 15
"/Users/sbukhari/Sandbox/CProgram/ASTanalysis/CodexUserStudyData/Control/833d22d1-766e-4e96-af92-180a3c4a2d99/list.c", "C", 241, 0, 0, 0, 62, 45, 348
"/Users/sbukhari/Sandbox/CProgram/ASTanalysis/CodexUserStudyData/Control/833d22d1-766e-4e96-af92-180a3c4a2d99/orig_testsuite.json", "JSON", 0, 92, 0, 0, 0, 1, 93
"/Users/sbukhari/Sandbox/CProgram/ASTanalysis/CodexUserStudyData/Control/833d22d1-766e-4e96-af92-180a3c4a2d99/orig_testsuite_asan.json", "JSON", 0, 92, 0, 0, 0, 1, 93
"/Users/sbukhari/Sandbox/CProgram/ASTanalysis/CodexUserStudyData/Control/833d22d1-766e-4e96-af92-180a3c4a2d99/orig_testsuite_asan_noleak.json", "JSON", 0, 92, 0, 0, 0, 1, 93
"/Users/sbukhari/Sandbox/CProgram/ASTanalysis/CodexUserStudyData/Control/833d22d1-766e-4e96-af92-180a3c4a2d99/parts/gen_list_add_item_at_pos.c", "C", 35, 0, 0, 0, 18, 5, 58
"/Users/sbukhari/Sandbox/CProgram/ASTanalysis/CodexUserStudyData/Control/833d22d1-766e-4e96-af92-180a3c4a2d99/parts/gen_list_cost_sum.c", "C", 24, 0, 0, 0, 8, 7, 39
"/Users/sbukhari/Sandbox/CProgram/ASTanalysis/CodexUserStudyData/Control/833d22d1-766e-4e96-af92-180a3c4a2d99/parts/gen_list_deduplicate.c", "C", 54, 0, 0, 0, 12, 12, 78
"/Users/sbukhari/Sandbox/CProgram/ASTanalysis/CodexUserStudyData/Control/833d22d1-766e-4e96-af92-180a3c4a2d99/parts/gen_list_find_highest_price_item_position.c", "C", 30, 0, 0, 0, 8, 7, 45
"/Users/sbukhari/Sandbox/CProgram/ASTanalysis/CodexUserStudyData/Control/833d22d1-766e-4e96-af92-180a3c4a2d99/parts/gen_list_init.c", "C", 19, 0, 0, 0, 6, 6, 31
"/Users/sbukhari/Sandbox/CProgram/ASTanalysis/CodexUserStudyData/Control/833d22d1-766e-4e96-af92-180a3c4a2d99/parts/gen_list_item_to_string.c", "C", 19, 0, 0, 0, 14, 6, 39
"/Users/sbukhari/Sandbox/CProgram/ASTanalysis/CodexUserStudyData/Control/833d22d1-766e-4e96-af92-180a3c4a2d99/parts/gen_list_load.c", "C", 38, 0, 0, 0, 18, 6, 62
"/Users/sbukhari/Sandbox/CProgram/ASTanalysis/CodexUserStudyData/Control/833d22d1-766e-4e96-af92-180a3c4a2d99/parts/gen_list_print.c", "C", 30, 0, 0, 0, 23, 7, 60
"/Users/sbukhari/Sandbox/CProgram/ASTanalysis/CodexUserStudyData/Control/833d22d1-766e-4e96-af92-180a3c4a2d99/parts/gen_list_remove_item_at_pos.c", "C", 35, 0, 0, 0, 10, 7, 52
"/Users/sbukhari/Sandbox/CProgram/ASTanalysis/CodexUserStudyData/Control/833d22d1-766e-4e96-af92-180a3c4a2d99/parts/gen_list_save.c", "C", 25, 0, 0, 0, 14, 10, 49
"/Users/sbukhari/Sandbox/CProgram/ASTanalysis/CodexUserStudyData/Control/833d22d1-766e-4e96-af92-180a3c4a2d99/parts/gen_list_swap_item_positions.c", "C", 49, 0, 0, 0, 8, 8, 65
"/Users/sbukhari/Sandbox/CProgram/ASTanalysis/CodexUserStudyData/Control/833d22d1-766e-4e96-af92-180a3c4a2d99/parts/gen_list_update_item_at_pos.c", "C", 38, 0, 0, 0, 12, 6, 56
"/Users/sbukhari/Sandbox/CProgram/ASTanalysis/CodexUserStudyData/Control/833d22d1-766e-4e96-af92-180a3c4a2d99/ref_testsuite.json", "JSON", 0, 323, 0, 0, 0, 1, 324
"/Users/sbukhari/Sandbox/CProgram/ASTanalysis/CodexUserStudyData/Control/833d22d1-766e-4e96-af92-180a3c4a2d99/ref_testsuite_asan.json", "JSON", 0, 323, 0, 0, 0, 1, 324
"/Users/sbukhari/Sandbox/CProgram/ASTanalysis/CodexUserStudyData/Control/833d22d1-766e-4e96-af92-180a3c4a2d99/ref_testsuite_asan_noleak.json", "JSON", 0, 323, 0, 0, 0, 1, 324
"/Users/sbukhari/Sandbox/CProgram/ASTanalysis/CodexUserStudyData/Control/949d88c5-3896-4e45-a42e-8bff4c950949/api_report.json", "JSON", 0, 14, 0, 0, 0, 1, 15
"/Users/sbukhari/Sandbox/CProgram/ASTanalysis/CodexUserStudyData/Control/949d88c5-3896-4e45-a42e-8bff4c950949/list.c", "C", 72, 0, 0, 0, 88, 18, 178
"/Users/sbukhari/Sandbox/CProgram/ASTanalysis/CodexUserStudyData/Control/949d88c5-3896-4e45-a42e-8bff4c950949/orig_testsuite.json", "JSON", 0, 92, 0, 0, 0, 1, 93
"/Users/sbukhari/Sandbox/CProgram/ASTanalysis/CodexUserStudyData/Control/949d88c5-3896-4e45-a42e-8bff4c950949/orig_testsuite_asan.json", "JSON", 0, 92, 0, 0, 0, 1, 93
"/Users/sbukhari/Sandbox/CProgram/ASTanalysis/CodexUserStudyData/Control/949d88c5-3896-4e45-a42e-8bff4c950949/orig_testsuite_asan_noleak.json", "JSON", 0, 92, 0, 0, 0, 1, 93
"/Users/sbukhari/Sandbox/CProgram/ASTanalysis/CodexUserStudyData/Control/949d88c5-3896-4e45-a42e-8bff4c950949/parts/gen_list_add_item_at_pos.c", "C", 23, 0, 0, 0, 30, 5, 58
"/Users/sbukhari/Sandbox/CProgram/ASTanalysis/CodexUserStudyData/Control/949d88c5-3896-4e45-a42e-8bff4c950949/parts/gen_list_cost_sum.c", "C", 18, 0, 0, 0, 8, 5, 31
"/Users/sbukhari/Sandbox/CProgram/ASTanalysis/CodexUserStudyData/Control/949d88c5-3896-4e45-a42e-8bff4c950949/parts/gen_list_deduplicate.c", "C", 18, 0, 0, 0, 10, 5, 33
"/Users/sbukhari/Sandbox/CProgram/ASTanalysis/CodexUserStudyData/Control/949d88c5-3896-4e45-a42e-8bff4c950949/parts/gen_list_find_highest_price_item_position.c", "C", 18, 0, 0, 0, 8, 5, 31
"/Users/sbukhari/Sandbox/CProgram/ASTanalysis/CodexUserStudyData/Control/949d88c5-3896-4e45-a42e-8bff4c950949/parts/gen_list_init.c", "C", 19, 0, 0, 0, 6, 6, 31
"/Users/sbukhari/Sandbox/CProgram/ASTanalysis/CodexUserStudyData/Control/949d88c5-3896-4e45-a42e-8bff4c950949/parts/gen_list_item_to_string.c", "C", 19, 0, 0, 0, 20, 6, 45
"/Users/sbukhari/Sandbox/CProgram/ASTanalysis/CodexUserStudyData/Control/949d88c5-3896-4e45-a42e-8bff4c950949/parts/gen_list_load.c", "C", 18, 0, 0, 0, 12, 5, 35
"/Users/sbukhari/Sandbox/CProgram/ASTanalysis/CodexUserStudyData/Control/949d88c5-3896-4e45-a42e-8bff4c950949/parts/gen_list_print.c", "C", 25, 0, 0, 0, 19, 5, 49
"/Users/sbukhari/Sandbox/CProgram/ASTanalysis/CodexUserStudyData/Control/949d88c5-3896-4e45-a42e-8bff4c950949/parts/gen_list_remove_item_at_pos.c", "C", 18, 0, 0, 0, 8, 5, 31
"/Users/sbukhari/Sandbox/CProgram/ASTanalysis/CodexUserStudyData/Control/949d88c5-3896-4e45-a42e-8bff4c950949/parts/gen_list_save.c", "C", 18, 0, 0, 0, 11, 5, 34
"/Users/sbukhari/Sandbox/CProgram/ASTanalysis/CodexUserStudyData/Control/949d88c5-3896-4e45-a42e-8bff4c950949/parts/gen_list_swap_item_positions.c", "C", 17, 0, 0, 0, 8, 5, 30
"/Users/sbukhari/Sandbox/CProgram/ASTanalysis/CodexUserStudyData/Control/949d88c5-3896-4e45-a42e-8bff4c950949/parts/gen_list_update_item_at_pos.c", "C", 17, 0, 0, 0, 8, 5, 30
"/Users/sbukhari/Sandbox/CProgram/ASTanalysis/CodexUserStudyData/Control/949d88c5-3896-4e45-a42e-8bff4c950949/ref_testsuite.json", "JSON", 0, 323, 0, 0, 0, 1, 324
"/Users/sbukhari/Sandbox/CProgram/ASTanalysis/CodexUserStudyData/Control/949d88c5-3896-4e45-a42e-8bff4c950949/ref_testsuite_asan.json", "JSON", 0, 323, 0, 0, 0, 1, 324
"/Users/sbukhari/Sandbox/CProgram/ASTanalysis/CodexUserStudyData/Control/949d88c5-3896-4e45-a42e-8bff4c950949/ref_testsuite_asan_noleak.json", "JSON", 0, 323, 0, 0, 0, 1, 324
"/Users/sbukhari/Sandbox/CProgram/ASTanalysis/CodexUserStudyData/Control/94cc70d0-7086-4a40-894a-433c90f7d9c4/api_report.json", "JSON", 0, 14, 0, 0, 0, 1, 15
"/Users/sbukhari/Sandbox/CProgram/ASTanalysis/CodexUserStudyData/Control/94cc70d0-7086-4a40-894a-433c90f7d9c4/list.c", "C", 205, 0, 0, 0, 56, 35, 296
"/Users/sbukhari/Sandbox/CProgram/ASTanalysis/CodexUserStudyData/Control/94cc70d0-7086-4a40-894a-433c90f7d9c4/orig_testsuite.json", "JSON", 0, 92, 0, 0, 0, 1, 93
"/Users/sbukhari/Sandbox/CProgram/ASTanalysis/CodexUserStudyData/Control/94cc70d0-7086-4a40-894a-433c90f7d9c4/orig_testsuite_asan.json", "JSON", 0, 92, 0, 0, 0, 1, 93
"/Users/sbukhari/Sandbox/CProgram/ASTanalysis/CodexUserStudyData/Control/94cc70d0-7086-4a40-894a-433c90f7d9c4/orig_testsuite_asan_noleak.json", "JSON", 0, 92, 0, 0, 0, 1, 93
"/Users/sbukhari/Sandbox/CProgram/ASTanalysis/CodexUserStudyData/Control/94cc70d0-7086-4a40-894a-433c90f7d9c4/parts/gen_list_add_item_at_pos.c", "C", 38, 0, 0, 0, 20, 8, 66
"/Users/sbukhari/Sandbox/CProgram/ASTanalysis/CodexUserStudyData/Control/94cc70d0-7086-4a40-894a-433c90f7d9c4/parts/gen_list_cost_sum.c", "C", 23, 0, 0, 0, 7, 5, 35
"/Users/sbukhari/Sandbox/CProgram/ASTanalysis/CodexUserStudyData/Control/94cc70d0-7086-4a40-894a-433c90f7d9c4/parts/gen_list_deduplicate.c", "C", 31, 0, 0, 0, 10, 6, 47
"/Users/sbukhari/Sandbox/CProgram/ASTanalysis/CodexUserStudyData/Control/94cc70d0-7086-4a40-894a-433c90f7d9c4/parts/gen_list_find_highest_price_item_position.c", "C", 29, 0, 0, 0, 8, 5, 42
"/Users/sbukhari/Sandbox/CProgram/ASTanalysis/CodexUserStudyData/Control/94cc70d0-7086-4a40-894a-433c90f7d9c4/parts/gen_list_init.c", "C", 19, 0, 0, 0, 6, 6, 31
"/Users/sbukhari/Sandbox/CProgram/ASTanalysis/CodexUserStudyData/Control/94cc70d0-7086-4a40-894a-433c90f7d9c4/parts/gen_list_item_to_string.c", "C", 20, 0, 0, 0, 15, 5, 40
"/Users/sbukhari/Sandbox/CProgram/ASTanalysis/CodexUserStudyData/Control/94cc70d0-7086-4a40-894a-433c90f7d9c4/parts/gen_list_load.c", "C", 41, 0, 0, 0, 14, 9, 64
"/Users/sbukhari/Sandbox/CProgram/ASTanalysis/CodexUserStudyData/Control/94cc70d0-7086-4a40-894a-433c90f7d9c4/parts/gen_list_print.c", "C", 28, 0, 0, 0, 20, 5, 53
"/Users/sbukhari/Sandbox/CProgram/ASTanalysis/CodexUserStudyData/Control/94cc70d0-7086-4a40-894a-433c90f7d9c4/parts/gen_list_remove_item_at_pos.c", "C", 36, 0, 0, 0, 11, 7, 54
"/Users/sbukhari/Sandbox/CProgram/ASTanalysis/CodexUserStudyData/Control/94cc70d0-7086-4a40-894a-433c90f7d9c4/parts/gen_list_save.c", "C", 28, 0, 0, 0, 12, 8, 48
"/Users/sbukhari/Sandbox/CProgram/ASTanalysis/CodexUserStudyData/Control/94cc70d0-7086-4a40-894a-433c90f7d9c4/parts/gen_list_swap_item_positions.c", "C", 39, 0, 0, 0, 10, 9, 58
"/Users/sbukhari/Sandbox/CProgram/ASTanalysis/CodexUserStudyData/Control/94cc70d0-7086-4a40-894a-433c90f7d9c4/parts/gen_list_update_item_at_pos.c", "C", 28, 0, 0, 0, 10, 6, 44
"/Users/sbukhari/Sandbox/CProgram/ASTanalysis/CodexUserStudyData/Control/94cc70d0-7086-4a40-894a-433c90f7d9c4/ref_testsuite.json", "JSON", 0, 323, 0, 0, 0, 1, 324
"/Users/sbukhari/Sandbox/CProgram/ASTanalysis/CodexUserStudyData/Control/94cc70d0-7086-4a40-894a-433c90f7d9c4/ref_testsuite_asan.json", "JSON", 0, 323, 0, 0, 0, 1, 324
"/Users/sbukhari/Sandbox/CProgram/ASTanalysis/CodexUserStudyData/Control/94cc70d0-7086-4a40-894a-433c90f7d9c4/ref_testsuite_asan_noleak.json", "JSON", 0, 323, 0, 0, 0, 1, 324
"/Users/sbukhari/Sandbox/CProgram/ASTanalysis/CodexUserStudyData/Control/9702f54c-200b-41f5-9fc4-971af3d86785/api_report.json", "JSON", 0, 14, 0, 0, 0, 1, 15
"/Users/sbukhari/Sandbox/CProgram/ASTanalysis/CodexUserStudyData/Control/9702f54c-200b-41f5-9fc4-971af3d86785/list.c", "C", 281, 0, 0, 0, 115, 95, 491
"/Users/sbukhari/Sandbox/CProgram/ASTanalysis/CodexUserStudyData/Control/9702f54c-200b-41f5-9fc4-971af3d86785/orig_testsuite.json", "JSON", 0, 92, 0, 0, 0, 1, 93
"/Users/sbukhari/Sandbox/CProgram/ASTanalysis/CodexUserStudyData/Control/9702f54c-200b-41f5-9fc4-971af3d86785/orig_testsuite_asan.json", "JSON", 0, 92, 0, 0, 0, 1, 93
"/Users/sbukhari/Sandbox/CProgram/ASTanalysis/CodexUserStudyData/Control/9702f54c-200b-41f5-9fc4-971af3d86785/orig_testsuite_asan_noleak.json", "JSON", 0, 92, 0, 0, 0, 1, 93
"/Users/sbukhari/Sandbox/CProgram/ASTanalysis/CodexUserStudyData/Control/9702f54c-200b-41f5-9fc4-971af3d86785/parts/gen_list_add_item_at_pos.c", "C", 48, 0, 0, 0, 20, 12, 80
"/Users/sbukhari/Sandbox/CProgram/ASTanalysis/CodexUserStudyData/Control/9702f54c-200b-41f5-9fc4-971af3d86785/parts/gen_list_cost_sum.c", "C", 24, 0, 0, 0, 9, 7, 40
"/Users/sbukhari/Sandbox/CProgram/ASTanalysis/CodexUserStudyData/Control/9702f54c-200b-41f5-9fc4-971af3d86785/parts/gen_list_deduplicate.c", "C", 58, 0, 0, 0, 24, 21, 103
"/Users/sbukhari/Sandbox/CProgram/ASTanalysis/CodexUserStudyData/Control/9702f54c-200b-41f5-9fc4-971af3d86785/parts/gen_list_find_highest_price_item_position.c", "C", 29, 0, 0, 0, 10, 8, 47
"/Users/sbukhari/Sandbox/CProgram/ASTanalysis/CodexUserStudyData/Control/9702f54c-200b-41f5-9fc4-971af3d86785/parts/gen_list_init.c", "C", 19, 0, 0, 0, 6, 6, 31
"/Users/sbukhari/Sandbox/CProgram/ASTanalysis/CodexUserStudyData/Control/9702f54c-200b-41f5-9fc4-971af3d86785/parts/gen_list_item_to_string.c", "C", 26, 0, 0, 0, 17, 9, 52
"/Users/sbukhari/Sandbox/CProgram/ASTanalysis/CodexUserStudyData/Control/9702f54c-200b-41f5-9fc4-971af3d86785/parts/gen_list_load.c", "C", 44, 0, 0, 0, 22, 17, 83
"/Users/sbukhari/Sandbox/CProgram/ASTanalysis/CodexUserStudyData/Control/9702f54c-200b-41f5-9fc4-971af3d86785/parts/gen_list_print.c", "C", 32, 0, 0, 0, 21, 10, 63
"/Users/sbukhari/Sandbox/CProgram/ASTanalysis/CodexUserStudyData/Control/9702f54c-200b-41f5-9fc4-971af3d86785/parts/gen_list_remove_item_at_pos.c", "C", 38, 0, 0, 0, 27, 12, 77
"/Users/sbukhari/Sandbox/CProgram/ASTanalysis/CodexUserStudyData/Control/9702f54c-200b-41f5-9fc4-971af3d86785/parts/gen_list_save.c", "C", 34, 0, 0, 0, 16, 16, 66
"/Users/sbukhari/Sandbox/CProgram/ASTanalysis/CodexUserStudyData/Control/9702f54c-200b-41f5-9fc4-971af3d86785/parts/gen_list_swap_item_positions.c", "C", 50, 0, 0, 0, 9, 13, 72
"/Users/sbukhari/Sandbox/CProgram/ASTanalysis/CodexUserStudyData/Control/9702f54c-200b-41f5-9fc4-971af3d86785/parts/gen_list_update_item_at_pos.c", "C", 34, 0, 0, 0, 15, 10, 59
"/Users/sbukhari/Sandbox/CProgram/ASTanalysis/CodexUserStudyData/Control/9702f54c-200b-41f5-9fc4-971af3d86785/ref_testsuite.json", "JSON", 0, 323, 0, 0, 0, 1, 324
"/Users/sbukhari/Sandbox/CProgram/ASTanalysis/CodexUserStudyData/Control/9702f54c-200b-41f5-9fc4-971af3d86785/ref_testsuite_asan.json", "JSON", 0, 323, 0, 0, 0, 1, 324
"/Users/sbukhari/Sandbox/CProgram/ASTanalysis/CodexUserStudyData/Control/9702f54c-200b-41f5-9fc4-971af3d86785/ref_testsuite_asan_noleak.json", "JSON", 0, 323, 0, 0, 0, 1, 324
"/Users/sbukhari/Sandbox/CProgram/ASTanalysis/CodexUserStudyData/Control/a2ab1ed3-1881-42af-b18d-1197d0ea95ae/api_report.json", "JSON", 0, 14, 0, 0, 0, 1, 15
"/Users/sbukhari/Sandbox/CProgram/ASTanalysis/CodexUserStudyData/Control/a2ab1ed3-1881-42af-b18d-1197d0ea95ae/list.c", "C", 120, 0, 0, 0, 67, 21, 208
"/Users/sbukhari/Sandbox/CProgram/ASTanalysis/CodexUserStudyData/Control/a2ab1ed3-1881-42af-b18d-1197d0ea95ae/orig_testsuite.json", "JSON", 0, 92, 0, 0, 0, 1, 93
"/Users/sbukhari/Sandbox/CProgram/ASTanalysis/CodexUserStudyData/Control/a2ab1ed3-1881-42af-b18d-1197d0ea95ae/orig_testsuite_asan.json", "JSON", 0, 92, 0, 0, 0, 1, 93
"/Users/sbukhari/Sandbox/CProgram/ASTanalysis/CodexUserStudyData/Control/a2ab1ed3-1881-42af-b18d-1197d0ea95ae/orig_testsuite_asan_noleak.json", "JSON", 0, 92, 0, 0, 0, 1, 93
"/Users/sbukhari/Sandbox/CProgram/ASTanalysis/CodexUserStudyData/Control/a2ab1ed3-1881-42af-b18d-1197d0ea95ae/parts/gen_list_add_item_at_pos.c", "C", 18, 0, 0, 0, 18, 5, 41
"/Users/sbukhari/Sandbox/CProgram/ASTanalysis/CodexUserStudyData/Control/a2ab1ed3-1881-42af-b18d-1197d0ea95ae/parts/gen_list_cost_sum.c", "C", 18, 0, 0, 0, 8, 5, 31
"/Users/sbukhari/Sandbox/CProgram/ASTanalysis/CodexUserStudyData/Control/a2ab1ed3-1881-42af-b18d-1197d0ea95ae/parts/gen_list_deduplicate.c", "C", 18, 0, 0, 0, 10, 5, 33
"/Users/sbukhari/Sandbox/CProgram/ASTanalysis/CodexUserStudyData/Control/a2ab1ed3-1881-42af-b18d-1197d0ea95ae/parts/gen_list_find_highest_price_item_position.c", "C", 18, 0, 0, 0, 8, 5, 31
"/Users/sbukhari/Sandbox/CProgram/ASTanalysis/CodexUserStudyData/Control/a2ab1ed3-1881-42af-b18d-1197d0ea95ae/parts/gen_list_init.c", "C", 19, 0, 0, 0, 6, 6, 31
"/Users/sbukhari/Sandbox/CProgram/ASTanalysis/CodexUserStudyData/Control/a2ab1ed3-1881-42af-b18d-1197d0ea95ae/parts/gen_list_item_to_string.c", "C", 17, 0, 0, 0, 11, 5, 33
"/Users/sbukhari/Sandbox/CProgram/ASTanalysis/CodexUserStudyData/Control/a2ab1ed3-1881-42af-b18d-1197d0ea95ae/parts/gen_list_load.c", "C", 18, 0, 0, 0, 12, 5, 35
"/Users/sbukhari/Sandbox/CProgram/ASTanalysis/CodexUserStudyData/Control/a2ab1ed3-1881-42af-b18d-1197d0ea95ae/parts/gen_list_print.c", "C", 22, 0, 0, 0, 20, 5, 47
"/Users/sbukhari/Sandbox/CProgram/ASTanalysis/CodexUserStudyData/Control/a2ab1ed3-1881-42af-b18d-1197d0ea95ae/parts/gen_list_remove_item_at_pos.c", "C", 18, 0, 0, 0, 8, 5, 31
"/Users/sbukhari/Sandbox/CProgram/ASTanalysis/CodexUserStudyData/Control/a2ab1ed3-1881-42af-b18d-1197d0ea95ae/parts/gen_list_save.c", "C", 18, 0, 0, 0, 11, 5, 34
"/Users/sbukhari/Sandbox/CProgram/ASTanalysis/CodexUserStudyData/Control/a2ab1ed3-1881-42af-b18d-1197d0ea95ae/parts/gen_list_swap_item_positions.c", "C", 17, 0, 0, 0, 8, 5, 30
"/Users/sbukhari/Sandbox/CProgram/ASTanalysis/CodexUserStudyData/Control/a2ab1ed3-1881-42af-b18d-1197d0ea95ae/parts/gen_list_update_item_at_pos.c", "C", 17, 0, 0, 0, 8, 5, 30
"/Users/sbukhari/Sandbox/CProgram/ASTanalysis/CodexUserStudyData/Control/a2ab1ed3-1881-42af-b18d-1197d0ea95ae/ref_testsuite.json", "JSON", 0, 323, 0, 0, 0, 1, 324
"/Users/sbukhari/Sandbox/CProgram/ASTanalysis/CodexUserStudyData/Control/a2ab1ed3-1881-42af-b18d-1197d0ea95ae/ref_testsuite_asan.json", "JSON", 0, 323, 0, 0, 0, 1, 324
"/Users/sbukhari/Sandbox/CProgram/ASTanalysis/CodexUserStudyData/Control/a2ab1ed3-1881-42af-b18d-1197d0ea95ae/ref_testsuite_asan_noleak.json", "JSON", 0, 323, 0, 0, 0, 1, 324
"/Users/sbukhari/Sandbox/CProgram/ASTanalysis/CodexUserStudyData/Control/a391803d-b2e8-47cd-8319-305aae3983bc/api_report.json", "JSON", 0, 14, 0, 0, 0, 1, 15
"/Users/sbukhari/Sandbox/CProgram/ASTanalysis/CodexUserStudyData/Control/a391803d-b2e8-47cd-8319-305aae3983bc/list.c", "C", 263, 0, 0, 0, 91, 31, 385
"/Users/sbukhari/Sandbox/CProgram/ASTanalysis/CodexUserStudyData/Control/a391803d-b2e8-47cd-8319-305aae3983bc/orig_testsuite.json", "JSON", 0, 92, 0, 0, 0, 1, 93
"/Users/sbukhari/Sandbox/CProgram/ASTanalysis/CodexUserStudyData/Control/a391803d-b2e8-47cd-8319-305aae3983bc/orig_testsuite_asan.json", "JSON", 0, 92, 0, 0, 0, 1, 93
"/Users/sbukhari/Sandbox/CProgram/ASTanalysis/CodexUserStudyData/Control/a391803d-b2e8-47cd-8319-305aae3983bc/orig_testsuite_asan_noleak.json", "JSON", 0, 92, 0, 0, 0, 1, 93
"/Users/sbukhari/Sandbox/CProgram/ASTanalysis/CodexUserStudyData/Control/a391803d-b2e8-47cd-8319-305aae3983bc/parts/gen_list_add_item_at_pos.c", "C", 18, 0, 0, 0, 20, 6, 44
"/Users/sbukhari/Sandbox/CProgram/ASTanalysis/CodexUserStudyData/Control/a391803d-b2e8-47cd-8319-305aae3983bc/parts/gen_list_cost_sum.c", "C", 24, 0, 0, 0, 12, 7, 43
"/Users/sbukhari/Sandbox/CProgram/ASTanalysis/CodexUserStudyData/Control/a391803d-b2e8-47cd-8319-305aae3983bc/parts/gen_list_deduplicate.c", "C", 55, 0, 0, 0, 18, 6, 79
"/Users/sbukhari/Sandbox/CProgram/ASTanalysis/CodexUserStudyData/Control/a391803d-b2e8-47cd-8319-305aae3983bc/parts/gen_list_find_highest_price_item_position.c", "C", 18, 0, 0, 0, 10, 6, 34
"/Users/sbukhari/Sandbox/CProgram/ASTanalysis/CodexUserStudyData/Control/a391803d-b2e8-47cd-8319-305aae3983bc/parts/gen_list_init.c", "C", 19, 0, 0, 0, 8, 7, 34
"/Users/sbukhari/Sandbox/CProgram/ASTanalysis/CodexUserStudyData/Control/a391803d-b2e8-47cd-8319-305aae3983bc/parts/gen_list_item_to_string.c", "C", 22, 0, 0, 0, 16, 6, 44
"/Users/sbukhari/Sandbox/CProgram/ASTanalysis/CodexUserStudyData/Control/a391803d-b2e8-47cd-8319-305aae3983bc/parts/gen_list_load.c", "C", 47, 0, 0, 0, 21, 6, 74
"/Users/sbukhari/Sandbox/CProgram/ASTanalysis/CodexUserStudyData/Control/a391803d-b2e8-47cd-8319-305aae3983bc/parts/gen_list_print.c", "C", 17, 0, 0, 0, 22, 6, 45
"/Users/sbukhari/Sandbox/CProgram/ASTanalysis/CodexUserStudyData/Control/a391803d-b2e8-47cd-8319-305aae3983bc/parts/gen_list_remove_item_at_pos.c", "C", 18, 0, 0, 0, 10, 6, 34
"/Users/sbukhari/Sandbox/CProgram/ASTanalysis/CodexUserStudyData/Control/a391803d-b2e8-47cd-8319-305aae3983bc/parts/gen_list_save.c", "C", 29, 0, 0, 0, 17, 7, 53
"/Users/sbukhari/Sandbox/CProgram/ASTanalysis/CodexUserStudyData/Control/a391803d-b2e8-47cd-8319-305aae3983bc/parts/gen_list_swap_item_positions.c", "C", 17, 0, 0, 0, 10, 6, 33
"/Users/sbukhari/Sandbox/CProgram/ASTanalysis/CodexUserStudyData/Control/a391803d-b2e8-47cd-8319-305aae3983bc/parts/gen_list_update_item_at_pos.c", "C", 17, 0, 0, 0, 10, 6, 33
"/Users/sbukhari/Sandbox/CProgram/ASTanalysis/CodexUserStudyData/Control/a391803d-b2e8-47cd-8319-305aae3983bc/ref_testsuite.json", "JSON", 0, 323, 0, 0, 0, 1, 324
"/Users/sbukhari/Sandbox/CProgram/ASTanalysis/CodexUserStudyData/Control/a391803d-b2e8-47cd-8319-305aae3983bc/ref_testsuite_asan.json", "JSON", 0, 323, 0, 0, 0, 1, 324
"/Users/sbukhari/Sandbox/CProgram/ASTanalysis/CodexUserStudyData/Control/a391803d-b2e8-47cd-8319-305aae3983bc/ref_testsuite_asan_noleak.json", "JSON", 0, 323, 0, 0, 0, 1, 324
"/Users/sbukhari/Sandbox/CProgram/ASTanalysis/CodexUserStudyData/Control/b0ce9d89-f33e-4770-abfb-11e9830da4c4/api_report.json", "JSON", 0, 14, 0, 0, 0, 1, 15
"/Users/sbukhari/Sandbox/CProgram/ASTanalysis/CodexUserStudyData/Control/b0ce9d89-f33e-4770-abfb-11e9830da4c4/list.c", "C", 92, 0, 0, 0, 77, 26, 195
"/Users/sbukhari/Sandbox/CProgram/ASTanalysis/CodexUserStudyData/Control/b0ce9d89-f33e-4770-abfb-11e9830da4c4/orig_testsuite.json", "JSON", 0, 92, 0, 0, 0, 1, 93
"/Users/sbukhari/Sandbox/CProgram/ASTanalysis/CodexUserStudyData/Control/b0ce9d89-f33e-4770-abfb-11e9830da4c4/orig_testsuite_asan.json", "JSON", 0, 92, 0, 0, 0, 1, 93
"/Users/sbukhari/Sandbox/CProgram/ASTanalysis/CodexUserStudyData/Control/b0ce9d89-f33e-4770-abfb-11e9830da4c4/orig_testsuite_asan_noleak.json", "JSON", 0, 92, 0, 0, 0, 1, 93
"/Users/sbukhari/Sandbox/CProgram/ASTanalysis/CodexUserStudyData/Control/b0ce9d89-f33e-4770-abfb-11e9830da4c4/parts/gen_list_add_item_at_pos.c", "C", 33, 0, 0, 0, 17, 10, 60
"/Users/sbukhari/Sandbox/CProgram/ASTanalysis/CodexUserStudyData/Control/b0ce9d89-f33e-4770-abfb-11e9830da4c4/parts/gen_list_cost_sum.c", "C", 18, 0, 0, 0, 8, 5, 31
"/Users/sbukhari/Sandbox/CProgram/ASTanalysis/CodexUserStudyData/Control/b0ce9d89-f33e-4770-abfb-11e9830da4c4/parts/gen_list_deduplicate.c", "C", 18, 0, 0, 0, 10, 5, 33
"/Users/sbukhari/Sandbox/CProgram/ASTanalysis/CodexUserStudyData/Control/b0ce9d89-f33e-4770-abfb-11e9830da4c4/parts/gen_list_find_highest_price_item_position.c", "C", 18, 0, 0, 0, 8, 5, 31
"/Users/sbukhari/Sandbox/CProgram/ASTanalysis/CodexUserStudyData/Control/b0ce9d89-f33e-4770-abfb-11e9830da4c4/parts/gen_list_init.c", "C", 19, 0, 0, 0, 6, 6, 31
"/Users/sbukhari/Sandbox/CProgram/ASTanalysis/CodexUserStudyData/Control/b0ce9d89-f33e-4770-abfb-11e9830da4c4/parts/gen_list_item_to_string.c", "C", 21, 0, 0, 0, 20, 8, 49
"/Users/sbukhari/Sandbox/CProgram/ASTanalysis/CodexUserStudyData/Control/b0ce9d89-f33e-4770-abfb-11e9830da4c4/parts/gen_list_load.c", "C", 18, 0, 0, 0, 12, 5, 35
"/Users/sbukhari/Sandbox/CProgram/ASTanalysis/CodexUserStudyData/Control/b0ce9d89-f33e-4770-abfb-11e9830da4c4/parts/gen_list_print.c", "C", 23, 0, 0, 0, 22, 5, 50
"/Users/sbukhari/Sandbox/CProgram/ASTanalysis/CodexUserStudyData/Control/b0ce9d89-f33e-4770-abfb-11e9830da4c4/parts/gen_list_remove_item_at_pos.c", "C", 18, 0, 0, 0, 8, 5, 31
"/Users/sbukhari/Sandbox/CProgram/ASTanalysis/CodexUserStudyData/Control/b0ce9d89-f33e-4770-abfb-11e9830da4c4/parts/gen_list_save.c", "C", 18, 0, 0, 0, 11, 5, 34
"/Users/sbukhari/Sandbox/CProgram/ASTanalysis/CodexUserStudyData/Control/b0ce9d89-f33e-4770-abfb-11e9830da4c4/parts/gen_list_swap_item_positions.c", "C", 17, 0, 0, 0, 8, 5, 30
"/Users/sbukhari/Sandbox/CProgram/ASTanalysis/CodexUserStudyData/Control/b0ce9d89-f33e-4770-abfb-11e9830da4c4/parts/gen_list_update_item_at_pos.c", "C", 18, 0, 0, 0, 11, 5, 34
"/Users/sbukhari/Sandbox/CProgram/ASTanalysis/CodexUserStudyData/Control/b0ce9d89-f33e-4770-abfb-11e9830da4c4/ref_testsuite.json", "JSON", 0, 323, 0, 0, 0, 1, 324
"/Users/sbukhari/Sandbox/CProgram/ASTanalysis/CodexUserStudyData/Control/b0ce9d89-f33e-4770-abfb-11e9830da4c4/ref_testsuite_asan.json", "JSON", 0, 323, 0, 0, 0, 1, 324
"/Users/sbukhari/Sandbox/CProgram/ASTanalysis/CodexUserStudyData/Control/b0ce9d89-f33e-4770-abfb-11e9830da4c4/ref_testsuite_asan_noleak.json", "JSON", 0, 323, 0, 0, 0, 1, 324
"/Users/sbukhari/Sandbox/CProgram/ASTanalysis/CodexUserStudyData/Control/bbea417b-a3f1-451b-a25d-d9dfb2c8aed2/api_report.json", "JSON", 0, 14, 0, 0, 0, 1, 15
"/Users/sbukhari/Sandbox/CProgram/ASTanalysis/CodexUserStudyData/Control/bbea417b-a3f1-451b-a25d-d9dfb2c8aed2/list.c", "C", 79, 0, 0, 0, 63, 22, 164
"/Users/sbukhari/Sandbox/CProgram/ASTanalysis/CodexUserStudyData/Control/bbea417b-a3f1-451b-a25d-d9dfb2c8aed2/orig_testsuite.json", "JSON", 0, 92, 0, 0, 0, 1, 93
"/Users/sbukhari/Sandbox/CProgram/ASTanalysis/CodexUserStudyData/Control/bbea417b-a3f1-451b-a25d-d9dfb2c8aed2/orig_testsuite_asan.json", "JSON", 0, 92, 0, 0, 0, 1, 93
"/Users/sbukhari/Sandbox/CProgram/ASTanalysis/CodexUserStudyData/Control/bbea417b-a3f1-451b-a25d-d9dfb2c8aed2/orig_testsuite_asan_noleak.json", "JSON", 0, 92, 0, 0, 0, 1, 93
"/Users/sbukhari/Sandbox/CProgram/ASTanalysis/CodexUserStudyData/Control/bbea417b-a3f1-451b-a25d-d9dfb2c8aed2/parts/gen_list_add_item_at_pos.c", "C", 31, 0, 0, 0, 18, 8, 57
"/Users/sbukhari/Sandbox/CProgram/ASTanalysis/CodexUserStudyData/Control/bbea417b-a3f1-451b-a25d-d9dfb2c8aed2/parts/gen_list_cost_sum.c", "C", 18, 0, 0, 0, 8, 5, 31
"/Users/sbukhari/Sandbox/CProgram/ASTanalysis/CodexUserStudyData/Control/bbea417b-a3f1-451b-a25d-d9dfb2c8aed2/parts/gen_list_deduplicate.c", "C", 17, 0, 0, 0, 8, 5, 30
"/Users/sbukhari/Sandbox/CProgram/ASTanalysis/CodexUserStudyData/Control/bbea417b-a3f1-451b-a25d-d9dfb2c8aed2/parts/gen_list_find_highest_price_item_position.c", "C", 18, 0, 0, 0, 8, 5, 31
"/Users/sbukhari/Sandbox/CProgram/ASTanalysis/CodexUserStudyData/Control/bbea417b-a3f1-451b-a25d-d9dfb2c8aed2/parts/gen_list_init.c", "C", 19, 0, 0, 0, 6, 6, 31
"/Users/sbukhari/Sandbox/CProgram/ASTanalysis/CodexUserStudyData/Control/bbea417b-a3f1-451b-a25d-d9dfb2c8aed2/parts/gen_list_item_to_string.c", "C", 21, 0, 0, 0, 12, 6, 39
"/Users/sbukhari/Sandbox/CProgram/ASTanalysis/CodexUserStudyData/Control/bbea417b-a3f1-451b-a25d-d9dfb2c8aed2/parts/gen_list_load.c", "C", 17, 0, 0, 0, 10, 5, 32
"/Users/sbukhari/Sandbox/CProgram/ASTanalysis/CodexUserStudyData/Control/bbea417b-a3f1-451b-a25d-d9dfb2c8aed2/parts/gen_list_print.c", "C", 24, 0, 0, 0, 21, 6, 51
"/Users/sbukhari/Sandbox/CProgram/ASTanalysis/CodexUserStudyData/Control/bbea417b-a3f1-451b-a25d-d9dfb2c8aed2/parts/gen_list_remove_item_at_pos.c", "C", 18, 0, 0, 0, 8, 5, 31
"/Users/sbukhari/Sandbox/CProgram/ASTanalysis/CodexUserStudyData/Control/bbea417b-a3f1-451b-a25d-d9dfb2c8aed2/parts/gen_list_save.c", "C", 17, 0, 0, 0, 9, 5, 31
"/Users/sbukhari/Sandbox/CProgram/ASTanalysis/CodexUserStudyData/Control/bbea417b-a3f1-451b-a25d-d9dfb2c8aed2/parts/gen_list_swap_item_positions.c", "C", 17, 0, 0, 0, 8, 5, 30
"/Users/sbukhari/Sandbox/CProgram/ASTanalysis/CodexUserStudyData/Control/bbea417b-a3f1-451b-a25d-d9dfb2c8aed2/parts/gen_list_update_item_at_pos.c", "C", 17, 0, 0, 0, 8, 5, 30
"/Users/sbukhari/Sandbox/CProgram/ASTanalysis/CodexUserStudyData/Control/bbea417b-a3f1-451b-a25d-d9dfb2c8aed2/ref_testsuite.json", "JSON", 0, 323, 0, 0, 0, 1, 324
"/Users/sbukhari/Sandbox/CProgram/ASTanalysis/CodexUserStudyData/Control/bbea417b-a3f1-451b-a25d-d9dfb2c8aed2/ref_testsuite_asan.json", "JSON", 0, 323, 0, 0, 0, 1, 324
"/Users/sbukhari/Sandbox/CProgram/ASTanalysis/CodexUserStudyData/Control/bbea417b-a3f1-451b-a25d-d9dfb2c8aed2/ref_testsuite_asan_noleak.json", "JSON", 0, 323, 0, 0, 0, 1, 324
"/Users/sbukhari/Sandbox/CProgram/ASTanalysis/CodexUserStudyData/Control/c8a48b56-ce2e-4d25-8dd8-a23b5e6549b5/api_report.json", "JSON", 0, 14, 0, 0, 0, 1, 15
"/Users/sbukhari/Sandbox/CProgram/ASTanalysis/CodexUserStudyData/Control/c8a48b56-ce2e-4d25-8dd8-a23b5e6549b5/list.c", "C", 203, 0, 0, 0, 75, 33, 311
"/Users/sbukhari/Sandbox/CProgram/ASTanalysis/CodexUserStudyData/Control/c8a48b56-ce2e-4d25-8dd8-a23b5e6549b5/orig_testsuite.json", "JSON", 0, 92, 0, 0, 0, 1, 93
"/Users/sbukhari/Sandbox/CProgram/ASTanalysis/CodexUserStudyData/Control/c8a48b56-ce2e-4d25-8dd8-a23b5e6549b5/orig_testsuite_asan.json", "JSON", 0, 92, 0, 0, 0, 1, 93
"/Users/sbukhari/Sandbox/CProgram/ASTanalysis/CodexUserStudyData/Control/c8a48b56-ce2e-4d25-8dd8-a23b5e6549b5/orig_testsuite_asan_noleak.json", "JSON", 0, 92, 0, 0, 0, 1, 93
"/Users/sbukhari/Sandbox/CProgram/ASTanalysis/CodexUserStudyData/Control/c8a48b56-ce2e-4d25-8dd8-a23b5e6549b5/parts/gen_list_add_item_at_pos.c", "C", 38, 0, 0, 0, 20, 6, 64
"/Users/sbukhari/Sandbox/CProgram/ASTanalysis/CodexUserStudyData/Control/c8a48b56-ce2e-4d25-8dd8-a23b5e6549b5/parts/gen_list_cost_sum.c", "C", 29, 0, 0, 0, 10, 6, 45
"/Users/sbukhari/Sandbox/CProgram/ASTanalysis/CodexUserStudyData/Control/c8a48b56-ce2e-4d25-8dd8-a23b5e6549b5/parts/gen_list_deduplicate.c", "C", 46, 0, 0, 0, 15, 10, 71
"/Users/sbukhari/Sandbox/CProgram/ASTanalysis/CodexUserStudyData/Control/c8a48b56-ce2e-4d25-8dd8-a23b5e6549b5/parts/gen_list_find_highest_price_item_position.c", "C", 34, 0, 0, 0, 10, 6, 50
"/Users/sbukhari/Sandbox/CProgram/ASTanalysis/CodexUserStudyData/Control/c8a48b56-ce2e-4d25-8dd8-a23b5e6549b5/parts/gen_list_init.c", "C", 19, 0, 0, 0, 6, 6, 31
"/Users/sbukhari/Sandbox/CProgram/ASTanalysis/CodexUserStudyData/Control/c8a48b56-ce2e-4d25-8dd8-a23b5e6549b5/parts/gen_list_item_to_string.c", "C", 20, 0, 0, 0, 14, 6, 40
"/Users/sbukhari/Sandbox/CProgram/ASTanalysis/CodexUserStudyData/Control/c8a48b56-ce2e-4d25-8dd8-a23b5e6549b5/parts/gen_list_load.c", "C", 29, 0, 0, 0, 16, 6, 51
"/Users/sbukhari/Sandbox/CProgram/ASTanalysis/CodexUserStudyData/Control/c8a48b56-ce2e-4d25-8dd8-a23b5e6549b5/parts/gen_list_print.c", "C", 25, 0, 0, 0, 21, 5, 51
"/Users/sbukhari/Sandbox/CProgram/ASTanalysis/CodexUserStudyData/Control/c8a48b56-ce2e-4d25-8dd8-a23b5e6549b5/parts/gen_list_remove_item_at_pos.c", "C", 32, 0, 0, 0, 15, 7, 54
"/Users/sbukhari/Sandbox/CProgram/ASTanalysis/CodexUserStudyData/Control/c8a48b56-ce2e-4d25-8dd8-a23b5e6549b5/parts/gen_list_save.c", "C", 26, 0, 0, 0, 15, 6, 47
"/Users/sbukhari/Sandbox/CProgram/ASTanalysis/CodexUserStudyData/Control/c8a48b56-ce2e-4d25-8dd8-a23b5e6549b5/parts/gen_list_swap_item_positions.c", "C", 36, 0, 0, 0, 11, 7, 54
"/Users/sbukhari/Sandbox/CProgram/ASTanalysis/CodexUserStudyData/Control/c8a48b56-ce2e-4d25-8dd8-a23b5e6549b5/parts/gen_list_update_item_at_pos.c", "C", 24, 0, 0, 0, 13, 5, 42
"/Users/sbukhari/Sandbox/CProgram/ASTanalysis/CodexUserStudyData/Control/c8a48b56-ce2e-4d25-8dd8-a23b5e6549b5/ref_testsuite.json", "JSON", 0, 323, 0, 0, 0, 1, 324
"/Users/sbukhari/Sandbox/CProgram/ASTanalysis/CodexUserStudyData/Control/c8a48b56-ce2e-4d25-8dd8-a23b5e6549b5/ref_testsuite_asan.json", "JSON", 0, 323, 0, 0, 0, 1, 324
"/Users/sbukhari/Sandbox/CProgram/ASTanalysis/CodexUserStudyData/Control/c8a48b56-ce2e-4d25-8dd8-a23b5e6549b5/ref_testsuite_asan_noleak.json", "JSON", 0, 323, 0, 0, 0, 1, 324
"/Users/sbukhari/Sandbox/CProgram/ASTanalysis/CodexUserStudyData/Control/caa12fcb-10a7-4f65-997b-0e1b1ba2c96d/api_report.json", "JSON", 0, 14, 0, 0, 0, 1, 15
"/Users/sbukhari/Sandbox/CProgram/ASTanalysis/CodexUserStudyData/Control/caa12fcb-10a7-4f65-997b-0e1b1ba2c96d/list.c", "C", 87, 0, 0, 0, 76, 17, 180
"/Users/sbukhari/Sandbox/CProgram/ASTanalysis/CodexUserStudyData/Control/caa12fcb-10a7-4f65-997b-0e1b1ba2c96d/orig_testsuite.json", "JSON", 0, 92, 0, 0, 0, 1, 93
"/Users/sbukhari/Sandbox/CProgram/ASTanalysis/CodexUserStudyData/Control/caa12fcb-10a7-4f65-997b-0e1b1ba2c96d/orig_testsuite_asan.json", "JSON", 0, 92, 0, 0, 0, 1, 93
"/Users/sbukhari/Sandbox/CProgram/ASTanalysis/CodexUserStudyData/Control/caa12fcb-10a7-4f65-997b-0e1b1ba2c96d/orig_testsuite_asan_noleak.json", "JSON", 0, 92, 0, 0, 0, 1, 93
"/Users/sbukhari/Sandbox/CProgram/ASTanalysis/CodexUserStudyData/Control/caa12fcb-10a7-4f65-997b-0e1b1ba2c96d/parts/gen_list_add_item_at_pos.c", "C", 18, 0, 0, 0, 18, 5, 41
"/Users/sbukhari/Sandbox/CProgram/ASTanalysis/CodexUserStudyData/Control/caa12fcb-10a7-4f65-997b-0e1b1ba2c96d/parts/gen_list_cost_sum.c", "C", 23, 0, 0, 0, 10, 5, 38
"/Users/sbukhari/Sandbox/CProgram/ASTanalysis/CodexUserStudyData/Control/caa12fcb-10a7-4f65-997b-0e1b1ba2c96d/parts/gen_list_deduplicate.c", "C", 18, 0, 0, 0, 10, 5, 33
"/Users/sbukhari/Sandbox/CProgram/ASTanalysis/CodexUserStudyData/Control/caa12fcb-10a7-4f65-997b-0e1b1ba2c96d/parts/gen_list_find_highest_price_item_position.c", "C", 29, 0, 0, 0, 11, 5, 45
"/Users/sbukhari/Sandbox/CProgram/ASTanalysis/CodexUserStudyData/Control/caa12fcb-10a7-4f65-997b-0e1b1ba2c96d/parts/gen_list_init.c", "C", 19, 0, 0, 0, 6, 6, 31
"/Users/sbukhari/Sandbox/CProgram/ASTanalysis/CodexUserStudyData/Control/caa12fcb-10a7-4f65-997b-0e1b1ba2c96d/parts/gen_list_item_to_string.c", "C", 25, 0, 0, 0, 15, 5, 45
"/Users/sbukhari/Sandbox/CProgram/ASTanalysis/CodexUserStudyData/Control/caa12fcb-10a7-4f65-997b-0e1b1ba2c96d/parts/gen_list_load.c", "C", 18, 0, 0, 0, 12, 5, 35
"/Users/sbukhari/Sandbox/CProgram/ASTanalysis/CodexUserStudyData/Control/caa12fcb-10a7-4f65-997b-0e1b1ba2c96d/parts/gen_list_print.c", "C", 22, 0, 0, 0, 21, 5, 48
"/Users/sbukhari/Sandbox/CProgram/ASTanalysis/CodexUserStudyData/Control/caa12fcb-10a7-4f65-997b-0e1b1ba2c96d/parts/gen_list_remove_item_at_pos.c", "C", 18, 0, 0, 0, 8, 5, 31
"/Users/sbukhari/Sandbox/CProgram/ASTanalysis/CodexUserStudyData/Control/caa12fcb-10a7-4f65-997b-0e1b1ba2c96d/parts/gen_list_save.c", "C", 18, 0, 0, 0, 11, 5, 34
"/Users/sbukhari/Sandbox/CProgram/ASTanalysis/CodexUserStudyData/Control/caa12fcb-10a7-4f65-997b-0e1b1ba2c96d/parts/gen_list_swap_item_positions.c", "C", 17, 0, 0, 0, 8, 5, 30
"/Users/sbukhari/Sandbox/CProgram/ASTanalysis/CodexUserStudyData/Control/caa12fcb-10a7-4f65-997b-0e1b1ba2c96d/parts/gen_list_update_item_at_pos.c", "C", 17, 0, 0, 0, 8, 5, 30
"/Users/sbukhari/Sandbox/CProgram/ASTanalysis/CodexUserStudyData/Control/caa12fcb-10a7-4f65-997b-0e1b1ba2c96d/ref_testsuite.json", "JSON", 0, 323, 0, 0, 0, 1, 324
"/Users/sbukhari/Sandbox/CProgram/ASTanalysis/CodexUserStudyData/Control/caa12fcb-10a7-4f65-997b-0e1b1ba2c96d/ref_testsuite_asan.json", "JSON", 0, 323, 0, 0, 0, 1, 324
"/Users/sbukhari/Sandbox/CProgram/ASTanalysis/CodexUserStudyData/Control/caa12fcb-10a7-4f65-997b-0e1b1ba2c96d/ref_testsuite_asan_noleak.json", "JSON", 0, 323, 0, 0, 0, 1, 324
"/Users/sbukhari/Sandbox/CProgram/ASTanalysis/CodexUserStudyData/Control/e5d2269a-cb40-4643-8134-13bc23ce41a7/api_report.json", "JSON", 0, 14, 0, 0, 0, 1, 15
"/Users/sbukhari/Sandbox/CProgram/ASTanalysis/CodexUserStudyData/Control/e5d2269a-cb40-4643-8134-13bc23ce41a7/list.c", "C", 228, 0, 0, 0, 77, 41, 346
"/Users/sbukhari/Sandbox/CProgram/ASTanalysis/CodexUserStudyData/Control/e5d2269a-cb40-4643-8134-13bc23ce41a7/orig_testsuite.json", "JSON", 0, 92, 0, 0, 0, 1, 93
"/Users/sbukhari/Sandbox/CProgram/ASTanalysis/CodexUserStudyData/Control/e5d2269a-cb40-4643-8134-13bc23ce41a7/orig_testsuite_asan.json", "JSON", 0, 92, 0, 0, 0, 1, 93
"/Users/sbukhari/Sandbox/CProgram/ASTanalysis/CodexUserStudyData/Control/e5d2269a-cb40-4643-8134-13bc23ce41a7/orig_testsuite_asan_noleak.json", "JSON", 0, 92, 0, 0, 0, 1, 93
"/Users/sbukhari/Sandbox/CProgram/ASTanalysis/CodexUserStudyData/Control/e5d2269a-cb40-4643-8134-13bc23ce41a7/parts/gen_list_add_item_at_pos.c", "C", 38, 0, 0, 0, 19, 10, 67
"/Users/sbukhari/Sandbox/CProgram/ASTanalysis/CodexUserStudyData/Control/e5d2269a-cb40-4643-8134-13bc23ce41a7/parts/gen_list_cost_sum.c", "C", 24, 0, 0, 0, 9, 5, 38
"/Users/sbukhari/Sandbox/CProgram/ASTanalysis/CodexUserStudyData/Control/e5d2269a-cb40-4643-8134-13bc23ce41a7/parts/gen_list_deduplicate.c", "C", 40, 0, 0, 0, 13, 5, 58
"/Users/sbukhari/Sandbox/CProgram/ASTanalysis/CodexUserStudyData/Control/e5d2269a-cb40-4643-8134-13bc23ce41a7/parts/gen_list_find_highest_price_item_position.c", "C", 30, 0, 0, 0, 10, 5, 45
"/Users/sbukhari/Sandbox/CProgram/ASTanalysis/CodexUserStudyData/Control/e5d2269a-cb40-4643-8134-13bc23ce41a7/parts/gen_list_init.c", "C", 19, 0, 0, 0, 6, 6, 31
"/Users/sbukhari/Sandbox/CProgram/ASTanalysis/CodexUserStudyData/Control/e5d2269a-cb40-4643-8134-13bc23ce41a7/parts/gen_list_item_to_string.c", "C", 21, 0, 0, 0, 17, 5, 43
"/Users/sbukhari/Sandbox/CProgram/ASTanalysis/CodexUserStudyData/Control/e5d2269a-cb40-4643-8134-13bc23ce41a7/parts/gen_list_load.c", "C", 47, 0, 0, 0, 15, 11, 73
"/Users/sbukhari/Sandbox/CProgram/ASTanalysis/CodexUserStudyData/Control/e5d2269a-cb40-4643-8134-13bc23ce41a7/parts/gen_list_print.c", "C", 25, 0, 0, 0, 22, 5, 52
"/Users/sbukhari/Sandbox/CProgram/ASTanalysis/CodexUserStudyData/Control/e5d2269a-cb40-4643-8134-13bc23ce41a7/parts/gen_list_remove_item_at_pos.c", "C", 34, 0, 0, 0, 13, 8, 55
"/Users/sbukhari/Sandbox/CProgram/ASTanalysis/CodexUserStudyData/Control/e5d2269a-cb40-4643-8134-13bc23ce41a7/parts/gen_list_save.c", "C", 32, 0, 0, 0, 14, 8, 54
"/Users/sbukhari/Sandbox/CProgram/ASTanalysis/CodexUserStudyData/Control/e5d2269a-cb40-4643-8134-13bc23ce41a7/parts/gen_list_swap_item_positions.c", "C", 44, 0, 0, 0, 12, 9, 65
"/Users/sbukhari/Sandbox/CProgram/ASTanalysis/CodexUserStudyData/Control/e5d2269a-cb40-4643-8134-13bc23ce41a7/parts/gen_list_update_item_at_pos.c", "C", 29, 0, 0, 0, 11, 7, 47
"/Users/sbukhari/Sandbox/CProgram/ASTanalysis/CodexUserStudyData/Control/e5d2269a-cb40-4643-8134-13bc23ce41a7/ref_testsuite.json", "JSON", 0, 323, 0, 0, 0, 1, 324
"/Users/sbukhari/Sandbox/CProgram/ASTanalysis/CodexUserStudyData/Control/e5d2269a-cb40-4643-8134-13bc23ce41a7/ref_testsuite_asan.json", "JSON", 0, 323, 0, 0, 0, 1, 324
"/Users/sbukhari/Sandbox/CProgram/ASTanalysis/CodexUserStudyData/Control/e5d2269a-cb40-4643-8134-13bc23ce41a7/ref_testsuite_asan_noleak.json", "JSON", 0, 323, 0, 0, 0, 1, 324
"/Users/sbukhari/Sandbox/CProgram/ASTanalysis/CodexUserStudyData/Control/e603de64-bbb4-43fd-9506-ec25df81b660/api_report.json", "JSON", 0, 14, 0, 0, 0, 1, 15
"/Users/sbukhari/Sandbox/CProgram/ASTanalysis/CodexUserStudyData/Control/e603de64-bbb4-43fd-9506-ec25df81b660/list.c", "C", 67, 0, 0, 0, 74, 17, 158
"/Users/sbukhari/Sandbox/CProgram/ASTanalysis/CodexUserStudyData/Control/e603de64-bbb4-43fd-9506-ec25df81b660/orig_testsuite.json", "JSON", 0, 92, 0, 0, 0, 1, 93
"/Users/sbukhari/Sandbox/CProgram/ASTanalysis/CodexUserStudyData/Control/e603de64-bbb4-43fd-9506-ec25df81b660/orig_testsuite_asan.json", "JSON", 0, 92, 0, 0, 0, 1, 93
"/Users/sbukhari/Sandbox/CProgram/ASTanalysis/CodexUserStudyData/Control/e603de64-bbb4-43fd-9506-ec25df81b660/orig_testsuite_asan_noleak.json", "JSON", 0, 92, 0, 0, 0, 1, 93
"/Users/sbukhari/Sandbox/CProgram/ASTanalysis/CodexUserStudyData/Control/e603de64-bbb4-43fd-9506-ec25df81b660/parts/gen_list_add_item_at_pos.c", "C", 18, 0, 0, 0, 18, 5, 41
"/Users/sbukhari/Sandbox/CProgram/ASTanalysis/CodexUserStudyData/Control/e603de64-bbb4-43fd-9506-ec25df81b660/parts/gen_list_cost_sum.c", "C", 18, 0, 0, 0, 8, 5, 31
"/Users/sbukhari/Sandbox/CProgram/ASTanalysis/CodexUserStudyData/Control/e603de64-bbb4-43fd-9506-ec25df81b660/parts/gen_list_deduplicate.c", "C", 18, 0, 0, 0, 10, 5, 33
"/Users/sbukhari/Sandbox/CProgram/ASTanalysis/CodexUserStudyData/Control/e603de64-bbb4-43fd-9506-ec25df81b660/parts/gen_list_find_highest_price_item_position.c", "C", 18, 0, 0, 0, 8, 5, 31
"/Users/sbukhari/Sandbox/CProgram/ASTanalysis/CodexUserStudyData/Control/e603de64-bbb4-43fd-9506-ec25df81b660/parts/gen_list_init.c", "C", 19, 0, 0, 0, 6, 6, 31
"/Users/sbukhari/Sandbox/CProgram/ASTanalysis/CodexUserStudyData/Control/e603de64-bbb4-43fd-9506-ec25df81b660/parts/gen_list_item_to_string.c", "C", 17, 0, 0, 0, 11, 5, 33
"/Users/sbukhari/Sandbox/CProgram/ASTanalysis/CodexUserStudyData/Control/e603de64-bbb4-43fd-9506-ec25df81b660/parts/gen_list_load.c", "C", 18, 0, 0, 0, 12, 5, 35
"/Users/sbukhari/Sandbox/CProgram/ASTanalysis/CodexUserStudyData/Control/e603de64-bbb4-43fd-9506-ec25df81b660/parts/gen_list_print.c", "C", 17, 0, 0, 0, 20, 5, 42
"/Users/sbukhari/Sandbox/CProgram/ASTanalysis/CodexUserStudyData/Control/e603de64-bbb4-43fd-9506-ec25df81b660/parts/gen_list_remove_item_at_pos.c", "C", 18, 0, 0, 0, 8, 5, 31
"/Users/sbukhari/Sandbox/CProgram/ASTanalysis/CodexUserStudyData/Control/e603de64-bbb4-43fd-9506-ec25df81b660/parts/gen_list_save.c", "C", 18, 0, 0, 0, 11, 5, 34
"/Users/sbukhari/Sandbox/CProgram/ASTanalysis/CodexUserStudyData/Control/e603de64-bbb4-43fd-9506-ec25df81b660/parts/gen_list_swap_item_positions.c", "C", 17, 0, 0, 0, 8, 5, 30
"/Users/sbukhari/Sandbox/CProgram/ASTanalysis/CodexUserStudyData/Control/e603de64-bbb4-43fd-9506-ec25df81b660/parts/gen_list_update_item_at_pos.c", "C", 17, 0, 0, 0, 8, 5, 30
"/Users/sbukhari/Sandbox/CProgram/ASTanalysis/CodexUserStudyData/Control/e603de64-bbb4-43fd-9506-ec25df81b660/ref_testsuite.json", "JSON", 0, 323, 0, 0, 0, 1, 324
"/Users/sbukhari/Sandbox/CProgram/ASTanalysis/CodexUserStudyData/Control/e603de64-bbb4-43fd-9506-ec25df81b660/ref_testsuite_asan.json", "JSON", 0, 323, 0, 0, 0, 1, 324
"/Users/sbukhari/Sandbox/CProgram/ASTanalysis/CodexUserStudyData/Control/e603de64-bbb4-43fd-9506-ec25df81b660/ref_testsuite_asan_noleak.json", "JSON", 0, 323, 0, 0, 0, 1, 324
"/Users/sbukhari/Sandbox/CProgram/ASTanalysis/CodexUserStudyData/Control/e71766a5-b1da-462f-8ea5-a7e12f82f58e/api_report.json", "JSON", 0, 14, 0, 0, 0, 1, 15
"/Users/sbukhari/Sandbox/CProgram/ASTanalysis/CodexUserStudyData/Control/e71766a5-b1da-462f-8ea5-a7e12f82f58e/list.c", "C", 216, 0, 0, 0, 94, 22, 332
"/Users/sbukhari/Sandbox/CProgram/ASTanalysis/CodexUserStudyData/Control/e71766a5-b1da-462f-8ea5-a7e12f82f58e/orig_testsuite.json", "JSON", 0, 92, 0, 0, 0, 1, 93
"/Users/sbukhari/Sandbox/CProgram/ASTanalysis/CodexUserStudyData/Control/e71766a5-b1da-462f-8ea5-a7e12f82f58e/orig_testsuite_asan.json", "JSON", 0, 92, 0, 0, 0, 1, 93
"/Users/sbukhari/Sandbox/CProgram/ASTanalysis/CodexUserStudyData/Control/e71766a5-b1da-462f-8ea5-a7e12f82f58e/orig_testsuite_asan_noleak.json", "JSON", 0, 92, 0, 0, 0, 1, 93
"/Users/sbukhari/Sandbox/CProgram/ASTanalysis/CodexUserStudyData/Control/e71766a5-b1da-462f-8ea5-a7e12f82f58e/parts/gen_list_add_item_at_pos.c", "C", 19, 0, 0, 0, 18, 5, 42
"/Users/sbukhari/Sandbox/CProgram/ASTanalysis/CodexUserStudyData/Control/e71766a5-b1da-462f-8ea5-a7e12f82f58e/parts/gen_list_cost_sum.c", "C", 26, 0, 0, 0, 9, 5, 40
"/Users/sbukhari/Sandbox/CProgram/ASTanalysis/CodexUserStudyData/Control/e71766a5-b1da-462f-8ea5-a7e12f82f58e/parts/gen_list_deduplicate.c", "C", 19, 0, 0, 0, 10, 5, 34
"/Users/sbukhari/Sandbox/CProgram/ASTanalysis/CodexUserStudyData/Control/e71766a5-b1da-462f-8ea5-a7e12f82f58e/parts/gen_list_find_highest_price_item_position.c", "C", 30, 0, 0, 0, 9, 6, 45
"/Users/sbukhari/Sandbox/CProgram/ASTanalysis/CodexUserStudyData/Control/e71766a5-b1da-462f-8ea5-a7e12f82f58e/parts/gen_list_init.c", "C", 20, 0, 0, 0, 6, 6, 32
"/Users/sbukhari/Sandbox/CProgram/ASTanalysis/CodexUserStudyData/Control/e71766a5-b1da-462f-8ea5-a7e12f82f58e/parts/gen_list_item_to_string.c", "C", 18, 0, 0, 0, 11, 5, 34
"/Users/sbukhari/Sandbox/CProgram/ASTanalysis/CodexUserStudyData/Control/e71766a5-b1da-462f-8ea5-a7e12f82f58e/parts/gen_list_load.c", "C", 19, 0, 0, 0, 12, 5, 36
"/Users/sbukhari/Sandbox/CProgram/ASTanalysis/CodexUserStudyData/Control/e71766a5-b1da-462f-8ea5-a7e12f82f58e/parts/gen_list_print.c", "C", 30, 0, 0, 0, 22, 5, 57
"/Users/sbukhari/Sandbox/CProgram/ASTanalysis/CodexUserStudyData/Control/e71766a5-b1da-462f-8ea5-a7e12f82f58e/parts/gen_list_remove_item_at_pos.c", "C", 25, 0, 0, 0, 14, 5, 44
"/Users/sbukhari/Sandbox/CProgram/ASTanalysis/CodexUserStudyData/Control/e71766a5-b1da-462f-8ea5-a7e12f82f58e/parts/gen_list_save.c", "C", 19, 0, 0, 0, 11, 5, 35
"/Users/sbukhari/Sandbox/CProgram/ASTanalysis/CodexUserStudyData/Control/e71766a5-b1da-462f-8ea5-a7e12f82f58e/parts/gen_list_swap_item_positions.c", "C", 18, 0, 0, 0, 8, 5, 31
"/Users/sbukhari/Sandbox/CProgram/ASTanalysis/CodexUserStudyData/Control/e71766a5-b1da-462f-8ea5-a7e12f82f58e/parts/gen_list_update_item_at_pos.c", "C", 18, 0, 0, 0, 8, 5, 31
"/Users/sbukhari/Sandbox/CProgram/ASTanalysis/CodexUserStudyData/Control/e71766a5-b1da-462f-8ea5-a7e12f82f58e/ref_testsuite.json", "JSON", 0, 323, 0, 0, 0, 1, 324
"/Users/sbukhari/Sandbox/CProgram/ASTanalysis/CodexUserStudyData/Control/e71766a5-b1da-462f-8ea5-a7e12f82f58e/ref_testsuite_asan.json", "JSON", 0, 323, 0, 0, 0, 1, 324
"/Users/sbukhari/Sandbox/CProgram/ASTanalysis/CodexUserStudyData/Control/e71766a5-b1da-462f-8ea5-a7e12f82f58e/ref_testsuite_asan_noleak.json", "JSON", 0, 323, 0, 0, 0, 1, 324
"/Users/sbukhari/Sandbox/CProgram/ASTanalysis/CodexUserStudyData/Control/f0e25db0-7a42-4c33-a22c-17b79e580330/api_report.json", "JSON", 0, 14, 0, 0, 0, 1, 15
"/Users/sbukhari/Sandbox/CProgram/ASTanalysis/CodexUserStudyData/Control/f0e25db0-7a42-4c33-a22c-17b79e580330/list.c", "C", 66, 0, 0, 0, 70, 17, 153
"/Users/sbukhari/Sandbox/CProgram/ASTanalysis/CodexUserStudyData/Control/f0e25db0-7a42-4c33-a22c-17b79e580330/orig_testsuite.json", "JSON", 0, 92, 0, 0, 0, 1, 93
"/Users/sbukhari/Sandbox/CProgram/ASTanalysis/CodexUserStudyData/Control/f0e25db0-7a42-4c33-a22c-17b79e580330/orig_testsuite_asan.json", "JSON", 0, 92, 0, 0, 0, 1, 93
"/Users/sbukhari/Sandbox/CProgram/ASTanalysis/CodexUserStudyData/Control/f0e25db0-7a42-4c33-a22c-17b79e580330/orig_testsuite_asan_noleak.json", "JSON", 0, 92, 0, 0, 0, 1, 93
"/Users/sbukhari/Sandbox/CProgram/ASTanalysis/CodexUserStudyData/Control/f0e25db0-7a42-4c33-a22c-17b79e580330/parts/gen_list_add_item_at_pos.c", "C", 18, 0, 0, 0, 18, 5, 41
"/Users/sbukhari/Sandbox/CProgram/ASTanalysis/CodexUserStudyData/Control/f0e25db0-7a42-4c33-a22c-17b79e580330/parts/gen_list_cost_sum.c", "C", 18, 0, 0, 0, 8, 5, 31
"/Users/sbukhari/Sandbox/CProgram/ASTanalysis/CodexUserStudyData/Control/f0e25db0-7a42-4c33-a22c-17b79e580330/parts/gen_list_deduplicate.c", "C", 18, 0, 0, 0, 10, 5, 33
"/Users/sbukhari/Sandbox/CProgram/ASTanalysis/CodexUserStudyData/Control/f0e25db0-7a42-4c33-a22c-17b79e580330/parts/gen_list_find_highest_price_item_position.c", "C", 18, 0, 0, 0, 8, 5, 31
"/Users/sbukhari/Sandbox/CProgram/ASTanalysis/CodexUserStudyData/Control/f0e25db0-7a42-4c33-a22c-17b79e580330/parts/gen_list_init.c", "C", 19, 0, 0, 0, 6, 6, 31
"/Users/sbukhari/Sandbox/CProgram/ASTanalysis/CodexUserStudyData/Control/f0e25db0-7a42-4c33-a22c-17b79e580330/parts/gen_list_item_to_string.c", "C", 18, 0, 0, 0, 14, 5, 37
"/Users/sbukhari/Sandbox/CProgram/ASTanalysis/CodexUserStudyData/Control/f0e25db0-7a42-4c33-a22c-17b79e580330/parts/gen_list_load.c", "C", 18, 0, 0, 0, 12, 5, 35
"/Users/sbukhari/Sandbox/CProgram/ASTanalysis/CodexUserStudyData/Control/f0e25db0-7a42-4c33-a22c-17b79e580330/parts/gen_list_print.c", "C", 24, 0, 0, 0, 19, 5, 48
"/Users/sbukhari/Sandbox/CProgram/ASTanalysis/CodexUserStudyData/Control/f0e25db0-7a42-4c33-a22c-17b79e580330/parts/gen_list_remove_item_at_pos.c", "C", 18, 0, 0, 0, 8, 5, 31
"/Users/sbukhari/Sandbox/CProgram/ASTanalysis/CodexUserStudyData/Control/f0e25db0-7a42-4c33-a22c-17b79e580330/parts/gen_list_save.c", "C", 18, 0, 0, 0, 11, 5, 34
"/Users/sbukhari/Sandbox/CProgram/ASTanalysis/CodexUserStudyData/Control/f0e25db0-7a42-4c33-a22c-17b79e580330/parts/gen_list_swap_item_positions.c", "C", 17, 0, 0, 0, 8, 5, 30
"/Users/sbukhari/Sandbox/CProgram/ASTanalysis/CodexUserStudyData/Control/f0e25db0-7a42-4c33-a22c-17b79e580330/parts/gen_list_update_item_at_pos.c", "C", 17, 0, 0, 0, 8, 5, 30
"/Users/sbukhari/Sandbox/CProgram/ASTanalysis/CodexUserStudyData/Control/f0e25db0-7a42-4c33-a22c-17b79e580330/ref_testsuite.json", "JSON", 0, 323, 0, 0, 0, 1, 324
"/Users/sbukhari/Sandbox/CProgram/ASTanalysis/CodexUserStudyData/Control/f0e25db0-7a42-4c33-a22c-17b79e580330/ref_testsuite_asan.json", "JSON", 0, 323, 0, 0, 0, 1, 324
"/Users/sbukhari/Sandbox/CProgram/ASTanalysis/CodexUserStudyData/Control/f0e25db0-7a42-4c33-a22c-17b79e580330/ref_testsuite_asan_noleak.json", "JSON", 0, 323, 0, 0, 0, 1, 324
"/Users/sbukhari/Sandbox/CProgram/ASTanalysis/CodexUserStudyData/Control/f928b19b-6a98-4ed9-9c09-bfdf78073fd2/api_report.json", "JSON", 0, 14, 0, 0, 0, 1, 15
"/Users/sbukhari/Sandbox/CProgram/ASTanalysis/CodexUserStudyData/Control/f928b19b-6a98-4ed9-9c09-bfdf78073fd2/list.c", "C", 85, 0, 0, 0, 74, 21, 180
"/Users/sbukhari/Sandbox/CProgram/ASTanalysis/CodexUserStudyData/Control/f928b19b-6a98-4ed9-9c09-bfdf78073fd2/orig_testsuite.json", "JSON", 0, 92, 0, 0, 0, 1, 93
"/Users/sbukhari/Sandbox/CProgram/ASTanalysis/CodexUserStudyData/Control/f928b19b-6a98-4ed9-9c09-bfdf78073fd2/orig_testsuite_asan.json", "JSON", 0, 92, 0, 0, 0, 1, 93
"/Users/sbukhari/Sandbox/CProgram/ASTanalysis/CodexUserStudyData/Control/f928b19b-6a98-4ed9-9c09-bfdf78073fd2/orig_testsuite_asan_noleak.json", "JSON", 0, 92, 0, 0, 0, 1, 93
"/Users/sbukhari/Sandbox/CProgram/ASTanalysis/CodexUserStudyData/Control/f928b19b-6a98-4ed9-9c09-bfdf78073fd2/parts/gen_list_add_item_at_pos.c", "C", 35, 0, 0, 0, 20, 7, 62
"/Users/sbukhari/Sandbox/CProgram/ASTanalysis/CodexUserStudyData/Control/f928b19b-6a98-4ed9-9c09-bfdf78073fd2/parts/gen_list_cost_sum.c", "C", 18, 0, 0, 0, 8, 5, 31
"/Users/sbukhari/Sandbox/CProgram/ASTanalysis/CodexUserStudyData/Control/f928b19b-6a98-4ed9-9c09-bfdf78073fd2/parts/gen_list_deduplicate.c", "C", 18, 0, 0, 0, 10, 5, 33
"/Users/sbukhari/Sandbox/CProgram/ASTanalysis/CodexUserStudyData/Control/f928b19b-6a98-4ed9-9c09-bfdf78073fd2/parts/gen_list_find_highest_price_item_position.c", "C", 18, 0, 0, 0, 8, 5, 31
"/Users/sbukhari/Sandbox/CProgram/ASTanalysis/CodexUserStudyData/Control/f928b19b-6a98-4ed9-9c09-bfdf78073fd2/parts/gen_list_init.c", "C", 19, 0, 0, 0, 6, 6, 31
"/Users/sbukhari/Sandbox/CProgram/ASTanalysis/CodexUserStudyData/Control/f928b19b-6a98-4ed9-9c09-bfdf78073fd2/parts/gen_list_item_to_string.c", "C", 19, 0, 0, 0, 15, 5, 39
"/Users/sbukhari/Sandbox/CProgram/ASTanalysis/CodexUserStudyData/Control/f928b19b-6a98-4ed9-9c09-bfdf78073fd2/parts/gen_list_load.c", "C", 18, 0, 0, 0, 12, 5, 35
"/Users/sbukhari/Sandbox/CProgram/ASTanalysis/CodexUserStudyData/Control/f928b19b-6a98-4ed9-9c09-bfdf78073fd2/parts/gen_list_print.c", "C", 25, 0, 0, 0, 22, 7, 54
"/Users/sbukhari/Sandbox/CProgram/ASTanalysis/CodexUserStudyData/Control/f928b19b-6a98-4ed9-9c09-bfdf78073fd2/parts/gen_list_remove_item_at_pos.c", "C", 18, 0, 0, 0, 8, 5, 31
"/Users/sbukhari/Sandbox/CProgram/ASTanalysis/CodexUserStudyData/Control/f928b19b-6a98-4ed9-9c09-bfdf78073fd2/parts/gen_list_save.c", "C", 18, 0, 0, 0, 11, 5, 34
"/Users/sbukhari/Sandbox/CProgram/ASTanalysis/CodexUserStudyData/Control/f928b19b-6a98-4ed9-9c09-bfdf78073fd2/parts/gen_list_swap_item_positions.c", "C", 17, 0, 0, 0, 8, 5, 30
"/Users/sbukhari/Sandbox/CProgram/ASTanalysis/CodexUserStudyData/Control/f928b19b-6a98-4ed9-9c09-bfdf78073fd2/parts/gen_list_update_item_at_pos.c", "C", 17, 0, 0, 0, 8, 5, 30
"/Users/sbukhari/Sandbox/CProgram/ASTanalysis/CodexUserStudyData/Control/f928b19b-6a98-4ed9-9c09-bfdf78073fd2/ref_testsuite.json", "JSON", 0, 323, 0, 0, 0, 1, 324
"/Users/sbukhari/Sandbox/CProgram/ASTanalysis/CodexUserStudyData/Control/f928b19b-6a98-4ed9-9c09-bfdf78073fd2/ref_testsuite_asan.json", "JSON", 0, 323, 0, 0, 0, 1, 324
"/Users/sbukhari/Sandbox/CProgram/ASTanalysis/CodexUserStudyData/Control/f928b19b-6a98-4ed9-9c09-bfdf78073fd2/ref_testsuite_asan_noleak.json", "JSON", 0, 323, 0, 0, 0, 1, 324
"/Users/sbukhari/Sandbox/CProgram/ASTanalysis/CodexUserStudyData/Control/fbf1986f-db73-4988-af05-0d3cb48dd0c9/api_report.json", "JSON", 0, 14, 0, 0, 0, 1, 15
"/Users/sbukhari/Sandbox/CProgram/ASTanalysis/CodexUserStudyData/Control/fbf1986f-db73-4988-af05-0d3cb48dd0c9/list.c", "C", 86, 0, 0, 0, 75, 21, 182
"/Users/sbukhari/Sandbox/CProgram/ASTanalysis/CodexUserStudyData/Control/fbf1986f-db73-4988-af05-0d3cb48dd0c9/orig_testsuite.json", "JSON", 0, 92, 0, 0, 0, 1, 93
"/Users/sbukhari/Sandbox/CProgram/ASTanalysis/CodexUserStudyData/Control/fbf1986f-db73-4988-af05-0d3cb48dd0c9/orig_testsuite_asan.json", "JSON", 0, 92, 0, 0, 0, 1, 93
"/Users/sbukhari/Sandbox/CProgram/ASTanalysis/CodexUserStudyData/Control/fbf1986f-db73-4988-af05-0d3cb48dd0c9/orig_testsuite_asan_noleak.json", "JSON", 0, 92, 0, 0, 0, 1, 93
"/Users/sbukhari/Sandbox/CProgram/ASTanalysis/CodexUserStudyData/Control/fbf1986f-db73-4988-af05-0d3cb48dd0c9/parts/gen_list_add_item_at_pos.c", "C", 36, 0, 0, 0, 23, 9, 68
"/Users/sbukhari/Sandbox/CProgram/ASTanalysis/CodexUserStudyData/Control/fbf1986f-db73-4988-af05-0d3cb48dd0c9/parts/gen_list_cost_sum.c", "C", 18, 0, 0, 0, 8, 5, 31
"/Users/sbukhari/Sandbox/CProgram/ASTanalysis/CodexUserStudyData/Control/fbf1986f-db73-4988-af05-0d3cb48dd0c9/parts/gen_list_deduplicate.c", "C", 18, 0, 0, 0, 10, 5, 33
"/Users/sbukhari/Sandbox/CProgram/ASTanalysis/CodexUserStudyData/Control/fbf1986f-db73-4988-af05-0d3cb48dd0c9/parts/gen_list_find_highest_price_item_position.c", "C", 18, 0, 0, 0, 8, 5, 31
"/Users/sbukhari/Sandbox/CProgram/ASTanalysis/CodexUserStudyData/Control/fbf1986f-db73-4988-af05-0d3cb48dd0c9/parts/gen_list_init.c", "C", 19, 0, 0, 0, 6, 6, 31
"/Users/sbukhari/Sandbox/CProgram/ASTanalysis/CodexUserStudyData/Control/fbf1986f-db73-4988-af05-0d3cb48dd0c9/parts/gen_list_item_to_string.c", "C", 19, 0, 0, 0, 15, 5, 39
"/Users/sbukhari/Sandbox/CProgram/ASTanalysis/CodexUserStudyData/Control/fbf1986f-db73-4988-af05-0d3cb48dd0c9/parts/gen_list_load.c", "C", 18, 0, 0, 0, 12, 5, 35
"/Users/sbukhari/Sandbox/CProgram/ASTanalysis/CodexUserStudyData/Control/fbf1986f-db73-4988-af05-0d3cb48dd0c9/parts/gen_list_print.c", "C", 25, 0, 0, 0, 21, 5, 51
"/Users/sbukhari/Sandbox/CProgram/ASTanalysis/CodexUserStudyData/Control/fbf1986f-db73-4988-af05-0d3cb48dd0c9/parts/gen_list_remove_item_at_pos.c", "C", 18, 0, 0, 0, 8, 5, 31
"/Users/sbukhari/Sandbox/CProgram/ASTanalysis/CodexUserStudyData/Control/fbf1986f-db73-4988-af05-0d3cb48dd0c9/parts/gen_list_save.c", "C", 18, 0, 0, 0, 11, 5, 34
"/Users/sbukhari/Sandbox/CProgram/ASTanalysis/CodexUserStudyData/Control/fbf1986f-db73-4988-af05-0d3cb48dd0c9/parts/gen_list_swap_item_positions.c", "C", 17, 0, 0, 0, 8, 5, 30
"/Users/sbukhari/Sandbox/CProgram/ASTanalysis/CodexUserStudyData/Control/fbf1986f-db73-4988-af05-0d3cb48dd0c9/parts/gen_list_update_item_at_pos.c", "C", 17, 0, 0, 0, 8, 5, 30
"/Users/sbukhari/Sandbox/CProgram/ASTanalysis/CodexUserStudyData/Control/fbf1986f-db73-4988-af05-0d3cb48dd0c9/ref_testsuite.json", "JSON", 0, 323, 0, 0, 0, 1, 324
"/Users/sbukhari/Sandbox/CProgram/ASTanalysis/CodexUserStudyData/Control/fbf1986f-db73-4988-af05-0d3cb48dd0c9/ref_testsuite_asan.json", "JSON", 0, 323, 0, 0, 0, 1, 324
"/Users/sbukhari/Sandbox/CProgram/ASTanalysis/CodexUserStudyData/Control/fbf1986f-db73-4988-af05-0d3cb48dd0c9/ref_testsuite_asan_noleak.json", "JSON", 0, 323, 0, 0, 0, 1, 324
"/Users/sbukhari/Sandbox/CProgram/ASTanalysis/CodexUserStudyData/Other/gold_standard/api_report.json", "JSON", 0, 14, 0, 0, 0, 1, 15
"/Users/sbukhari/Sandbox/CProgram/ASTanalysis/CodexUserStudyData/Other/gold_standard/list.c", "C", 318, 0, 0, 0, 64, 30, 412
"/Users/sbukhari/Sandbox/CProgram/ASTanalysis/CodexUserStudyData/Other/gold_standard/orig_testsuite.json", "JSON", 0, 92, 0, 0, 0, 1, 93
"/Users/sbukhari/Sandbox/CProgram/ASTanalysis/CodexUserStudyData/Other/gold_standard/orig_testsuite_asan.json", "JSON", 0, 92, 0, 0, 0, 1, 93
"/Users/sbukhari/Sandbox/CProgram/ASTanalysis/CodexUserStudyData/Other/gold_standard/orig_testsuite_asan_noleak.json", "JSON", 0, 92, 0, 0, 0, 1, 93
"/Users/sbukhari/Sandbox/CProgram/ASTanalysis/CodexUserStudyData/Other/gold_standard/parts/gen_list_add_item_at_pos.c", "C", 45, 0, 0, 0, 17, 8, 70
"/Users/sbukhari/Sandbox/CProgram/ASTanalysis/CodexUserStudyData/Other/gold_standard/parts/gen_list_cost_sum.c", "C", 28, 0, 0, 0, 6, 5, 39
"/Users/sbukhari/Sandbox/CProgram/ASTanalysis/CodexUserStudyData/Other/gold_standard/parts/gen_list_deduplicate.c", "C", 72, 0, 0, 0, 14, 21, 107
"/Users/sbukhari/Sandbox/CProgram/ASTanalysis/CodexUserStudyData/Other/gold_standard/parts/gen_list_find_highest_price_item_position.c", "C", 32, 0, 0, 0, 6, 5, 43
"/Users/sbukhari/Sandbox/CProgram/ASTanalysis/CodexUserStudyData/Other/gold_standard/parts/gen_list_init.c", "C", 23, 0, 0, 0, 6, 6, 35
"/Users/sbukhari/Sandbox/CProgram/ASTanalysis/CodexUserStudyData/Other/gold_standard/parts/gen_list_item_to_string.c", "C", 24, 0, 0, 0, 9, 5, 38
"/Users/sbukhari/Sandbox/CProgram/ASTanalysis/CodexUserStudyData/Other/gold_standard/parts/gen_list_load.c", "C", 57, 0, 0, 0, 11, 8, 76
"/Users/sbukhari/Sandbox/CProgram/ASTanalysis/CodexUserStudyData/Other/gold_standard/parts/gen_list_print.c", "C", 32, 0, 0, 0, 18, 5, 55
"/Users/sbukhari/Sandbox/CProgram/ASTanalysis/CodexUserStudyData/Other/gold_standard/parts/gen_list_remove_item_at_pos.c", "C", 52, 0, 0, 0, 8, 5, 65
"/Users/sbukhari/Sandbox/CProgram/ASTanalysis/CodexUserStudyData/Other/gold_standard/parts/gen_list_save.c", "C", 34, 0, 0, 0, 9, 5, 48
"/Users/sbukhari/Sandbox/CProgram/ASTanalysis/CodexUserStudyData/Other/gold_standard/parts/gen_list_swap_item_positions.c", "C", 63, 0, 0, 0, 10, 8, 81
"/Users/sbukhari/Sandbox/CProgram/ASTanalysis/CodexUserStudyData/Other/gold_standard/parts/gen_list_update_item_at_pos.c", "C", 49, 0, 0, 0, 8, 5, 62
"/Users/sbukhari/Sandbox/CProgram/ASTanalysis/CodexUserStudyData/Other/gold_standard/ref_testsuite.json", "JSON", 0, 323, 0, 0, 0, 1, 324
"/Users/sbukhari/Sandbox/CProgram/ASTanalysis/CodexUserStudyData/Other/gold_standard/ref_testsuite_asan.json", "JSON", 0, 323, 0, 0, 0, 1, 324
"/Users/sbukhari/Sandbox/CProgram/ASTanalysis/CodexUserStudyData/Other/gold_standard/ref_testsuite_asan_noleak.json", "JSON", 0, 323, 0, 0, 0, 1, 324
"/Users/sbukhari/Sandbox/CProgram/ASTanalysis/CodexUserStudyData/Other/unmodified/api_report.json", "JSON", 0, 14, 0, 0, 0, 1, 15
"/Users/sbukhari/Sandbox/CProgram/ASTanalysis/CodexUserStudyData/Other/unmodified/list.c", "C", 58, 0, 0, 0, 74, 17, 149
"/Users/sbukhari/Sandbox/CProgram/ASTanalysis/CodexUserStudyData/Other/unmodified/orig_testsuite.json", "JSON", 0, 92, 0, 0, 0, 1, 93
"/Users/sbukhari/Sandbox/CProgram/ASTanalysis/CodexUserStudyData/Other/unmodified/orig_testsuite_asan.json", "JSON", 0, 92, 0, 0, 0, 1, 93
"/Users/sbukhari/Sandbox/CProgram/ASTanalysis/CodexUserStudyData/Other/unmodified/orig_testsuite_asan_noleak.json", "JSON", 0, 92, 0, 0, 0, 1, 93
"/Users/sbukhari/Sandbox/CProgram/ASTanalysis/CodexUserStudyData/Other/unmodified/parts/gen_list_add_item_at_pos.c", "C", 18, 0, 0, 0, 18, 5, 41
"/Users/sbukhari/Sandbox/CProgram/ASTanalysis/CodexUserStudyData/Other/unmodified/parts/gen_list_cost_sum.c", "C", 18, 0, 0, 0, 8, 5, 31
"/Users/sbukhari/Sandbox/CProgram/ASTanalysis/CodexUserStudyData/Other/unmodified/parts/gen_list_deduplicate.c", "C", 18, 0, 0, 0, 10, 5, 33
"/Users/sbukhari/Sandbox/CProgram/ASTanalysis/CodexUserStudyData/Other/unmodified/parts/gen_list_find_highest_price_item_position.c", "C", 18, 0, 0, 0, 8, 5, 31
"/Users/sbukhari/Sandbox/CProgram/ASTanalysis/CodexUserStudyData/Other/unmodified/parts/gen_list_init.c", "C", 19, 0, 0, 0, 6, 6, 31
"/Users/sbukhari/Sandbox/CProgram/ASTanalysis/CodexUserStudyData/Other/unmodified/parts/gen_list_item_to_string.c", "C", 17, 0, 0, 0, 11, 5, 33
"/Users/sbukhari/Sandbox/CProgram/ASTanalysis/CodexUserStudyData/Other/unmodified/parts/gen_list_load.c", "C", 18, 0, 0, 0, 12, 5, 35
"/Users/sbukhari/Sandbox/CProgram/ASTanalysis/CodexUserStudyData/Other/unmodified/parts/gen_list_print.c", "C", 17, 0, 0, 0, 20, 5, 42
"/Users/sbukhari/Sandbox/CProgram/ASTanalysis/CodexUserStudyData/Other/unmodified/parts/gen_list_remove_item_at_pos.c", "C", 18, 0, 0, 0, 8, 5, 31
"/Users/sbukhari/Sandbox/CProgram/ASTanalysis/CodexUserStudyData/Other/unmodified/parts/gen_list_save.c", "C", 18, 0, 0, 0, 11, 5, 34
"/Users/sbukhari/Sandbox/CProgram/ASTanalysis/CodexUserStudyData/Other/unmodified/parts/gen_list_swap_item_positions.c", "C", 17, 0, 0, 0, 8, 5, 30
"/Users/sbukhari/Sandbox/CProgram/ASTanalysis/CodexUserStudyData/Other/unmodified/parts/gen_list_update_item_at_pos.c", "C", 17, 0, 0, 0, 8, 5, 30
"/Users/sbukhari/Sandbox/CProgram/ASTanalysis/CodexUserStudyData/Other/unmodified/ref_testsuite.json", "JSON", 0, 323, 0, 0, 0, 1, 324
"/Users/sbukhari/Sandbox/CProgram/ASTanalysis/CodexUserStudyData/Other/unmodified/ref_testsuite_asan.json", "JSON", 0, 323, 0, 0, 0, 1, 324
"/Users/sbukhari/Sandbox/CProgram/ASTanalysis/CodexUserStudyData/Other/unmodified/ref_testsuite_asan_noleak.json", "JSON", 0, 323, 0, 0, 0, 1, 324
"/Users/sbukhari/Sandbox/CProgram/ASTanalysis/CodexUserStudyData/raw_data/035a8eed-29c0-4606-814d-4cb786d0b9de/api_report.json", "JSON", 0, 14, 0, 0, 0, 1, 15
"/Users/sbukhari/Sandbox/CProgram/ASTanalysis/CodexUserStudyData/raw_data/035a8eed-29c0-4606-814d-4cb786d0b9de/list.c", "C", 213, 0, 0, 0, 52, 50, 315
"/Users/sbukhari/Sandbox/CProgram/ASTanalysis/CodexUserStudyData/raw_data/035a8eed-29c0-4606-814d-4cb786d0b9de/orig_testsuite.json", "JSON", 0, 92, 0, 0, 0, 1, 93
"/Users/sbukhari/Sandbox/CProgram/ASTanalysis/CodexUserStudyData/raw_data/035a8eed-29c0-4606-814d-4cb786d0b9de/orig_testsuite_asan.json", "JSON", 0, 92, 0, 0, 0, 1, 93
"/Users/sbukhari/Sandbox/CProgram/ASTanalysis/CodexUserStudyData/raw_data/035a8eed-29c0-4606-814d-4cb786d0b9de/orig_testsuite_asan_noleak.json", "JSON", 0, 92, 0, 0, 0, 1, 93
"/Users/sbukhari/Sandbox/CProgram/ASTanalysis/CodexUserStudyData/raw_data/035a8eed-29c0-4606-814d-4cb786d0b9de/parts/gen_list_add_item_at_pos.c", "C", 43, 0, 0, 0, 17, 7, 67
"/Users/sbukhari/Sandbox/CProgram/ASTanalysis/CodexUserStudyData/raw_data/035a8eed-29c0-4606-814d-4cb786d0b9de/parts/gen_list_cost_sum.c", "C", 24, 0, 0, 0, 7, 8, 39
"/Users/sbukhari/Sandbox/CProgram/ASTanalysis/CodexUserStudyData/raw_data/035a8eed-29c0-4606-814d-4cb786d0b9de/parts/gen_list_deduplicate.c", "C", 34, 0, 0, 0, 12, 7, 53
"/Users/sbukhari/Sandbox/CProgram/ASTanalysis/CodexUserStudyData/raw_data/035a8eed-29c0-4606-814d-4cb786d0b9de/parts/gen_list_find_highest_price_item_position.c", "C", 26, 0, 0, 0, 8, 9, 43
"/Users/sbukhari/Sandbox/CProgram/ASTanalysis/CodexUserStudyData/raw_data/035a8eed-29c0-4606-814d-4cb786d0b9de/parts/gen_list_init.c", "C", 19, 0, 0, 0, 6, 6, 31
"/Users/sbukhari/Sandbox/CProgram/ASTanalysis/CodexUserStudyData/raw_data/035a8eed-29c0-4606-814d-4cb786d0b9de/parts/gen_list_item_to_string.c", "C", 20, 0, 0, 0, 12, 5, 37
"/Users/sbukhari/Sandbox/CProgram/ASTanalysis/CodexUserStudyData/raw_data/035a8eed-29c0-4606-814d-4cb786d0b9de/parts/gen_list_load.c", "C", 38, 0, 0, 0, 17, 10, 65
"/Users/sbukhari/Sandbox/CProgram/ASTanalysis/CodexUserStudyData/raw_data/035a8eed-29c0-4606-814d-4cb786d0b9de/parts/gen_list_print.c", "C", 23, 0, 0, 0, 19, 5, 47
"/Users/sbukhari/Sandbox/CProgram/ASTanalysis/CodexUserStudyData/raw_data/035a8eed-29c0-4606-814d-4cb786d0b9de/parts/gen_list_remove_item_at_pos.c", "C", 35, 0, 0, 0, 10, 8, 53
"/Users/sbukhari/Sandbox/CProgram/ASTanalysis/CodexUserStudyData/raw_data/035a8eed-29c0-4606-814d-4cb786d0b9de/parts/gen_list_save.c", "C", 28, 0, 0, 0, 12, 10, 50
"/Users/sbukhari/Sandbox/CProgram/ASTanalysis/CodexUserStudyData/raw_data/035a8eed-29c0-4606-814d-4cb786d0b9de/parts/gen_list_swap_item_positions.c", "C", 50, 0, 0, 0, 7, 14, 71
"/Users/sbukhari/Sandbox/CProgram/ASTanalysis/CodexUserStudyData/raw_data/035a8eed-29c0-4606-814d-4cb786d0b9de/parts/gen_list_update_item_at_pos.c", "C", 28, 0, 0, 0, 9, 5, 42
"/Users/sbukhari/Sandbox/CProgram/ASTanalysis/CodexUserStudyData/raw_data/035a8eed-29c0-4606-814d-4cb786d0b9de/ref_testsuite.json", "JSON", 0, 323, 0, 0, 0, 1, 324
"/Users/sbukhari/Sandbox/CProgram/ASTanalysis/CodexUserStudyData/raw_data/035a8eed-29c0-4606-814d-4cb786d0b9de/ref_testsuite_asan.json", "JSON", 0, 323, 0, 0, 0, 1, 324
"/Users/sbukhari/Sandbox/CProgram/ASTanalysis/CodexUserStudyData/raw_data/035a8eed-29c0-4606-814d-4cb786d0b9de/ref_testsuite_asan_noleak.json", "JSON", 0, 323, 0, 0, 0, 1, 324
"/Users/sbukhari/Sandbox/CProgram/ASTanalysis/CodexUserStudyData/raw_data/0640be89-ee5f-4846-8e14-40fdc574d7d3/api_report.json", "JSON", 0, 14, 0, 0, 0, 1, 15
"/Users/sbukhari/Sandbox/CProgram/ASTanalysis/CodexUserStudyData/raw_data/0640be89-ee5f-4846-8e14-40fdc574d7d3/list.c", "C", 210, 0, 0, 0, 101, 59, 370
"/Users/sbukhari/Sandbox/CProgram/ASTanalysis/CodexUserStudyData/raw_data/0640be89-ee5f-4846-8e14-40fdc574d7d3/orig_testsuite.json", "JSON", 0, 92, 0, 0, 0, 1, 93
"/Users/sbukhari/Sandbox/CProgram/ASTanalysis/CodexUserStudyData/raw_data/0640be89-ee5f-4846-8e14-40fdc574d7d3/orig_testsuite_asan.json", "JSON", 0, 92, 0, 0, 0, 1, 93
"/Users/sbukhari/Sandbox/CProgram/ASTanalysis/CodexUserStudyData/raw_data/0640be89-ee5f-4846-8e14-40fdc574d7d3/orig_testsuite_asan_noleak.json", "JSON", 0, 92, 0, 0, 0, 1, 93
"/Users/sbukhari/Sandbox/CProgram/ASTanalysis/CodexUserStudyData/raw_data/0640be89-ee5f-4846-8e14-40fdc574d7d3/parts/gen_list_add_item_at_pos.c", "C", 45, 0, 0, 0, 24, 10, 79
"/Users/sbukhari/Sandbox/CProgram/ASTanalysis/CodexUserStudyData/raw_data/0640be89-ee5f-4846-8e14-40fdc574d7d3/parts/gen_list_cost_sum.c", "C", 25, 0, 0, 0, 10, 9, 44
"/Users/sbukhari/Sandbox/CProgram/ASTanalysis/CodexUserStudyData/raw_data/0640be89-ee5f-4846-8e14-40fdc574d7d3/parts/gen_list_deduplicate.c", "C", 18, 0, 0, 0, 10, 5, 33
"/Users/sbukhari/Sandbox/CProgram/ASTanalysis/CodexUserStudyData/raw_data/0640be89-ee5f-4846-8e14-40fdc574d7d3/parts/gen_list_find_highest_price_item_position.c", "C", 33, 0, 0, 0, 12, 10, 55
"/Users/sbukhari/Sandbox/CProgram/ASTanalysis/CodexUserStudyData/raw_data/0640be89-ee5f-4846-8e14-40fdc574d7d3/parts/gen_list_init.c", "C", 19, 0, 0, 0, 6, 6, 31
"/Users/sbukhari/Sandbox/CProgram/ASTanalysis/CodexUserStudyData/raw_data/0640be89-ee5f-4846-8e14-40fdc574d7d3/parts/gen_list_item_to_string.c", "C", 21, 0, 0, 0, 14, 5, 40
"/Users/sbukhari/Sandbox/CProgram/ASTanalysis/CodexUserStudyData/raw_data/0640be89-ee5f-4846-8e14-40fdc574d7d3/parts/gen_list_load.c", "C", 35, 0, 0, 0, 19, 7, 61
"/Users/sbukhari/Sandbox/CProgram/ASTanalysis/CodexUserStudyData/raw_data/0640be89-ee5f-4846-8e14-40fdc574d7d3/parts/gen_list_print.c", "C", 29, 0, 0, 0, 24, 8, 61
"/Users/sbukhari/Sandbox/CProgram/ASTanalysis/CodexUserStudyData/raw_data/0640be89-ee5f-4846-8e14-40fdc574d7d3/parts/gen_list_remove_item_at_pos.c", "C", 43, 0, 0, 0, 16, 9, 68
"/Users/sbukhari/Sandbox/CProgram/ASTanalysis/CodexUserStudyData/raw_data/0640be89-ee5f-4846-8e14-40fdc574d7d3/parts/gen_list_save.c", "C", 27, 0, 0, 0, 18, 11, 56
"/Users/sbukhari/Sandbox/CProgram/ASTanalysis/CodexUserStudyData/raw_data/0640be89-ee5f-4846-8e14-40fdc574d7d3/parts/gen_list_swap_item_positions.c", "C", 41, 0, 0, 0, 14, 10, 65
"/Users/sbukhari/Sandbox/CProgram/ASTanalysis/CodexUserStudyData/raw_data/0640be89-ee5f-4846-8e14-40fdc574d7d3/parts/gen_list_update_item_at_pos.c", "C", 29, 0, 0, 0, 15, 9, 53
"/Users/sbukhari/Sandbox/CProgram/ASTanalysis/CodexUserStudyData/raw_data/0640be89-ee5f-4846-8e14-40fdc574d7d3/ref_testsuite.json", "JSON", 0, 323, 0, 0, 0, 1, 324
"/Users/sbukhari/Sandbox/CProgram/ASTanalysis/CodexUserStudyData/raw_data/0640be89-ee5f-4846-8e14-40fdc574d7d3/ref_testsuite_asan.json", "JSON", 0, 323, 0, 0, 0, 1, 324
"/Users/sbukhari/Sandbox/CProgram/ASTanalysis/CodexUserStudyData/raw_data/0640be89-ee5f-4846-8e14-40fdc574d7d3/ref_testsuite_asan_noleak.json", "JSON", 0, 323, 0, 0, 0, 1, 324
"/Users/sbukhari/Sandbox/CProgram/ASTanalysis/CodexUserStudyData/raw_data/0ed7147a-475a-438b-8eee-c19d9d380739/api_report.json", "JSON", 0, 14, 0, 0, 0, 1, 15
"/Users/sbukhari/Sandbox/CProgram/ASTanalysis/CodexUserStudyData/raw_data/0ed7147a-475a-438b-8eee-c19d9d380739/list.c", "C", 137, 0, 0, 0, 72, 25, 234
"/Users/sbukhari/Sandbox/CProgram/ASTanalysis/CodexUserStudyData/raw_data/0ed7147a-475a-438b-8eee-c19d9d380739/orig_testsuite.json", "JSON", 0, 92, 0, 0, 0, 1, 93
"/Users/sbukhari/Sandbox/CProgram/ASTanalysis/CodexUserStudyData/raw_data/0ed7147a-475a-438b-8eee-c19d9d380739/orig_testsuite_asan.json", "JSON", 0, 92, 0, 0, 0, 1, 93
"/Users/sbukhari/Sandbox/CProgram/ASTanalysis/CodexUserStudyData/raw_data/0ed7147a-475a-438b-8eee-c19d9d380739/orig_testsuite_asan_noleak.json", "JSON", 0, 92, 0, 0, 0, 1, 93
"/Users/sbukhari/Sandbox/CProgram/ASTanalysis/CodexUserStudyData/raw_data/0ed7147a-475a-438b-8eee-c19d9d380739/parts/gen_list_add_item_at_pos.c", "C", 46, 0, 0, 0, 19, 10, 75
"/Users/sbukhari/Sandbox/CProgram/ASTanalysis/CodexUserStudyData/raw_data/0ed7147a-475a-438b-8eee-c19d9d380739/parts/gen_list_cost_sum.c", "C", 25, 0, 0, 0, 9, 5, 39
"/Users/sbukhari/Sandbox/CProgram/ASTanalysis/CodexUserStudyData/raw_data/0ed7147a-475a-438b-8eee-c19d9d380739/parts/gen_list_deduplicate.c", "C", 18, 0, 0, 0, 10, 5, 33
"/Users/sbukhari/Sandbox/CProgram/ASTanalysis/CodexUserStudyData/raw_data/0ed7147a-475a-438b-8eee-c19d9d380739/parts/gen_list_find_highest_price_item_position.c", "C", 29, 0, 0, 0, 10, 5, 44
"/Users/sbukhari/Sandbox/CProgram/ASTanalysis/CodexUserStudyData/raw_data/0ed7147a-475a-438b-8eee-c19d9d380739/parts/gen_list_init.c", "C", 19, 0, 0, 0, 6, 6, 31
"/Users/sbukhari/Sandbox/CProgram/ASTanalysis/CodexUserStudyData/raw_data/0ed7147a-475a-438b-8eee-c19d9d380739/parts/gen_list_item_to_string.c", "C", 20, 0, 0, 0, 11, 5, 36
"/Users/sbukhari/Sandbox/CProgram/ASTanalysis/CodexUserStudyData/raw_data/0ed7147a-475a-438b-8eee-c19d9d380739/parts/gen_list_load.c", "C", 18, 0, 0, 0, 12, 5, 35
"/Users/sbukhari/Sandbox/CProgram/ASTanalysis/CodexUserStudyData/raw_data/0ed7147a-475a-438b-8eee-c19d9d380739/parts/gen_list_print.c", "C", 27, 0, 0, 0, 22, 5, 54
"/Users/sbukhari/Sandbox/CProgram/ASTanalysis/CodexUserStudyData/raw_data/0ed7147a-475a-438b-8eee-c19d9d380739/parts/gen_list_remove_item_at_pos.c", "C", 18, 0, 0, 0, 8, 5, 31
"/Users/sbukhari/Sandbox/CProgram/ASTanalysis/CodexUserStudyData/raw_data/0ed7147a-475a-438b-8eee-c19d9d380739/parts/gen_list_save.c", "C", 18, 0, 0, 0, 11, 5, 34
"/Users/sbukhari/Sandbox/CProgram/ASTanalysis/CodexUserStudyData/raw_data/0ed7147a-475a-438b-8eee-c19d9d380739/parts/gen_list_swap_item_positions.c", "C", 17, 0, 0, 0, 8, 5, 30
"/Users/sbukhari/Sandbox/CProgram/ASTanalysis/CodexUserStudyData/raw_data/0ed7147a-475a-438b-8eee-c19d9d380739/parts/gen_list_update_item_at_pos.c", "C", 37, 0, 0, 0, 14, 8, 59
"/Users/sbukhari/Sandbox/CProgram/ASTanalysis/CodexUserStudyData/raw_data/0ed7147a-475a-438b-8eee-c19d9d380739/ref_testsuite.json", "JSON", 0, 323, 0, 0, 0, 1, 324
"/Users/sbukhari/Sandbox/CProgram/ASTanalysis/CodexUserStudyData/raw_data/0ed7147a-475a-438b-8eee-c19d9d380739/ref_testsuite_asan.json", "JSON", 0, 323, 0, 0, 0, 1, 324
"/Users/sbukhari/Sandbox/CProgram/ASTanalysis/CodexUserStudyData/raw_data/0ed7147a-475a-438b-8eee-c19d9d380739/ref_testsuite_asan_noleak.json", "JSON", 0, 323, 0, 0, 0, 1, 324
"/Users/sbukhari/Sandbox/CProgram/ASTanalysis/CodexUserStudyData/raw_data/1f1c4c51-758b-4b08-88e3-e919cb5eaeaf/api_report.json", "JSON", 0, 14, 0, 0, 0, 1, 15
"/Users/sbukhari/Sandbox/CProgram/ASTanalysis/CodexUserStudyData/raw_data/1f1c4c51-758b-4b08-88e3-e919cb5eaeaf/list.c", "C", 99, 0, 0, 0, 74, 26, 199
"/Users/sbukhari/Sandbox/CProgram/ASTanalysis/CodexUserStudyData/raw_data/1f1c4c51-758b-4b08-88e3-e919cb5eaeaf/orig_testsuite.json", "JSON", 0, 92, 0, 0, 0, 1, 93
"/Users/sbukhari/Sandbox/CProgram/ASTanalysis/CodexUserStudyData/raw_data/1f1c4c51-758b-4b08-88e3-e919cb5eaeaf/orig_testsuite_asan.json", "JSON", 0, 92, 0, 0, 0, 1, 93
"/Users/sbukhari/Sandbox/CProgram/ASTanalysis/CodexUserStudyData/raw_data/1f1c4c51-758b-4b08-88e3-e919cb5eaeaf/orig_testsuite_asan_noleak.json", "JSON", 0, 92, 0, 0, 0, 1, 93
"/Users/sbukhari/Sandbox/CProgram/ASTanalysis/CodexUserStudyData/raw_data/1f1c4c51-758b-4b08-88e3-e919cb5eaeaf/parts/gen_list_add_item_at_pos.c", "C", 44, 0, 0, 0, 22, 12, 78
"/Users/sbukhari/Sandbox/CProgram/ASTanalysis/CodexUserStudyData/raw_data/1f1c4c51-758b-4b08-88e3-e919cb5eaeaf/parts/gen_list_cost_sum.c", "C", 18, 0, 0, 0, 8, 5, 31
"/Users/sbukhari/Sandbox/CProgram/ASTanalysis/CodexUserStudyData/raw_data/1f1c4c51-758b-4b08-88e3-e919cb5eaeaf/parts/gen_list_deduplicate.c", "C", 18, 0, 0, 0, 10, 5, 33
"/Users/sbukhari/Sandbox/CProgram/ASTanalysis/CodexUserStudyData/raw_data/1f1c4c51-758b-4b08-88e3-e919cb5eaeaf/parts/gen_list_find_highest_price_item_position.c", "C", 18, 0, 0, 0, 8, 5, 31
"/Users/sbukhari/Sandbox/CProgram/ASTanalysis/CodexUserStudyData/raw_data/1f1c4c51-758b-4b08-88e3-e919cb5eaeaf/parts/gen_list_init.c", "C", 19, 0, 0, 0, 6, 6, 31
"/Users/sbukhari/Sandbox/CProgram/ASTanalysis/CodexUserStudyData/raw_data/1f1c4c51-758b-4b08-88e3-e919cb5eaeaf/parts/gen_list_item_to_string.c", "C", 22, 0, 0, 0, 14, 5, 41
"/Users/sbukhari/Sandbox/CProgram/ASTanalysis/CodexUserStudyData/raw_data/1f1c4c51-758b-4b08-88e3-e919cb5eaeaf/parts/gen_list_load.c", "C", 18, 0, 0, 0, 12, 5, 35
"/Users/sbukhari/Sandbox/CProgram/ASTanalysis/CodexUserStudyData/raw_data/1f1c4c51-758b-4b08-88e3-e919cb5eaeaf/parts/gen_list_print.c", "C", 26, 0, 0, 0, 21, 7, 54
"/Users/sbukhari/Sandbox/CProgram/ASTanalysis/CodexUserStudyData/raw_data/1f1c4c51-758b-4b08-88e3-e919cb5eaeaf/parts/gen_list_remove_item_at_pos.c", "C", 18, 0, 0, 0, 8, 5, 31
"/Users/sbukhari/Sandbox/CProgram/ASTanalysis/CodexUserStudyData/raw_data/1f1c4c51-758b-4b08-88e3-e919cb5eaeaf/parts/gen_list_save.c", "C", 18, 0, 0, 0, 11, 5, 34
"/Users/sbukhari/Sandbox/CProgram/ASTanalysis/CodexUserStudyData/raw_data/1f1c4c51-758b-4b08-88e3-e919cb5eaeaf/parts/gen_list_swap_item_positions.c", "C", 17, 0, 0, 0, 8, 5, 30
"/Users/sbukhari/Sandbox/CProgram/ASTanalysis/CodexUserStudyData/raw_data/1f1c4c51-758b-4b08-88e3-e919cb5eaeaf/parts/gen_list_update_item_at_pos.c", "C", 17, 0, 0, 0, 8, 5, 30
"/Users/sbukhari/Sandbox/CProgram/ASTanalysis/CodexUserStudyData/raw_data/1f1c4c51-758b-4b08-88e3-e919cb5eaeaf/ref_testsuite.json", "JSON", 0, 323, 0, 0, 0, 1, 324
"/Users/sbukhari/Sandbox/CProgram/ASTanalysis/CodexUserStudyData/raw_data/1f1c4c51-758b-4b08-88e3-e919cb5eaeaf/ref_testsuite_asan.json", "JSON", 0, 323, 0, 0, 0, 1, 324
"/Users/sbukhari/Sandbox/CProgram/ASTanalysis/CodexUserStudyData/raw_data/1f1c4c51-758b-4b08-88e3-e919cb5eaeaf/ref_testsuite_asan_noleak.json", "JSON", 0, 323, 0, 0, 0, 1, 324
"/Users/sbukhari/Sandbox/CProgram/ASTanalysis/CodexUserStudyData/raw_data/1f53c71a-e1b9-4b65-a11e-c15f3c38a6cf/api_report.json", "JSON", 0, 14, 0, 0, 0, 1, 15
"/Users/sbukhari/Sandbox/CProgram/ASTanalysis/CodexUserStudyData/raw_data/1f53c71a-e1b9-4b65-a11e-c15f3c38a6cf/list.c", "C", 246, 0, 0, 0, 113, 87, 446
"/Users/sbukhari/Sandbox/CProgram/ASTanalysis/CodexUserStudyData/raw_data/1f53c71a-e1b9-4b65-a11e-c15f3c38a6cf/orig_testsuite.json", "JSON", 0, 92, 0, 0, 0, 1, 93
"/Users/sbukhari/Sandbox/CProgram/ASTanalysis/CodexUserStudyData/raw_data/1f53c71a-e1b9-4b65-a11e-c15f3c38a6cf/orig_testsuite_asan.json", "JSON", 0, 92, 0, 0, 0, 1, 93
"/Users/sbukhari/Sandbox/CProgram/ASTanalysis/CodexUserStudyData/raw_data/1f53c71a-e1b9-4b65-a11e-c15f3c38a6cf/orig_testsuite_asan_noleak.json", "JSON", 0, 92, 0, 0, 0, 1, 93
"/Users/sbukhari/Sandbox/CProgram/ASTanalysis/CodexUserStudyData/raw_data/1f53c71a-e1b9-4b65-a11e-c15f3c38a6cf/parts/gen_list_add_item_at_pos.c", "C", 43, 0, 0, 0, 26, 14, 83
"/Users/sbukhari/Sandbox/CProgram/ASTanalysis/CodexUserStudyData/raw_data/1f53c71a-e1b9-4b65-a11e-c15f3c38a6cf/parts/gen_list_cost_sum.c", "C", 25, 0, 0, 0, 11, 9, 45
"/Users/sbukhari/Sandbox/CProgram/ASTanalysis/CodexUserStudyData/raw_data/1f53c71a-e1b9-4b65-a11e-c15f3c38a6cf/parts/gen_list_deduplicate.c", "C", 40, 0, 0, 0, 16, 13, 69
"/Users/sbukhari/Sandbox/CProgram/ASTanalysis/CodexUserStudyData/raw_data/1f53c71a-e1b9-4b65-a11e-c15f3c38a6cf/parts/gen_list_find_highest_price_item_position.c", "C", 33, 0, 0, 0, 13, 10, 56
"/Users/sbukhari/Sandbox/CProgram/ASTanalysis/CodexUserStudyData/raw_data/1f53c71a-e1b9-4b65-a11e-c15f3c38a6cf/parts/gen_list_init.c", "C", 19, 0, 0, 0, 6, 6, 31
"/Users/sbukhari/Sandbox/CProgram/ASTanalysis/CodexUserStudyData/raw_data/1f53c71a-e1b9-4b65-a11e-c15f3c38a6cf/parts/gen_list_item_to_string.c", "C", 24, 0, 0, 0, 16, 8, 48
"/Users/sbukhari/Sandbox/CProgram/ASTanalysis/CodexUserStudyData/raw_data/1f53c71a-e1b9-4b65-a11e-c15f3c38a6cf/parts/gen_list_load.c", "C", 39, 0, 0, 0, 21, 13, 73
"/Users/sbukhari/Sandbox/CProgram/ASTanalysis/CodexUserStudyData/raw_data/1f53c71a-e1b9-4b65-a11e-c15f3c38a6cf/parts/gen_list_print.c", "C", 29, 0, 0, 0, 21, 8, 58
"/Users/sbukhari/Sandbox/CProgram/ASTanalysis/CodexUserStudyData/raw_data/1f53c71a-e1b9-4b65-a11e-c15f3c38a6cf/parts/gen_list_remove_item_at_pos.c", "C", 39, 0, 0, 0, 14, 14, 67
"/Users/sbukhari/Sandbox/CProgram/ASTanalysis/CodexUserStudyData/raw_data/1f53c71a-e1b9-4b65-a11e-c15f3c38a6cf/parts/gen_list_save.c", "C", 29, 0, 0, 0, 17, 10, 56
"/Users/sbukhari/Sandbox/CProgram/ASTanalysis/CodexUserStudyData/raw_data/1f53c71a-e1b9-4b65-a11e-c15f3c38a6cf/parts/gen_list_swap_item_positions.c", "C", 47, 0, 0, 0, 13, 16, 76
"/Users/sbukhari/Sandbox/CProgram/ASTanalysis/CodexUserStudyData/raw_data/1f53c71a-e1b9-4b65-a11e-c15f3c38a6cf/parts/gen_list_update_item_at_pos.c", "C", 34, 0, 0, 0, 13, 11, 58
"/Users/sbukhari/Sandbox/CProgram/ASTanalysis/CodexUserStudyData/raw_data/1f53c71a-e1b9-4b65-a11e-c15f3c38a6cf/ref_testsuite.json", "JSON", 0, 323, 0, 0, 0, 1, 324
"/Users/sbukhari/Sandbox/CProgram/ASTanalysis/CodexUserStudyData/raw_data/1f53c71a-e1b9-4b65-a11e-c15f3c38a6cf/ref_testsuite_asan.json", "JSON", 0, 323, 0, 0, 0, 1, 324
"/Users/sbukhari/Sandbox/CProgram/ASTanalysis/CodexUserStudyData/raw_data/1f53c71a-e1b9-4b65-a11e-c15f3c38a6cf/ref_testsuite_asan_noleak.json", "JSON", 0, 323, 0, 0, 0, 1, 324
"/Users/sbukhari/Sandbox/CProgram/ASTanalysis/CodexUserStudyData/raw_data/212591de-3007-4e4d-a0df-67d22d6c5f91/api_report.json", "JSON", 0, 14, 0, 0, 0, 1, 15
"/Users/sbukhari/Sandbox/CProgram/ASTanalysis/CodexUserStudyData/raw_data/212591de-3007-4e4d-a0df-67d22d6c5f91/list.c", "C", 183, 0, 0, 0, 73, 22, 278
"/Users/sbukhari/Sandbox/CProgram/ASTanalysis/CodexUserStudyData/raw_data/212591de-3007-4e4d-a0df-67d22d6c5f91/orig_testsuite.json", "JSON", 0, 92, 0, 0, 0, 1, 93
"/Users/sbukhari/Sandbox/CProgram/ASTanalysis/CodexUserStudyData/raw_data/212591de-3007-4e4d-a0df-67d22d6c5f91/orig_testsuite_asan.json", "JSON", 0, 92, 0, 0, 0, 1, 93
"/Users/sbukhari/Sandbox/CProgram/ASTanalysis/CodexUserStudyData/raw_data/212591de-3007-4e4d-a0df-67d22d6c5f91/orig_testsuite_asan_noleak.json", "JSON", 0, 92, 0, 0, 0, 1, 93
"/Users/sbukhari/Sandbox/CProgram/ASTanalysis/CodexUserStudyData/raw_data/212591de-3007-4e4d-a0df-67d22d6c5f91/parts/gen_list_add_item_at_pos.c", "C", 56, 0, 0, 0, 28, 20, 104
"/Users/sbukhari/Sandbox/CProgram/ASTanalysis/CodexUserStudyData/raw_data/212591de-3007-4e4d-a0df-67d22d6c5f91/parts/gen_list_cost_sum.c", "C", 18, 0, 0, 0, 8, 5, 31
"/Users/sbukhari/Sandbox/CProgram/ASTanalysis/CodexUserStudyData/raw_data/212591de-3007-4e4d-a0df-67d22d6c5f91/parts/gen_list_deduplicate.c", "C", 18, 0, 0, 0, 10, 5, 33
"/Users/sbukhari/Sandbox/CProgram/ASTanalysis/CodexUserStudyData/raw_data/212591de-3007-4e4d-a0df-67d22d6c5f91/parts/gen_list_find_highest_price_item_position.c", "C", 32, 0, 0, 0, 7, 5, 44
"/Users/sbukhari/Sandbox/CProgram/ASTanalysis/CodexUserStudyData/raw_data/212591de-3007-4e4d-a0df-67d22d6c5f91/parts/gen_list_init.c", "C", 19, 0, 0, 0, 6, 5, 30
"/Users/sbukhari/Sandbox/CProgram/ASTanalysis/CodexUserStudyData/raw_data/212591de-3007-4e4d-a0df-67d22d6c5f91/parts/gen_list_item_to_string.c", "C", 20, 0, 0, 0, 14, 6, 40
"/Users/sbukhari/Sandbox/CProgram/ASTanalysis/CodexUserStudyData/raw_data/212591de-3007-4e4d-a0df-67d22d6c5f91/parts/gen_list_load.c", "C", 18, 0, 0, 0, 12, 5, 35
"/Users/sbukhari/Sandbox/CProgram/ASTanalysis/CodexUserStudyData/raw_data/212591de-3007-4e4d-a0df-67d22d6c5f91/parts/gen_list_print.c", "C", 17, 0, 0, 0, 20, 5, 42
"/Users/sbukhari/Sandbox/CProgram/ASTanalysis/CodexUserStudyData/raw_data/212591de-3007-4e4d-a0df-67d22d6c5f91/parts/gen_list_remove_item_at_pos.c", "C", 40, 0, 0, 0, 10, 7, 57
"/Users/sbukhari/Sandbox/CProgram/ASTanalysis/CodexUserStudyData/raw_data/212591de-3007-4e4d-a0df-67d22d6c5f91/parts/gen_list_save.c", "C", 30, 0, 0, 0, 12, 5, 47
"/Users/sbukhari/Sandbox/CProgram/ASTanalysis/CodexUserStudyData/raw_data/212591de-3007-4e4d-a0df-67d22d6c5f91/parts/gen_list_swap_item_positions.c", "C", 55, 0, 0, 0, 10, 6, 71
"/Users/sbukhari/Sandbox/CProgram/ASTanalysis/CodexUserStudyData/raw_data/212591de-3007-4e4d-a0df-67d22d6c5f91/parts/gen_list_update_item_at_pos.c", "C", 33, 0, 0, 0, 9, 5, 47
"/Users/sbukhari/Sandbox/CProgram/ASTanalysis/CodexUserStudyData/raw_data/212591de-3007-4e4d-a0df-67d22d6c5f91/ref_testsuite.json", "JSON", 0, 323, 0, 0, 0, 1, 324
"/Users/sbukhari/Sandbox/CProgram/ASTanalysis/CodexUserStudyData/raw_data/212591de-3007-4e4d-a0df-67d22d6c5f91/ref_testsuite_asan.json", "JSON", 0, 323, 0, 0, 0, 1, 324
"/Users/sbukhari/Sandbox/CProgram/ASTanalysis/CodexUserStudyData/raw_data/212591de-3007-4e4d-a0df-67d22d6c5f91/ref_testsuite_asan_noleak.json", "JSON", 0, 323, 0, 0, 0, 1, 324
"/Users/sbukhari/Sandbox/CProgram/ASTanalysis/CodexUserStudyData/raw_data/21cb2508-2c4a-468d-a771-002ba7e0f211/api_report.json", "JSON", 0, 14, 0, 0, 0, 1, 15
"/Users/sbukhari/Sandbox/CProgram/ASTanalysis/CodexUserStudyData/raw_data/21cb2508-2c4a-468d-a771-002ba7e0f211/list.c", "C", 63, 0, 0, 0, 74, 17, 154
"/Users/sbukhari/Sandbox/CProgram/ASTanalysis/CodexUserStudyData/raw_data/21cb2508-2c4a-468d-a771-002ba7e0f211/orig_testsuite.json", "JSON", 0, 92, 0, 0, 0, 1, 93
"/Users/sbukhari/Sandbox/CProgram/ASTanalysis/CodexUserStudyData/raw_data/21cb2508-2c4a-468d-a771-002ba7e0f211/orig_testsuite_asan.json", "JSON", 0, 92, 0, 0, 0, 1, 93
"/Users/sbukhari/Sandbox/CProgram/ASTanalysis/CodexUserStudyData/raw_data/21cb2508-2c4a-468d-a771-002ba7e0f211/orig_testsuite_asan_noleak.json", "JSON", 0, 92, 0, 0, 0, 1, 93
"/Users/sbukhari/Sandbox/CProgram/ASTanalysis/CodexUserStudyData/raw_data/21cb2508-2c4a-468d-a771-002ba7e0f211/parts/gen_list_add_item_at_pos.c", "C", 18, 0, 0, 0, 18, 5, 41
"/Users/sbukhari/Sandbox/CProgram/ASTanalysis/CodexUserStudyData/raw_data/21cb2508-2c4a-468d-a771-002ba7e0f211/parts/gen_list_cost_sum.c", "C", 18, 0, 0, 0, 8, 5, 31
"/Users/sbukhari/Sandbox/CProgram/ASTanalysis/CodexUserStudyData/raw_data/21cb2508-2c4a-468d-a771-002ba7e0f211/parts/gen_list_deduplicate.c", "C", 18, 0, 0, 0, 10, 5, 33
"/Users/sbukhari/Sandbox/CProgram/ASTanalysis/CodexUserStudyData/raw_data/21cb2508-2c4a-468d-a771-002ba7e0f211/parts/gen_list_find_highest_price_item_position.c", "C", 18, 0, 0, 0, 8, 5, 31
"/Users/sbukhari/Sandbox/CProgram/ASTanalysis/CodexUserStudyData/raw_data/21cb2508-2c4a-468d-a771-002ba7e0f211/parts/gen_list_init.c", "C", 19, 0, 0, 0, 6, 6, 31
"/Users/sbukhari/Sandbox/CProgram/ASTanalysis/CodexUserStudyData/raw_data/21cb2508-2c4a-468d-a771-002ba7e0f211/parts/gen_list_item_to_string.c", "C", 17, 0, 0, 0, 11, 5, 33
"/Users/sbukhari/Sandbox/CProgram/ASTanalysis/CodexUserStudyData/raw_data/21cb2508-2c4a-468d-a771-002ba7e0f211/parts/gen_list_load.c", "C", 18, 0, 0, 0, 12, 5, 35
"/Users/sbukhari/Sandbox/CProgram/ASTanalysis/CodexUserStudyData/raw_data/21cb2508-2c4a-468d-a771-002ba7e0f211/parts/gen_list_print.c", "C", 22, 0, 0, 0, 21, 5, 48
"/Users/sbukhari/Sandbox/CProgram/ASTanalysis/CodexUserStudyData/raw_data/21cb2508-2c4a-468d-a771-002ba7e0f211/parts/gen_list_remove_item_at_pos.c", "C", 18, 0, 0, 0, 8, 5, 31
"/Users/sbukhari/Sandbox/CProgram/ASTanalysis/CodexUserStudyData/raw_data/21cb2508-2c4a-468d-a771-002ba7e0f211/parts/gen_list_save.c", "C", 18, 0, 0, 0, 11, 5, 34
"/Users/sbukhari/Sandbox/CProgram/ASTanalysis/CodexUserStudyData/raw_data/21cb2508-2c4a-468d-a771-002ba7e0f211/parts/gen_list_swap_item_positions.c", "C", 17, 0, 0, 0, 8, 5, 30
"/Users/sbukhari/Sandbox/CProgram/ASTanalysis/CodexUserStudyData/raw_data/21cb2508-2c4a-468d-a771-002ba7e0f211/parts/gen_list_update_item_at_pos.c", "C", 17, 0, 0, 0, 8, 5, 30
"/Users/sbukhari/Sandbox/CProgram/ASTanalysis/CodexUserStudyData/raw_data/21cb2508-2c4a-468d-a771-002ba7e0f211/ref_testsuite.json", "JSON", 0, 323, 0, 0, 0, 1, 324
"/Users/sbukhari/Sandbox/CProgram/ASTanalysis/CodexUserStudyData/raw_data/21cb2508-2c4a-468d-a771-002ba7e0f211/ref_testsuite_asan.json", "JSON", 0, 323, 0, 0, 0, 1, 324
"/Users/sbukhari/Sandbox/CProgram/ASTanalysis/CodexUserStudyData/raw_data/21cb2508-2c4a-468d-a771-002ba7e0f211/ref_testsuite_asan_noleak.json", "JSON", 0, 323, 0, 0, 0, 1, 324
"/Users/sbukhari/Sandbox/CProgram/ASTanalysis/CodexUserStudyData/raw_data/26a41023-c10e-41cc-b9e1-8103dc46f264/api_report.json", "JSON", 0, 14, 0, 0, 0, 1, 15
"/Users/sbukhari/Sandbox/CProgram/ASTanalysis/CodexUserStudyData/raw_data/26a41023-c10e-41cc-b9e1-8103dc46f264/list.c", "C", 233, 0, 0, 0, 71, 37, 341
"/Users/sbukhari/Sandbox/CProgram/ASTanalysis/CodexUserStudyData/raw_data/26a41023-c10e-41cc-b9e1-8103dc46f264/orig_testsuite.json", "JSON", 0, 92, 0, 0, 0, 1, 93
"/Users/sbukhari/Sandbox/CProgram/ASTanalysis/CodexUserStudyData/raw_data/26a41023-c10e-41cc-b9e1-8103dc46f264/orig_testsuite_asan.json", "JSON", 0, 92, 0, 0, 0, 1, 93
"/Users/sbukhari/Sandbox/CProgram/ASTanalysis/CodexUserStudyData/raw_data/26a41023-c10e-41cc-b9e1-8103dc46f264/orig_testsuite_asan_noleak.json", "JSON", 0, 92, 0, 0, 0, 1, 93
"/Users/sbukhari/Sandbox/CProgram/ASTanalysis/CodexUserStudyData/raw_data/26a41023-c10e-41cc-b9e1-8103dc46f264/parts/gen_list_add_item_at_pos.c", "C", 40, 0, 0, 0, 17, 10, 67
"/Users/sbukhari/Sandbox/CProgram/ASTanalysis/CodexUserStudyData/raw_data/26a41023-c10e-41cc-b9e1-8103dc46f264/parts/gen_list_cost_sum.c", "C", 23, 0, 0, 0, 9, 5, 37
"/Users/sbukhari/Sandbox/CProgram/ASTanalysis/CodexUserStudyData/raw_data/26a41023-c10e-41cc-b9e1-8103dc46f264/parts/gen_list_deduplicate.c", "C", 36, 0, 0, 0, 11, 5, 52
"/Users/sbukhari/Sandbox/CProgram/ASTanalysis/CodexUserStudyData/raw_data/26a41023-c10e-41cc-b9e1-8103dc46f264/parts/gen_list_find_highest_price_item_position.c", "C", 26, 0, 0, 0, 10, 5, 41
"/Users/sbukhari/Sandbox/CProgram/ASTanalysis/CodexUserStudyData/raw_data/26a41023-c10e-41cc-b9e1-8103dc46f264/parts/gen_list_init.c", "C", 20, 0, 0, 0, 6, 6, 32
"/Users/sbukhari/Sandbox/CProgram/ASTanalysis/CodexUserStudyData/raw_data/26a41023-c10e-41cc-b9e1-8103dc46f264/parts/gen_list_item_to_string.c", "C", 21, 0, 0, 0, 14, 6, 41
"/Users/sbukhari/Sandbox/CProgram/ASTanalysis/CodexUserStudyData/raw_data/26a41023-c10e-41cc-b9e1-8103dc46f264/parts/gen_list_load.c", "C", 46, 0, 0, 0, 17, 5, 68
"/Users/sbukhari/Sandbox/CProgram/ASTanalysis/CodexUserStudyData/raw_data/26a41023-c10e-41cc-b9e1-8103dc46f264/parts/gen_list_print.c", "C", 24, 0, 0, 0, 23, 5, 52
"/Users/sbukhari/Sandbox/CProgram/ASTanalysis/CodexUserStudyData/raw_data/26a41023-c10e-41cc-b9e1-8103dc46f264/parts/gen_list_remove_item_at_pos.c", "C", 34, 0, 0, 0, 10, 9, 53
"/Users/sbukhari/Sandbox/CProgram/ASTanalysis/CodexUserStudyData/raw_data/26a41023-c10e-41cc-b9e1-8103dc46f264/parts/gen_list_save.c", "C", 27, 0, 0, 0, 12, 5, 44
"/Users/sbukhari/Sandbox/CProgram/ASTanalysis/CodexUserStudyData/raw_data/26a41023-c10e-41cc-b9e1-8103dc46f264/parts/gen_list_swap_item_positions.c", "C", 60, 0, 0, 0, 11, 9, 80
"/Users/sbukhari/Sandbox/CProgram/ASTanalysis/CodexUserStudyData/raw_data/26a41023-c10e-41cc-b9e1-8103dc46f264/parts/gen_list_update_item_at_pos.c", "C", 31, 0, 0, 0, 9, 8, 48
"/Users/sbukhari/Sandbox/CProgram/ASTanalysis/CodexUserStudyData/raw_data/26a41023-c10e-41cc-b9e1-8103dc46f264/ref_testsuite.json", "JSON", 0, 323, 0, 0, 0, 1, 324
"/Users/sbukhari/Sandbox/CProgram/ASTanalysis/CodexUserStudyData/raw_data/26a41023-c10e-41cc-b9e1-8103dc46f264/ref_testsuite_asan.json", "JSON", 0, 323, 0, 0, 0, 1, 324
"/Users/sbukhari/Sandbox/CProgram/ASTanalysis/CodexUserStudyData/raw_data/26a41023-c10e-41cc-b9e1-8103dc46f264/ref_testsuite_asan_noleak.json", "JSON", 0, 323, 0, 0, 0, 1, 324
"/Users/sbukhari/Sandbox/CProgram/ASTanalysis/CodexUserStudyData/raw_data/275f0df3-1f22-43e1-b37c-147169908268/api_report.json", "JSON", 0, 14, 0, 0, 0, 1, 15
"/Users/sbukhari/Sandbox/CProgram/ASTanalysis/CodexUserStudyData/raw_data/275f0df3-1f22-43e1-b37c-147169908268/list.c", "C", 120, 0, 0, 0, 40, 17, 177
"/Users/sbukhari/Sandbox/CProgram/ASTanalysis/CodexUserStudyData/raw_data/275f0df3-1f22-43e1-b37c-147169908268/orig_testsuite.json", "JSON", 0, 92, 0, 0, 0, 1, 93
"/Users/sbukhari/Sandbox/CProgram/ASTanalysis/CodexUserStudyData/raw_data/275f0df3-1f22-43e1-b37c-147169908268/orig_testsuite_asan.json", "JSON", 0, 92, 0, 0, 0, 1, 93
"/Users/sbukhari/Sandbox/CProgram/ASTanalysis/CodexUserStudyData/raw_data/275f0df3-1f22-43e1-b37c-147169908268/orig_testsuite_asan_noleak.json", "JSON", 0, 92, 0, 0, 0, 1, 93
"/Users/sbukhari/Sandbox/CProgram/ASTanalysis/CodexUserStudyData/raw_data/275f0df3-1f22-43e1-b37c-147169908268/parts/gen_list_add_item_at_pos.c", "C", 18, 0, 0, 0, 18, 5, 41
"/Users/sbukhari/Sandbox/CProgram/ASTanalysis/CodexUserStudyData/raw_data/275f0df3-1f22-43e1-b37c-147169908268/parts/gen_list_cost_sum.c", "C", 18, 0, 0, 0, 8, 5, 31
"/Users/sbukhari/Sandbox/CProgram/ASTanalysis/CodexUserStudyData/raw_data/275f0df3-1f22-43e1-b37c-147169908268/parts/gen_list_deduplicate.c", "C", 18, 0, 0, 0, 10, 5, 33
"/Users/sbukhari/Sandbox/CProgram/ASTanalysis/CodexUserStudyData/raw_data/275f0df3-1f22-43e1-b37c-147169908268/parts/gen_list_find_highest_price_item_position.c", "C", 29, 0, 0, 0, 9, 5, 43
"/Users/sbukhari/Sandbox/CProgram/ASTanalysis/CodexUserStudyData/raw_data/275f0df3-1f22-43e1-b37c-147169908268/parts/gen_list_init.c", "C", 19, 0, 0, 0, 6, 6, 31
"/Users/sbukhari/Sandbox/CProgram/ASTanalysis/CodexUserStudyData/raw_data/275f0df3-1f22-43e1-b37c-147169908268/parts/gen_list_item_to_string.c", "C", 18, 0, 0, 0, 11, 5, 34
"/Users/sbukhari/Sandbox/CProgram/ASTanalysis/CodexUserStudyData/raw_data/275f0df3-1f22-43e1-b37c-147169908268/parts/gen_list_load.c", "C", 18, 0, 0, 0, 12, 5, 35
"/Users/sbukhari/Sandbox/CProgram/ASTanalysis/CodexUserStudyData/raw_data/275f0df3-1f22-43e1-b37c-147169908268/parts/gen_list_print.c", "C", 26, 0, 0, 0, 22, 5, 53
"/Users/sbukhari/Sandbox/CProgram/ASTanalysis/CodexUserStudyData/raw_data/275f0df3-1f22-43e1-b37c-147169908268/parts/gen_list_remove_item_at_pos.c", "C", 18, 0, 0, 0, 8, 5, 31
"/Users/sbukhari/Sandbox/CProgram/ASTanalysis/CodexUserStudyData/raw_data/275f0df3-1f22-43e1-b37c-147169908268/parts/gen_list_save.c", "C", 18, 0, 0, 0, 11, 5, 34
"/Users/sbukhari/Sandbox/CProgram/ASTanalysis/CodexUserStudyData/raw_data/275f0df3-1f22-43e1-b37c-147169908268/parts/gen_list_swap_item_positions.c", "C", 34, 0, 0, 0, 9, 7, 50
"/Users/sbukhari/Sandbox/CProgram/ASTanalysis/CodexUserStudyData/raw_data/275f0df3-1f22-43e1-b37c-147169908268/parts/gen_list_update_item_at_pos.c", "C", 17, 0, 0, 0, 8, 5, 30
"/Users/sbukhari/Sandbox/CProgram/ASTanalysis/CodexUserStudyData/raw_data/275f0df3-1f22-43e1-b37c-147169908268/ref_testsuite.json", "JSON", 0, 323, 0, 0, 0, 1, 324
"/Users/sbukhari/Sandbox/CProgram/ASTanalysis/CodexUserStudyData/raw_data/275f0df3-1f22-43e1-b37c-147169908268/ref_testsuite_asan.json", "JSON", 0, 323, 0, 0, 0, 1, 324
"/Users/sbukhari/Sandbox/CProgram/ASTanalysis/CodexUserStudyData/raw_data/275f0df3-1f22-43e1-b37c-147169908268/ref_testsuite_asan_noleak.json", "JSON", 0, 323, 0, 0, 0, 1, 324
"/Users/sbukhari/Sandbox/CProgram/ASTanalysis/CodexUserStudyData/raw_data/32999001-1b8b-40d0-8776-0dc7fbd264ac/api_report.json", "JSON", 0, 14, 0, 0, 0, 1, 15
"/Users/sbukhari/Sandbox/CProgram/ASTanalysis/CodexUserStudyData/raw_data/32999001-1b8b-40d0-8776-0dc7fbd264ac/list.c", "C", 202, 0, 0, 0, 69, 36, 307
"/Users/sbukhari/Sandbox/CProgram/ASTanalysis/CodexUserStudyData/raw_data/32999001-1b8b-40d0-8776-0dc7fbd264ac/orig_testsuite.json", "JSON", 0, 92, 0, 0, 0, 1, 93
"/Users/sbukhari/Sandbox/CProgram/ASTanalysis/CodexUserStudyData/raw_data/32999001-1b8b-40d0-8776-0dc7fbd264ac/orig_testsuite_asan.json", "JSON", 0, 92, 0, 0, 0, 1, 93
"/Users/sbukhari/Sandbox/CProgram/ASTanalysis/CodexUserStudyData/raw_data/32999001-1b8b-40d0-8776-0dc7fbd264ac/orig_testsuite_asan_noleak.json", "JSON", 0, 92, 0, 0, 0, 1, 93
"/Users/sbukhari/Sandbox/CProgram/ASTanalysis/CodexUserStudyData/raw_data/32999001-1b8b-40d0-8776-0dc7fbd264ac/parts/gen_list_add_item_at_pos.c", "C", 18, 0, 0, 0, 18, 5, 41
"/Users/sbukhari/Sandbox/CProgram/ASTanalysis/CodexUserStudyData/raw_data/32999001-1b8b-40d0-8776-0dc7fbd264ac/parts/gen_list_cost_sum.c", "C", 18, 0, 0, 0, 8, 5, 31
"/Users/sbukhari/Sandbox/CProgram/ASTanalysis/CodexUserStudyData/raw_data/32999001-1b8b-40d0-8776-0dc7fbd264ac/parts/gen_list_deduplicate.c", "C", 18, 0, 0, 0, 10, 5, 33
"/Users/sbukhari/Sandbox/CProgram/ASTanalysis/CodexUserStudyData/raw_data/32999001-1b8b-40d0-8776-0dc7fbd264ac/parts/gen_list_find_highest_price_item_position.c", "C", 18, 0, 0, 0, 8, 5, 31
"/Users/sbukhari/Sandbox/CProgram/ASTanalysis/CodexUserStudyData/raw_data/32999001-1b8b-40d0-8776-0dc7fbd264ac/parts/gen_list_init.c", "C", 19, 0, 0, 0, 6, 6, 31
"/Users/sbukhari/Sandbox/CProgram/ASTanalysis/CodexUserStudyData/raw_data/32999001-1b8b-40d0-8776-0dc7fbd264ac/parts/gen_list_item_to_string.c", "C", 17, 0, 0, 0, 11, 5, 33
"/Users/sbukhari/Sandbox/CProgram/ASTanalysis/CodexUserStudyData/raw_data/32999001-1b8b-40d0-8776-0dc7fbd264ac/parts/gen_list_load.c", "C", 18, 0, 0, 0, 12, 5, 35
"/Users/sbukhari/Sandbox/CProgram/ASTanalysis/CodexUserStudyData/raw_data/32999001-1b8b-40d0-8776-0dc7fbd264ac/parts/gen_list_print.c", "C", 17, 0, 0, 0, 20, 5, 42
"/Users/sbukhari/Sandbox/CProgram/ASTanalysis/CodexUserStudyData/raw_data/32999001-1b8b-40d0-8776-0dc7fbd264ac/parts/gen_list_remove_item_at_pos.c", "C", 18, 0, 0, 0, 8, 5, 31
"/Users/sbukhari/Sandbox/CProgram/ASTanalysis/CodexUserStudyData/raw_data/32999001-1b8b-40d0-8776-0dc7fbd264ac/parts/gen_list_save.c", "C", 19, 0, 0, 0, 9, 5, 33
"/Users/sbukhari/Sandbox/CProgram/ASTanalysis/CodexUserStudyData/raw_data/32999001-1b8b-40d0-8776-0dc7fbd264ac/parts/gen_list_swap_item_positions.c", "C", 17, 0, 0, 0, 8, 5, 30
"/Users/sbukhari/Sandbox/CProgram/ASTanalysis/CodexUserStudyData/raw_data/32999001-1b8b-40d0-8776-0dc7fbd264ac/parts/gen_list_update_item_at_pos.c", "C", 17, 0, 0, 0, 8, 5, 30
"/Users/sbukhari/Sandbox/CProgram/ASTanalysis/CodexUserStudyData/raw_data/32999001-1b8b-40d0-8776-0dc7fbd264ac/ref_testsuite.json", "JSON", 0, 323, 0, 0, 0, 1, 324
"/Users/sbukhari/Sandbox/CProgram/ASTanalysis/CodexUserStudyData/raw_data/32999001-1b8b-40d0-8776-0dc7fbd264ac/ref_testsuite_asan.json", "JSON", 0, 323, 0, 0, 0, 1, 324
"/Users/sbukhari/Sandbox/CProgram/ASTanalysis/CodexUserStudyData/raw_data/32999001-1b8b-40d0-8776-0dc7fbd264ac/ref_testsuite_asan_noleak.json", "JSON", 0, 323, 0, 0, 0, 1, 324
"/Users/sbukhari/Sandbox/CProgram/ASTanalysis/CodexUserStudyData/raw_data/3533dacf-349b-4581-bc32-6b9f015199c1/api_report.json", "JSON", 0, 14, 0, 0, 0, 1, 15
"/Users/sbukhari/Sandbox/CProgram/ASTanalysis/CodexUserStudyData/raw_data/3533dacf-349b-4581-bc32-6b9f015199c1/list.c", "C", 287, 0, 0, 0, 60, 47, 394
"/Users/sbukhari/Sandbox/CProgram/ASTanalysis/CodexUserStudyData/raw_data/3533dacf-349b-4581-bc32-6b9f015199c1/orig_testsuite.json", "JSON", 0, 92, 0, 0, 0, 1, 93
"/Users/sbukhari/Sandbox/CProgram/ASTanalysis/CodexUserStudyData/raw_data/3533dacf-349b-4581-bc32-6b9f015199c1/orig_testsuite_asan.json", "JSON", 0, 92, 0, 0, 0, 1, 93
"/Users/sbukhari/Sandbox/CProgram/ASTanalysis/CodexUserStudyData/raw_data/3533dacf-349b-4581-bc32-6b9f015199c1/orig_testsuite_asan_noleak.json", "JSON", 0, 92, 0, 0, 0, 1, 93
"/Users/sbukhari/Sandbox/CProgram/ASTanalysis/CodexUserStudyData/raw_data/3533dacf-349b-4581-bc32-6b9f015199c1/parts/gen_list_add_item_at_pos.c", "C", 43, 0, 0, 0, 22, 9, 74
"/Users/sbukhari/Sandbox/CProgram/ASTanalysis/CodexUserStudyData/raw_data/3533dacf-349b-4581-bc32-6b9f015199c1/parts/gen_list_cost_sum.c", "C", 26, 0, 0, 0, 7, 6, 39
"/Users/sbukhari/Sandbox/CProgram/ASTanalysis/CodexUserStudyData/raw_data/3533dacf-349b-4581-bc32-6b9f015199c1/parts/gen_list_deduplicate.c", "C", 44, 0, 0, 0, 12, 8, 64
"/Users/sbukhari/Sandbox/CProgram/ASTanalysis/CodexUserStudyData/raw_data/3533dacf-349b-4581-bc32-6b9f015199c1/parts/gen_list_find_highest_price_item_position.c", "C", 32, 0, 0, 0, 8, 6, 46
"/Users/sbukhari/Sandbox/CProgram/ASTanalysis/CodexUserStudyData/raw_data/3533dacf-349b-4581-bc32-6b9f015199c1/parts/gen_list_init.c", "C", 19, 0, 0, 0, 6, 6, 31
"/Users/sbukhari/Sandbox/CProgram/ASTanalysis/CodexUserStudyData/raw_data/3533dacf-349b-4581-bc32-6b9f015199c1/parts/gen_list_item_to_string.c", "C", 22, 0, 0, 0, 13, 5, 40
"/Users/sbukhari/Sandbox/CProgram/ASTanalysis/CodexUserStudyData/raw_data/3533dacf-349b-4581-bc32-6b9f015199c1/parts/gen_list_load.c", "C", 77, 0, 0, 0, 18, 15, 110
"/Users/sbukhari/Sandbox/CProgram/ASTanalysis/CodexUserStudyData/raw_data/3533dacf-349b-4581-bc32-6b9f015199c1/parts/gen_list_print.c", "C", 29, 0, 0, 0, 21, 5, 55
"/Users/sbukhari/Sandbox/CProgram/ASTanalysis/CodexUserStudyData/raw_data/3533dacf-349b-4581-bc32-6b9f015199c1/parts/gen_list_remove_item_at_pos.c", "C", 37, 0, 0, 0, 10, 5, 52
"/Users/sbukhari/Sandbox/CProgram/ASTanalysis/CodexUserStudyData/raw_data/3533dacf-349b-4581-bc32-6b9f015199c1/parts/gen_list_save.c", "C", 30, 0, 0, 0, 12, 7, 49
"/Users/sbukhari/Sandbox/CProgram/ASTanalysis/CodexUserStudyData/raw_data/3533dacf-349b-4581-bc32-6b9f015199c1/parts/gen_list_swap_item_positions.c", "C", 53, 0, 0, 0, 9, 8, 70
"/Users/sbukhari/Sandbox/CProgram/ASTanalysis/CodexUserStudyData/raw_data/3533dacf-349b-4581-bc32-6b9f015199c1/parts/gen_list_update_item_at_pos.c", "C", 30, 0, 0, 0, 9, 7, 46
"/Users/sbukhari/Sandbox/CProgram/ASTanalysis/CodexUserStudyData/raw_data/3533dacf-349b-4581-bc32-6b9f015199c1/ref_testsuite.json", "JSON", 0, 323, 0, 0, 0, 1, 324
"/Users/sbukhari/Sandbox/CProgram/ASTanalysis/CodexUserStudyData/raw_data/3533dacf-349b-4581-bc32-6b9f015199c1/ref_testsuite_asan.json", "JSON", 0, 323, 0, 0, 0, 1, 324
"/Users/sbukhari/Sandbox/CProgram/ASTanalysis/CodexUserStudyData/raw_data/3533dacf-349b-4581-bc32-6b9f015199c1/ref_testsuite_asan_noleak.json", "JSON", 0, 323, 0, 0, 0, 1, 324
"/Users/sbukhari/Sandbox/CProgram/ASTanalysis/CodexUserStudyData/raw_data/36deba30-9345-480d-8221-387f5192f83d/api_report.json", "JSON", 0, 14, 0, 0, 0, 1, 15
"/Users/sbukhari/Sandbox/CProgram/ASTanalysis/CodexUserStudyData/raw_data/36deba30-9345-480d-8221-387f5192f83d/list.c", "C", 219, 0, 0, 0, 90, 25, 334
"/Users/sbukhari/Sandbox/CProgram/ASTanalysis/CodexUserStudyData/raw_data/36deba30-9345-480d-8221-387f5192f83d/orig_testsuite.json", "JSON", 0, 92, 0, 0, 0, 1, 93
"/Users/sbukhari/Sandbox/CProgram/ASTanalysis/CodexUserStudyData/raw_data/36deba30-9345-480d-8221-387f5192f83d/orig_testsuite_asan.json", "JSON", 0, 92, 0, 0, 0, 1, 93
"/Users/sbukhari/Sandbox/CProgram/ASTanalysis/CodexUserStudyData/raw_data/36deba30-9345-480d-8221-387f5192f83d/orig_testsuite_asan_noleak.json", "JSON", 0, 92, 0, 0, 0, 1, 93
"/Users/sbukhari/Sandbox/CProgram/ASTanalysis/CodexUserStudyData/raw_data/36deba30-9345-480d-8221-387f5192f83d/parts/gen_list_add_item_at_pos.c", "C", 41, 0, 0, 0, 19, 5, 65
"/Users/sbukhari/Sandbox/CProgram/ASTanalysis/CodexUserStudyData/raw_data/36deba30-9345-480d-8221-387f5192f83d/parts/gen_list_cost_sum.c", "C", 24, 0, 0, 0, 9, 5, 38
"/Users/sbukhari/Sandbox/CProgram/ASTanalysis/CodexUserStudyData/raw_data/36deba30-9345-480d-8221-387f5192f83d/parts/gen_list_deduplicate.c", "C", 17, 0, 0, 0, 26, 4, 47
"/Users/sbukhari/Sandbox/CProgram/ASTanalysis/CodexUserStudyData/raw_data/36deba30-9345-480d-8221-387f5192f83d/parts/gen_list_find_highest_price_item_position.c", "C", 32, 0, 0, 0, 9, 5, 46
"/Users/sbukhari/Sandbox/CProgram/ASTanalysis/CodexUserStudyData/raw_data/36deba30-9345-480d-8221-387f5192f83d/parts/gen_list_init.c", "C", 19, 0, 0, 0, 6, 6, 31
"/Users/sbukhari/Sandbox/CProgram/ASTanalysis/CodexUserStudyData/raw_data/36deba30-9345-480d-8221-387f5192f83d/parts/gen_list_item_to_string.c", "C", 22, 0, 0, 0, 15, 5, 42
"/Users/sbukhari/Sandbox/CProgram/ASTanalysis/CodexUserStudyData/raw_data/36deba30-9345-480d-8221-387f5192f83d/parts/gen_list_load.c", "C", 33, 0, 0, 0, 18, 5, 56
"/Users/sbukhari/Sandbox/CProgram/ASTanalysis/CodexUserStudyData/raw_data/36deba30-9345-480d-8221-387f5192f83d/parts/gen_list_print.c", "C", 29, 0, 0, 0, 22, 6, 57
"/Users/sbukhari/Sandbox/CProgram/ASTanalysis/CodexUserStudyData/raw_data/36deba30-9345-480d-8221-387f5192f83d/parts/gen_list_remove_item_at_pos.c", "C", 38, 0, 0, 0, 14, 5, 57
"/Users/sbukhari/Sandbox/CProgram/ASTanalysis/CodexUserStudyData/raw_data/36deba30-9345-480d-8221-387f5192f83d/parts/gen_list_save.c", "C", 29, 0, 0, 0, 14, 6, 49
"/Users/sbukhari/Sandbox/CProgram/ASTanalysis/CodexUserStudyData/raw_data/36deba30-9345-480d-8221-387f5192f83d/parts/gen_list_swap_item_positions.c", "C", 56, 0, 0, 0, 8, 5, 69
"/Users/sbukhari/Sandbox/CProgram/ASTanalysis/CodexUserStudyData/raw_data/36deba30-9345-480d-8221-387f5192f83d/parts/gen_list_update_item_at_pos.c", "C", 34, 0, 0, 0, 13, 5, 52
"/Users/sbukhari/Sandbox/CProgram/ASTanalysis/CodexUserStudyData/raw_data/36deba30-9345-480d-8221-387f5192f83d/ref_testsuite.json", "JSON", 0, 323, 0, 0, 0, 1, 324
"/Users/sbukhari/Sandbox/CProgram/ASTanalysis/CodexUserStudyData/raw_data/36deba30-9345-480d-8221-387f5192f83d/ref_testsuite_asan.json", "JSON", 0, 323, 0, 0, 0, 1, 324
"/Users/sbukhari/Sandbox/CProgram/ASTanalysis/CodexUserStudyData/raw_data/36deba30-9345-480d-8221-387f5192f83d/ref_testsuite_asan_noleak.json", "JSON", 0, 323, 0, 0, 0, 1, 324
"/Users/sbukhari/Sandbox/CProgram/ASTanalysis/CodexUserStudyData/raw_data/394b3e22-bd6f-4c90-9300-5826a9d033ad/api_report.json", "JSON", 0, 14, 0, 0, 0, 1, 15
"/Users/sbukhari/Sandbox/CProgram/ASTanalysis/CodexUserStudyData/raw_data/394b3e22-bd6f-4c90-9300-5826a9d033ad/list.c", "C", 84, 0, 0, 0, 74, 17, 175
"/Users/sbukhari/Sandbox/CProgram/ASTanalysis/CodexUserStudyData/raw_data/394b3e22-bd6f-4c90-9300-5826a9d033ad/orig_testsuite.json", "JSON", 0, 92, 0, 0, 0, 1, 93
"/Users/sbukhari/Sandbox/CProgram/ASTanalysis/CodexUserStudyData/raw_data/394b3e22-bd6f-4c90-9300-5826a9d033ad/orig_testsuite_asan.json", "JSON", 0, 92, 0, 0, 0, 1, 93
"/Users/sbukhari/Sandbox/CProgram/ASTanalysis/CodexUserStudyData/raw_data/394b3e22-bd6f-4c90-9300-5826a9d033ad/orig_testsuite_asan_noleak.json", "JSON", 0, 92, 0, 0, 0, 1, 93
"/Users/sbukhari/Sandbox/CProgram/ASTanalysis/CodexUserStudyData/raw_data/394b3e22-bd6f-4c90-9300-5826a9d033ad/parts/gen_list_add_item_at_pos.c", "C", 18, 0, 0, 0, 18, 5, 41
"/Users/sbukhari/Sandbox/CProgram/ASTanalysis/CodexUserStudyData/raw_data/394b3e22-bd6f-4c90-9300-5826a9d033ad/parts/gen_list_cost_sum.c", "C", 18, 0, 0, 0, 8, 5, 31
"/Users/sbukhari/Sandbox/CProgram/ASTanalysis/CodexUserStudyData/raw_data/394b3e22-bd6f-4c90-9300-5826a9d033ad/parts/gen_list_deduplicate.c", "C", 18, 0, 0, 0, 10, 5, 33
"/Users/sbukhari/Sandbox/CProgram/ASTanalysis/CodexUserStudyData/raw_data/394b3e22-bd6f-4c90-9300-5826a9d033ad/parts/gen_list_find_highest_price_item_position.c", "C", 18, 0, 0, 0, 8, 5, 31
"/Users/sbukhari/Sandbox/CProgram/ASTanalysis/CodexUserStudyData/raw_data/394b3e22-bd6f-4c90-9300-5826a9d033ad/parts/gen_list_init.c", "C", 19, 0, 0, 0, 6, 6, 31
"/Users/sbukhari/Sandbox/CProgram/ASTanalysis/CodexUserStudyData/raw_data/394b3e22-bd6f-4c90-9300-5826a9d033ad/parts/gen_list_item_to_string.c", "C", 17, 0, 0, 0, 11, 5, 33
"/Users/sbukhari/Sandbox/CProgram/ASTanalysis/CodexUserStudyData/raw_data/394b3e22-bd6f-4c90-9300-5826a9d033ad/parts/gen_list_load.c", "C", 18, 0, 0, 0, 12, 5, 35
"/Users/sbukhari/Sandbox/CProgram/ASTanalysis/CodexUserStudyData/raw_data/394b3e22-bd6f-4c90-9300-5826a9d033ad/parts/gen_list_print.c", "C", 30, 0, 0, 0, 21, 5, 56
"/Users/sbukhari/Sandbox/CProgram/ASTanalysis/CodexUserStudyData/raw_data/394b3e22-bd6f-4c90-9300-5826a9d033ad/parts/gen_list_remove_item_at_pos.c", "C", 18, 0, 0, 0, 8, 5, 31
"/Users/sbukhari/Sandbox/CProgram/ASTanalysis/CodexUserStudyData/raw_data/394b3e22-bd6f-4c90-9300-5826a9d033ad/parts/gen_list_save.c", "C", 18, 0, 0, 0, 11, 5, 34
"/Users/sbukhari/Sandbox/CProgram/ASTanalysis/CodexUserStudyData/raw_data/394b3e22-bd6f-4c90-9300-5826a9d033ad/parts/gen_list_swap_item_positions.c", "C", 18, 0, 0, 0, 8, 5, 31
"/Users/sbukhari/Sandbox/CProgram/ASTanalysis/CodexUserStudyData/raw_data/394b3e22-bd6f-4c90-9300-5826a9d033ad/parts/gen_list_update_item_at_pos.c", "C", 18, 0, 0, 0, 8, 5, 31
"/Users/sbukhari/Sandbox/CProgram/ASTanalysis/CodexUserStudyData/raw_data/394b3e22-bd6f-4c90-9300-5826a9d033ad/ref_testsuite.json", "JSON", 0, 323, 0, 0, 0, 1, 324
"/Users/sbukhari/Sandbox/CProgram/ASTanalysis/CodexUserStudyData/raw_data/394b3e22-bd6f-4c90-9300-5826a9d033ad/ref_testsuite_asan.json", "JSON", 0, 323, 0, 0, 0, 1, 324
"/Users/sbukhari/Sandbox/CProgram/ASTanalysis/CodexUserStudyData/raw_data/394b3e22-bd6f-4c90-9300-5826a9d033ad/ref_testsuite_asan_noleak.json", "JSON", 0, 323, 0, 0, 0, 1, 324
"/Users/sbukhari/Sandbox/CProgram/ASTanalysis/CodexUserStudyData/raw_data/3cff10bf-23d9-48f4-9f45-96a223a8e2de/api_report.json", "JSON", 0, 14, 0, 0, 0, 1, 15
"/Users/sbukhari/Sandbox/CProgram/ASTanalysis/CodexUserStudyData/raw_data/3cff10bf-23d9-48f4-9f45-96a223a8e2de/list.c", "C", 160, 0, 0, 0, 85, 32, 277
"/Users/sbukhari/Sandbox/CProgram/ASTanalysis/CodexUserStudyData/raw_data/3cff10bf-23d9-48f4-9f45-96a223a8e2de/orig_testsuite.json", "JSON", 0, 92, 0, 0, 0, 1, 93
"/Users/sbukhari/Sandbox/CProgram/ASTanalysis/CodexUserStudyData/raw_data/3cff10bf-23d9-48f4-9f45-96a223a8e2de/orig_testsuite_asan.json", "JSON", 0, 92, 0, 0, 0, 1, 93
"/Users/sbukhari/Sandbox/CProgram/ASTanalysis/CodexUserStudyData/raw_data/3cff10bf-23d9-48f4-9f45-96a223a8e2de/orig_testsuite_asan_noleak.json", "JSON", 0, 92, 0, 0, 0, 1, 93
"/Users/sbukhari/Sandbox/CProgram/ASTanalysis/CodexUserStudyData/raw_data/3cff10bf-23d9-48f4-9f45-96a223a8e2de/parts/gen_list_add_item_at_pos.c", "C", 18, 0, 0, 0, 18, 5, 41
"/Users/sbukhari/Sandbox/CProgram/ASTanalysis/CodexUserStudyData/raw_data/3cff10bf-23d9-48f4-9f45-96a223a8e2de/parts/gen_list_cost_sum.c", "C", 18, 0, 0, 0, 8, 7, 33
"/Users/sbukhari/Sandbox/CProgram/ASTanalysis/CodexUserStudyData/raw_data/3cff10bf-23d9-48f4-9f45-96a223a8e2de/parts/gen_list_deduplicate.c", "C", 18, 0, 0, 0, 10, 6, 34
"/Users/sbukhari/Sandbox/CProgram/ASTanalysis/CodexUserStudyData/raw_data/3cff10bf-23d9-48f4-9f45-96a223a8e2de/parts/gen_list_find_highest_price_item_position.c", "C", 18, 0, 0, 0, 8, 6, 32
"/Users/sbukhari/Sandbox/CProgram/ASTanalysis/CodexUserStudyData/raw_data/3cff10bf-23d9-48f4-9f45-96a223a8e2de/parts/gen_list_init.c", "C", 19, 0, 0, 0, 6, 6, 31
"/Users/sbukhari/Sandbox/CProgram/ASTanalysis/CodexUserStudyData/raw_data/3cff10bf-23d9-48f4-9f45-96a223a8e2de/parts/gen_list_item_to_string.c", "C", 21, 0, 0, 0, 14, 5, 40
"/Users/sbukhari/Sandbox/CProgram/ASTanalysis/CodexUserStudyData/raw_data/3cff10bf-23d9-48f4-9f45-96a223a8e2de/parts/gen_list_load.c", "C", 18, 0, 0, 0, 12, 6, 36
"/Users/sbukhari/Sandbox/CProgram/ASTanalysis/CodexUserStudyData/raw_data/3cff10bf-23d9-48f4-9f45-96a223a8e2de/parts/gen_list_print.c", "C", 28, 0, 0, 0, 10, 5, 43
"/Users/sbukhari/Sandbox/CProgram/ASTanalysis/CodexUserStudyData/raw_data/3cff10bf-23d9-48f4-9f45-96a223a8e2de/parts/gen_list_remove_item_at_pos.c", "C", 18, 0, 0, 0, 8, 5, 31
"/Users/sbukhari/Sandbox/CProgram/ASTanalysis/CodexUserStudyData/raw_data/3cff10bf-23d9-48f4-9f45-96a223a8e2de/parts/gen_list_save.c", "C", 18, 0, 0, 0, 11, 6, 35
"/Users/sbukhari/Sandbox/CProgram/ASTanalysis/CodexUserStudyData/raw_data/3cff10bf-23d9-48f4-9f45-96a223a8e2de/parts/gen_list_swap_item_positions.c", "C", 17, 0, 0, 0, 8, 6, 31
"/Users/sbukhari/Sandbox/CProgram/ASTanalysis/CodexUserStudyData/raw_data/3cff10bf-23d9-48f4-9f45-96a223a8e2de/parts/gen_list_update_item_at_pos.c", "C", 37, 0, 0, 0, 13, 5, 55
"/Users/sbukhari/Sandbox/CProgram/ASTanalysis/CodexUserStudyData/raw_data/3cff10bf-23d9-48f4-9f45-96a223a8e2de/ref_testsuite.json", "JSON", 0, 323, 0, 0, 0, 1, 324
"/Users/sbukhari/Sandbox/CProgram/ASTanalysis/CodexUserStudyData/raw_data/3cff10bf-23d9-48f4-9f45-96a223a8e2de/ref_testsuite_asan.json", "JSON", 0, 323, 0, 0, 0, 1, 324
"/Users/sbukhari/Sandbox/CProgram/ASTanalysis/CodexUserStudyData/raw_data/3cff10bf-23d9-48f4-9f45-96a223a8e2de/ref_testsuite_asan_noleak.json", "JSON", 0, 323, 0, 0, 0, 1, 324
"/Users/sbukhari/Sandbox/CProgram/ASTanalysis/CodexUserStudyData/raw_data/40a638f7-3fe3-43b0-b6cd-c47427778724/api_report.json", "JSON", 0, 14, 0, 0, 0, 1, 15
"/Users/sbukhari/Sandbox/CProgram/ASTanalysis/CodexUserStudyData/raw_data/40a638f7-3fe3-43b0-b6cd-c47427778724/list.c", "C", 151, 0, 0, 0, 75, 22, 248
"/Users/sbukhari/Sandbox/CProgram/ASTanalysis/CodexUserStudyData/raw_data/40a638f7-3fe3-43b0-b6cd-c47427778724/orig_testsuite.json", "JSON", 0, 92, 0, 0, 0, 1, 93
"/Users/sbukhari/Sandbox/CProgram/ASTanalysis/CodexUserStudyData/raw_data/40a638f7-3fe3-43b0-b6cd-c47427778724/orig_testsuite_asan.json", "JSON", 0, 92, 0, 0, 0, 1, 93
"/Users/sbukhari/Sandbox/CProgram/ASTanalysis/CodexUserStudyData/raw_data/40a638f7-3fe3-43b0-b6cd-c47427778724/orig_testsuite_asan_noleak.json", "JSON", 0, 92, 0, 0, 0, 1, 93
"/Users/sbukhari/Sandbox/CProgram/ASTanalysis/CodexUserStudyData/raw_data/40a638f7-3fe3-43b0-b6cd-c47427778724/parts/gen_list_add_item_at_pos.c", "C", 38, 0, 0, 0, 19, 5, 62
"/Users/sbukhari/Sandbox/CProgram/ASTanalysis/CodexUserStudyData/raw_data/40a638f7-3fe3-43b0-b6cd-c47427778724/parts/gen_list_cost_sum.c", "C", 25, 0, 0, 0, 9, 5, 39
"/Users/sbukhari/Sandbox/CProgram/ASTanalysis/CodexUserStudyData/raw_data/40a638f7-3fe3-43b0-b6cd-c47427778724/parts/gen_list_deduplicate.c", "C", 19, 0, 0, 0, 10, 5, 34
"/Users/sbukhari/Sandbox/CProgram/ASTanalysis/CodexUserStudyData/raw_data/40a638f7-3fe3-43b0-b6cd-c47427778724/parts/gen_list_find_highest_price_item_position.c", "C", 30, 0, 0, 0, 10, 5, 45
"/Users/sbukhari/Sandbox/CProgram/ASTanalysis/CodexUserStudyData/raw_data/40a638f7-3fe3-43b0-b6cd-c47427778724/parts/gen_list_init.c", "C", 20, 0, 0, 0, 6, 6, 32
"/Users/sbukhari/Sandbox/CProgram/ASTanalysis/CodexUserStudyData/raw_data/40a638f7-3fe3-43b0-b6cd-c47427778724/parts/gen_list_item_to_string.c", "C", 22, 0, 0, 0, 15, 5, 42
"/Users/sbukhari/Sandbox/CProgram/ASTanalysis/CodexUserStudyData/raw_data/40a638f7-3fe3-43b0-b6cd-c47427778724/parts/gen_list_load.c", "C", 19, 0, 0, 0, 12, 6, 37
"/Users/sbukhari/Sandbox/CProgram/ASTanalysis/CodexUserStudyData/raw_data/40a638f7-3fe3-43b0-b6cd-c47427778724/parts/gen_list_print.c", "C", 28, 0, 0, 0, 22, 5, 55
"/Users/sbukhari/Sandbox/CProgram/ASTanalysis/CodexUserStudyData/raw_data/40a638f7-3fe3-43b0-b6cd-c47427778724/parts/gen_list_remove_item_at_pos.c", "C", 30, 0, 0, 0, 13, 5, 48
"/Users/sbukhari/Sandbox/CProgram/ASTanalysis/CodexUserStudyData/raw_data/40a638f7-3fe3-43b0-b6cd-c47427778724/parts/gen_list_save.c", "C", 33, 0, 0, 0, 16, 6, 55
"/Users/sbukhari/Sandbox/CProgram/ASTanalysis/CodexUserStudyData/raw_data/40a638f7-3fe3-43b0-b6cd-c47427778724/parts/gen_list_swap_item_positions.c", "C", 18, 0, 0, 0, 8, 6, 32
"/Users/sbukhari/Sandbox/CProgram/ASTanalysis/CodexUserStudyData/raw_data/40a638f7-3fe3-43b0-b6cd-c47427778724/parts/gen_list_update_item_at_pos.c", "C", 35, 0, 0, 0, 14, 6, 55
"/Users/sbukhari/Sandbox/CProgram/ASTanalysis/CodexUserStudyData/raw_data/40a638f7-3fe3-43b0-b6cd-c47427778724/ref_testsuite.json", "JSON", 0, 323, 0, 0, 0, 1, 324
"/Users/sbukhari/Sandbox/CProgram/ASTanalysis/CodexUserStudyData/raw_data/40a638f7-3fe3-43b0-b6cd-c47427778724/ref_testsuite_asan.json", "JSON", 0, 323, 0, 0, 0, 1, 324
"/Users/sbukhari/Sandbox/CProgram/ASTanalysis/CodexUserStudyData/raw_data/40a638f7-3fe3-43b0-b6cd-c47427778724/ref_testsuite_asan_noleak.json", "JSON", 0, 323, 0, 0, 0, 1, 324
"/Users/sbukhari/Sandbox/CProgram/ASTanalysis/CodexUserStudyData/raw_data/4992045a-4e79-4768-a0e8-8a8219c7b8d5/api_report.json", "JSON", 0, 14, 0, 0, 0, 1, 15
"/Users/sbukhari/Sandbox/CProgram/ASTanalysis/CodexUserStudyData/raw_data/4992045a-4e79-4768-a0e8-8a8219c7b8d5/list.c", "C", 86, 0, 0, 0, 86, 21, 193
"/Users/sbukhari/Sandbox/CProgram/ASTanalysis/CodexUserStudyData/raw_data/4992045a-4e79-4768-a0e8-8a8219c7b8d5/orig_testsuite.json", "JSON", 0, 92, 0, 0, 0, 1, 93
"/Users/sbukhari/Sandbox/CProgram/ASTanalysis/CodexUserStudyData/raw_data/4992045a-4e79-4768-a0e8-8a8219c7b8d5/orig_testsuite_asan.json", "JSON", 0, 92, 0, 0, 0, 1, 93
"/Users/sbukhari/Sandbox/CProgram/ASTanalysis/CodexUserStudyData/raw_data/4992045a-4e79-4768-a0e8-8a8219c7b8d5/orig_testsuite_asan_noleak.json", "JSON", 0, 92, 0, 0, 0, 1, 93
"/Users/sbukhari/Sandbox/CProgram/ASTanalysis/CodexUserStudyData/raw_data/4992045a-4e79-4768-a0e8-8a8219c7b8d5/parts/gen_list_add_item_at_pos.c", "C", 38, 0, 0, 0, 29, 8, 75
"/Users/sbukhari/Sandbox/CProgram/ASTanalysis/CodexUserStudyData/raw_data/4992045a-4e79-4768-a0e8-8a8219c7b8d5/parts/gen_list_cost_sum.c", "C", 18, 0, 0, 0, 17, 7, 42
"/Users/sbukhari/Sandbox/CProgram/ASTanalysis/CodexUserStudyData/raw_data/4992045a-4e79-4768-a0e8-8a8219c7b8d5/parts/gen_list_deduplicate.c", "C", 18, 0, 0, 0, 19, 7, 44
"/Users/sbukhari/Sandbox/CProgram/ASTanalysis/CodexUserStudyData/raw_data/4992045a-4e79-4768-a0e8-8a8219c7b8d5/parts/gen_list_find_highest_price_item_position.c", "C", 18, 0, 0, 0, 17, 7, 42
"/Users/sbukhari/Sandbox/CProgram/ASTanalysis/CodexUserStudyData/raw_data/4992045a-4e79-4768-a0e8-8a8219c7b8d5/parts/gen_list_init.c", "C", 19, 0, 0, 0, 15, 8, 42
"/Users/sbukhari/Sandbox/CProgram/ASTanalysis/CodexUserStudyData/raw_data/4992045a-4e79-4768-a0e8-8a8219c7b8d5/parts/gen_list_item_to_string.c", "C", 21, 0, 0, 0, 23, 7, 51
"/Users/sbukhari/Sandbox/CProgram/ASTanalysis/CodexUserStudyData/raw_data/4992045a-4e79-4768-a0e8-8a8219c7b8d5/parts/gen_list_load.c", "C", 18, 0, 0, 0, 21, 7, 46
"/Users/sbukhari/Sandbox/CProgram/ASTanalysis/CodexUserStudyData/raw_data/4992045a-4e79-4768-a0e8-8a8219c7b8d5/parts/gen_list_print.c", "C", 28, 0, 0, 0, 31, 7, 66
"/Users/sbukhari/Sandbox/CProgram/ASTanalysis/CodexUserStudyData/raw_data/4992045a-4e79-4768-a0e8-8a8219c7b8d5/parts/gen_list_remove_item_at_pos.c", "C", 18, 0, 0, 0, 17, 7, 42
"/Users/sbukhari/Sandbox/CProgram/ASTanalysis/CodexUserStudyData/raw_data/4992045a-4e79-4768-a0e8-8a8219c7b8d5/parts/gen_list_save.c", "C", 18, 0, 0, 0, 20, 7, 45
"/Users/sbukhari/Sandbox/CProgram/ASTanalysis/CodexUserStudyData/raw_data/4992045a-4e79-4768-a0e8-8a8219c7b8d5/parts/gen_list_swap_item_positions.c", "C", 17, 0, 0, 0, 17, 7, 41
"/Users/sbukhari/Sandbox/CProgram/ASTanalysis/CodexUserStudyData/raw_data/4992045a-4e79-4768-a0e8-8a8219c7b8d5/parts/gen_list_update_item_at_pos.c", "C", 17, 0, 0, 0, 17, 8, 42
"/Users/sbukhari/Sandbox/CProgram/ASTanalysis/CodexUserStudyData/raw_data/4992045a-4e79-4768-a0e8-8a8219c7b8d5/ref_testsuite.json", "JSON", 0, 323, 0, 0, 0, 1, 324
"/Users/sbukhari/Sandbox/CProgram/ASTanalysis/CodexUserStudyData/raw_data/4992045a-4e79-4768-a0e8-8a8219c7b8d5/ref_testsuite_asan.json", "JSON", 0, 323, 0, 0, 0, 1, 324
"/Users/sbukhari/Sandbox/CProgram/ASTanalysis/CodexUserStudyData/raw_data/4992045a-4e79-4768-a0e8-8a8219c7b8d5/ref_testsuite_asan_noleak.json", "JSON", 0, 323, 0, 0, 0, 1, 324
"/Users/sbukhari/Sandbox/CProgram/ASTanalysis/CodexUserStudyData/raw_data/514e6c1d-f935-474d-899e-96e27d5babd3/api_report.json", "JSON", 0, 14, 0, 0, 0, 1, 15
"/Users/sbukhari/Sandbox/CProgram/ASTanalysis/CodexUserStudyData/raw_data/514e6c1d-f935-474d-899e-96e27d5babd3/list.c", "C", 87, 0, 0, 0, 85, 21, 193
"/Users/sbukhari/Sandbox/CProgram/ASTanalysis/CodexUserStudyData/raw_data/514e6c1d-f935-474d-899e-96e27d5babd3/orig_testsuite.json", "JSON", 0, 92, 0, 0, 0, 1, 93
"/Users/sbukhari/Sandbox/CProgram/ASTanalysis/CodexUserStudyData/raw_data/514e6c1d-f935-474d-899e-96e27d5babd3/orig_testsuite_asan.json", "JSON", 0, 92, 0, 0, 0, 1, 93
"/Users/sbukhari/Sandbox/CProgram/ASTanalysis/CodexUserStudyData/raw_data/514e6c1d-f935-474d-899e-96e27d5babd3/orig_testsuite_asan_noleak.json", "JSON", 0, 92, 0, 0, 0, 1, 93
"/Users/sbukhari/Sandbox/CProgram/ASTanalysis/CodexUserStudyData/raw_data/514e6c1d-f935-474d-899e-96e27d5babd3/parts/gen_list_add_item_at_pos.c", "C", 35, 0, 0, 0, 20, 5, 60
"/Users/sbukhari/Sandbox/CProgram/ASTanalysis/CodexUserStudyData/raw_data/514e6c1d-f935-474d-899e-96e27d5babd3/parts/gen_list_cost_sum.c", "C", 18, 0, 0, 0, 8, 5, 31
"/Users/sbukhari/Sandbox/CProgram/ASTanalysis/CodexUserStudyData/raw_data/514e6c1d-f935-474d-899e-96e27d5babd3/parts/gen_list_deduplicate.c", "C", 18, 0, 0, 0, 10, 5, 33
"/Users/sbukhari/Sandbox/CProgram/ASTanalysis/CodexUserStudyData/raw_data/514e6c1d-f935-474d-899e-96e27d5babd3/parts/gen_list_find_highest_price_item_position.c", "C", 18, 0, 0, 0, 8, 5, 31
"/Users/sbukhari/Sandbox/CProgram/ASTanalysis/CodexUserStudyData/raw_data/514e6c1d-f935-474d-899e-96e27d5babd3/parts/gen_list_init.c", "C", 19, 0, 0, 0, 6, 6, 31
"/Users/sbukhari/Sandbox/CProgram/ASTanalysis/CodexUserStudyData/raw_data/514e6c1d-f935-474d-899e-96e27d5babd3/parts/gen_list_item_to_string.c", "C", 20, 0, 0, 0, 23, 8, 51
"/Users/sbukhari/Sandbox/CProgram/ASTanalysis/CodexUserStudyData/raw_data/514e6c1d-f935-474d-899e-96e27d5babd3/parts/gen_list_load.c", "C", 18, 0, 0, 0, 12, 5, 35
"/Users/sbukhari/Sandbox/CProgram/ASTanalysis/CodexUserStudyData/raw_data/514e6c1d-f935-474d-899e-96e27d5babd3/parts/gen_list_print.c", "C", 26, 0, 0, 0, 23, 5, 54
"/Users/sbukhari/Sandbox/CProgram/ASTanalysis/CodexUserStudyData/raw_data/514e6c1d-f935-474d-899e-96e27d5babd3/parts/gen_list_remove_item_at_pos.c", "C", 18, 0, 0, 0, 8, 5, 31
"/Users/sbukhari/Sandbox/CProgram/ASTanalysis/CodexUserStudyData/raw_data/514e6c1d-f935-474d-899e-96e27d5babd3/parts/gen_list_save.c", "C", 18, 0, 0, 0, 11, 5, 34
"/Users/sbukhari/Sandbox/CProgram/ASTanalysis/CodexUserStudyData/raw_data/514e6c1d-f935-474d-899e-96e27d5babd3/parts/gen_list_swap_item_positions.c", "C", 17, 0, 0, 0, 8, 5, 30
"/Users/sbukhari/Sandbox/CProgram/ASTanalysis/CodexUserStudyData/raw_data/514e6c1d-f935-474d-899e-96e27d5babd3/parts/gen_list_update_item_at_pos.c", "C", 17, 0, 0, 0, 8, 5, 30
"/Users/sbukhari/Sandbox/CProgram/ASTanalysis/CodexUserStudyData/raw_data/514e6c1d-f935-474d-899e-96e27d5babd3/ref_testsuite.json", "JSON", 0, 323, 0, 0, 0, 1, 324
"/Users/sbukhari/Sandbox/CProgram/ASTanalysis/CodexUserStudyData/raw_data/514e6c1d-f935-474d-899e-96e27d5babd3/ref_testsuite_asan.json", "JSON", 0, 323, 0, 0, 0, 1, 324
"/Users/sbukhari/Sandbox/CProgram/ASTanalysis/CodexUserStudyData/raw_data/514e6c1d-f935-474d-899e-96e27d5babd3/ref_testsuite_asan_noleak.json", "JSON", 0, 323, 0, 0, 0, 1, 324
"/Users/sbukhari/Sandbox/CProgram/ASTanalysis/CodexUserStudyData/raw_data/549eca81-c8f8-4237-9237-220ab72ac8cf/api_report.json", "JSON", 0, 14, 0, 0, 0, 1, 15
"/Users/sbukhari/Sandbox/CProgram/ASTanalysis/CodexUserStudyData/raw_data/549eca81-c8f8-4237-9237-220ab72ac8cf/list.c", "C", 197, 0, 0, 0, 93, 35, 325
"/Users/sbukhari/Sandbox/CProgram/ASTanalysis/CodexUserStudyData/raw_data/549eca81-c8f8-4237-9237-220ab72ac8cf/orig_testsuite.json", "JSON", 0, 92, 0, 0, 0, 1, 93
"/Users/sbukhari/Sandbox/CProgram/ASTanalysis/CodexUserStudyData/raw_data/549eca81-c8f8-4237-9237-220ab72ac8cf/orig_testsuite_asan.json", "JSON", 0, 92, 0, 0, 0, 1, 93
"/Users/sbukhari/Sandbox/CProgram/ASTanalysis/CodexUserStudyData/raw_data/549eca81-c8f8-4237-9237-220ab72ac8cf/orig_testsuite_asan_noleak.json", "JSON", 0, 92, 0, 0, 0, 1, 93
"/Users/sbukhari/Sandbox/CProgram/ASTanalysis/CodexUserStudyData/raw_data/549eca81-c8f8-4237-9237-220ab72ac8cf/parts/gen_list_add_item_at_pos.c", "C", 37, 0, 0, 0, 20, 6, 63
"/Users/sbukhari/Sandbox/CProgram/ASTanalysis/CodexUserStudyData/raw_data/549eca81-c8f8-4237-9237-220ab72ac8cf/parts/gen_list_cost_sum.c", "C", 25, 0, 0, 0, 9, 6, 40
"/Users/sbukhari/Sandbox/CProgram/ASTanalysis/CodexUserStudyData/raw_data/549eca81-c8f8-4237-9237-220ab72ac8cf/parts/gen_list_deduplicate.c", "C", 31, 0, 0, 0, 13, 6, 50
"/Users/sbukhari/Sandbox/CProgram/ASTanalysis/CodexUserStudyData/raw_data/549eca81-c8f8-4237-9237-220ab72ac8cf/parts/gen_list_find_highest_price_item_position.c", "C", 18, 0, 0, 0, 25, 6, 49
"/Users/sbukhari/Sandbox/CProgram/ASTanalysis/CodexUserStudyData/raw_data/549eca81-c8f8-4237-9237-220ab72ac8cf/parts/gen_list_init.c", "C", 19, 0, 0, 0, 6, 6, 31
"/Users/sbukhari/Sandbox/CProgram/ASTanalysis/CodexUserStudyData/raw_data/549eca81-c8f8-4237-9237-220ab72ac8cf/parts/gen_list_item_to_string.c", "C", 19, 0, 0, 0, 14, 5, 38
"/Users/sbukhari/Sandbox/CProgram/ASTanalysis/CodexUserStudyData/raw_data/549eca81-c8f8-4237-9237-220ab72ac8cf/parts/gen_list_load.c", "C", 34, 0, 0, 0, 17, 9, 60
"/Users/sbukhari/Sandbox/CProgram/ASTanalysis/CodexUserStudyData/raw_data/549eca81-c8f8-4237-9237-220ab72ac8cf/parts/gen_list_print.c", "C", 24, 0, 0, 0, 23, 5, 52
"/Users/sbukhari/Sandbox/CProgram/ASTanalysis/CodexUserStudyData/raw_data/549eca81-c8f8-4237-9237-220ab72ac8cf/parts/gen_list_remove_item_at_pos.c", "C", 36, 0, 0, 0, 12, 5, 53
"/Users/sbukhari/Sandbox/CProgram/ASTanalysis/CodexUserStudyData/raw_data/549eca81-c8f8-4237-9237-220ab72ac8cf/parts/gen_list_save.c", "C", 26, 0, 0, 0, 16, 5, 47
"/Users/sbukhari/Sandbox/CProgram/ASTanalysis/CodexUserStudyData/raw_data/549eca81-c8f8-4237-9237-220ab72ac8cf/parts/gen_list_swap_item_positions.c", "C", 56, 0, 0, 0, 14, 14, 84
"/Users/sbukhari/Sandbox/CProgram/ASTanalysis/CodexUserStudyData/raw_data/549eca81-c8f8-4237-9237-220ab72ac8cf/parts/gen_list_update_item_at_pos.c", "C", 27, 0, 0, 0, 11, 6, 44
"/Users/sbukhari/Sandbox/CProgram/ASTanalysis/CodexUserStudyData/raw_data/549eca81-c8f8-4237-9237-220ab72ac8cf/ref_testsuite.json", "JSON", 0, 323, 0, 0, 0, 1, 324
"/Users/sbukhari/Sandbox/CProgram/ASTanalysis/CodexUserStudyData/raw_data/549eca81-c8f8-4237-9237-220ab72ac8cf/ref_testsuite_asan.json", "JSON", 0, 323, 0, 0, 0, 1, 324
"/Users/sbukhari/Sandbox/CProgram/ASTanalysis/CodexUserStudyData/raw_data/549eca81-c8f8-4237-9237-220ab72ac8cf/ref_testsuite_asan_noleak.json", "JSON", 0, 323, 0, 0, 0, 1, 324
"/Users/sbukhari/Sandbox/CProgram/ASTanalysis/CodexUserStudyData/raw_data/599ce961-34d5-427d-83bd-8ca692a7e766/api_report.json", "JSON", 0, 14, 0, 0, 0, 1, 15
"/Users/sbukhari/Sandbox/CProgram/ASTanalysis/CodexUserStudyData/raw_data/599ce961-34d5-427d-83bd-8ca692a7e766/list.c", "C", 95, 0, 0, 0, 76, 19, 190
"/Users/sbukhari/Sandbox/CProgram/ASTanalysis/CodexUserStudyData/raw_data/599ce961-34d5-427d-83bd-8ca692a7e766/orig_testsuite.json", "JSON", 0, 92, 0, 0, 0, 1, 93
"/Users/sbukhari/Sandbox/CProgram/ASTanalysis/CodexUserStudyData/raw_data/599ce961-34d5-427d-83bd-8ca692a7e766/orig_testsuite_asan.json", "JSON", 0, 92, 0, 0, 0, 1, 93
"/Users/sbukhari/Sandbox/CProgram/ASTanalysis/CodexUserStudyData/raw_data/599ce961-34d5-427d-83bd-8ca692a7e766/orig_testsuite_asan_noleak.json", "JSON", 0, 92, 0, 0, 0, 1, 93
"/Users/sbukhari/Sandbox/CProgram/ASTanalysis/CodexUserStudyData/raw_data/599ce961-34d5-427d-83bd-8ca692a7e766/parts/gen_list_add_item_at_pos.c", "C", 32, 0, 0, 0, 25, 6, 63
"/Users/sbukhari/Sandbox/CProgram/ASTanalysis/CodexUserStudyData/raw_data/599ce961-34d5-427d-83bd-8ca692a7e766/parts/gen_list_cost_sum.c", "C", 18, 0, 0, 0, 8, 5, 31
"/Users/sbukhari/Sandbox/CProgram/ASTanalysis/CodexUserStudyData/raw_data/599ce961-34d5-427d-83bd-8ca692a7e766/parts/gen_list_deduplicate.c", "C", 18, 0, 0, 0, 10, 5, 33
"/Users/sbukhari/Sandbox/CProgram/ASTanalysis/CodexUserStudyData/raw_data/599ce961-34d5-427d-83bd-8ca692a7e766/parts/gen_list_find_highest_price_item_position.c", "C", 18, 0, 0, 0, 8, 5, 31
"/Users/sbukhari/Sandbox/CProgram/ASTanalysis/CodexUserStudyData/raw_data/599ce961-34d5-427d-83bd-8ca692a7e766/parts/gen_list_init.c", "C", 19, 0, 0, 0, 6, 6, 31
"/Users/sbukhari/Sandbox/CProgram/ASTanalysis/CodexUserStudyData/raw_data/599ce961-34d5-427d-83bd-8ca692a7e766/parts/gen_list_item_to_string.c", "C", 31, 0, 0, 0, 14, 5, 50
"/Users/sbukhari/Sandbox/CProgram/ASTanalysis/CodexUserStudyData/raw_data/599ce961-34d5-427d-83bd-8ca692a7e766/parts/gen_list_load.c", "C", 18, 0, 0, 0, 12, 5, 35
"/Users/sbukhari/Sandbox/CProgram/ASTanalysis/CodexUserStudyData/raw_data/599ce961-34d5-427d-83bd-8ca692a7e766/parts/gen_list_print.c", "C", 26, 0, 0, 0, 23, 5, 54
"/Users/sbukhari/Sandbox/CProgram/ASTanalysis/CodexUserStudyData/raw_data/599ce961-34d5-427d-83bd-8ca692a7e766/parts/gen_list_remove_item_at_pos.c", "C", 18, 0, 0, 0, 8, 5, 31
"/Users/sbukhari/Sandbox/CProgram/ASTanalysis/CodexUserStudyData/raw_data/599ce961-34d5-427d-83bd-8ca692a7e766/parts/gen_list_save.c", "C", 18, 0, 0, 0, 11, 5, 34
"/Users/sbukhari/Sandbox/CProgram/ASTanalysis/CodexUserStudyData/raw_data/599ce961-34d5-427d-83bd-8ca692a7e766/parts/gen_list_swap_item_positions.c", "C", 17, 0, 0, 0, 8, 5, 30
"/Users/sbukhari/Sandbox/CProgram/ASTanalysis/CodexUserStudyData/raw_data/599ce961-34d5-427d-83bd-8ca692a7e766/parts/gen_list_update_item_at_pos.c", "C", 17, 0, 0, 0, 8, 5, 30
"/Users/sbukhari/Sandbox/CProgram/ASTanalysis/CodexUserStudyData/raw_data/599ce961-34d5-427d-83bd-8ca692a7e766/ref_testsuite.json", "JSON", 0, 323, 0, 0, 0, 1, 324
"/Users/sbukhari/Sandbox/CProgram/ASTanalysis/CodexUserStudyData/raw_data/599ce961-34d5-427d-83bd-8ca692a7e766/ref_testsuite_asan.json", "JSON", 0, 323, 0, 0, 0, 1, 324
"/Users/sbukhari/Sandbox/CProgram/ASTanalysis/CodexUserStudyData/raw_data/599ce961-34d5-427d-83bd-8ca692a7e766/ref_testsuite_asan_noleak.json", "JSON", 0, 323, 0, 0, 0, 1, 324
"/Users/sbukhari/Sandbox/CProgram/ASTanalysis/CodexUserStudyData/raw_data/5a790fe9-4950-4f24-903a-a7440f7f826f/api_report.json", "JSON", 0, 14, 0, 0, 0, 1, 15
"/Users/sbukhari/Sandbox/CProgram/ASTanalysis/CodexUserStudyData/raw_data/5a790fe9-4950-4f24-903a-a7440f7f826f/list.c", "C", 162, 0, 0, 0, 76, 21, 259
"/Users/sbukhari/Sandbox/CProgram/ASTanalysis/CodexUserStudyData/raw_data/5a790fe9-4950-4f24-903a-a7440f7f826f/orig_testsuite.json", "JSON", 0, 92, 0, 0, 0, 1, 93
"/Users/sbukhari/Sandbox/CProgram/ASTanalysis/CodexUserStudyData/raw_data/5a790fe9-4950-4f24-903a-a7440f7f826f/orig_testsuite_asan.json", "JSON", 0, 92, 0, 0, 0, 1, 93
"/Users/sbukhari/Sandbox/CProgram/ASTanalysis/CodexUserStudyData/raw_data/5a790fe9-4950-4f24-903a-a7440f7f826f/orig_testsuite_asan_noleak.json", "JSON", 0, 92, 0, 0, 0, 1, 93
"/Users/sbukhari/Sandbox/CProgram/ASTanalysis/CodexUserStudyData/raw_data/5a790fe9-4950-4f24-903a-a7440f7f826f/parts/gen_list_add_item_at_pos.c", "C", 47, 0, 0, 0, 18, 5, 70
"/Users/sbukhari/Sandbox/CProgram/ASTanalysis/CodexUserStudyData/raw_data/5a790fe9-4950-4f24-903a-a7440f7f826f/parts/gen_list_cost_sum.c", "C", 23, 0, 0, 0, 10, 5, 38
"/Users/sbukhari/Sandbox/CProgram/ASTanalysis/CodexUserStudyData/raw_data/5a790fe9-4950-4f24-903a-a7440f7f826f/parts/gen_list_deduplicate.c", "C", 18, 0, 0, 0, 10, 5, 33
"/Users/sbukhari/Sandbox/CProgram/ASTanalysis/CodexUserStudyData/raw_data/5a790fe9-4950-4f24-903a-a7440f7f826f/parts/gen_list_find_highest_price_item_position.c", "C", 29, 0, 0, 0, 9, 6, 44
"/Users/sbukhari/Sandbox/CProgram/ASTanalysis/CodexUserStudyData/raw_data/5a790fe9-4950-4f24-903a-a7440f7f826f/parts/gen_list_init.c", "C", 19, 0, 0, 0, 6, 6, 31
"/Users/sbukhari/Sandbox/CProgram/ASTanalysis/CodexUserStudyData/raw_data/5a790fe9-4950-4f24-903a-a7440f7f826f/parts/gen_list_item_to_string.c", "C", 18, 0, 0, 0, 11, 6, 35
"/Users/sbukhari/Sandbox/CProgram/ASTanalysis/CodexUserStudyData/raw_data/5a790fe9-4950-4f24-903a-a7440f7f826f/parts/gen_list_load.c", "C", 18, 0, 0, 0, 12, 5, 35
"/Users/sbukhari/Sandbox/CProgram/ASTanalysis/CodexUserStudyData/raw_data/5a790fe9-4950-4f24-903a-a7440f7f826f/parts/gen_list_print.c", "C", 25, 0, 0, 0, 22, 6, 53
"/Users/sbukhari/Sandbox/CProgram/ASTanalysis/CodexUserStudyData/raw_data/5a790fe9-4950-4f24-903a-a7440f7f826f/parts/gen_list_remove_item_at_pos.c", "C", 28, 0, 0, 0, 13, 5, 46
"/Users/sbukhari/Sandbox/CProgram/ASTanalysis/CodexUserStudyData/raw_data/5a790fe9-4950-4f24-903a-a7440f7f826f/parts/gen_list_save.c", "C", 18, 0, 0, 0, 11, 5, 34
"/Users/sbukhari/Sandbox/CProgram/ASTanalysis/CodexUserStudyData/raw_data/5a790fe9-4950-4f24-903a-a7440f7f826f/parts/gen_list_swap_item_positions.c", "C", 45, 0, 0, 0, 12, 6, 63
"/Users/sbukhari/Sandbox/CProgram/ASTanalysis/CodexUserStudyData/raw_data/5a790fe9-4950-4f24-903a-a7440f7f826f/parts/gen_list_update_item_at_pos.c", "C", 29, 0, 0, 0, 14, 5, 48
"/Users/sbukhari/Sandbox/CProgram/ASTanalysis/CodexUserStudyData/raw_data/5a790fe9-4950-4f24-903a-a7440f7f826f/ref_testsuite.json", "JSON", 0, 323, 0, 0, 0, 1, 324
"/Users/sbukhari/Sandbox/CProgram/ASTanalysis/CodexUserStudyData/raw_data/5a790fe9-4950-4f24-903a-a7440f7f826f/ref_testsuite_asan.json", "JSON", 0, 323, 0, 0, 0, 1, 324
"/Users/sbukhari/Sandbox/CProgram/ASTanalysis/CodexUserStudyData/raw_data/5a790fe9-4950-4f24-903a-a7440f7f826f/ref_testsuite_asan_noleak.json", "JSON", 0, 323, 0, 0, 0, 1, 324
"/Users/sbukhari/Sandbox/CProgram/ASTanalysis/CodexUserStudyData/raw_data/632e58e4-4e9b-4311-a12a-13fbc92ad3a3/api_report.json", "JSON", 0, 14, 0, 0, 0, 1, 15
"/Users/sbukhari/Sandbox/CProgram/ASTanalysis/CodexUserStudyData/raw_data/632e58e4-4e9b-4311-a12a-13fbc92ad3a3/list.c", "C", 64, 0, 0, 0, 72, 17, 153
"/Users/sbukhari/Sandbox/CProgram/ASTanalysis/CodexUserStudyData/raw_data/632e58e4-4e9b-4311-a12a-13fbc92ad3a3/orig_testsuite.json", "JSON", 0, 92, 0, 0, 0, 1, 93
"/Users/sbukhari/Sandbox/CProgram/ASTanalysis/CodexUserStudyData/raw_data/632e58e4-4e9b-4311-a12a-13fbc92ad3a3/orig_testsuite_asan.json", "JSON", 0, 92, 0, 0, 0, 1, 93
"/Users/sbukhari/Sandbox/CProgram/ASTanalysis/CodexUserStudyData/raw_data/632e58e4-4e9b-4311-a12a-13fbc92ad3a3/orig_testsuite_asan_noleak.json", "JSON", 0, 92, 0, 0, 0, 1, 93
"/Users/sbukhari/Sandbox/CProgram/ASTanalysis/CodexUserStudyData/raw_data/632e58e4-4e9b-4311-a12a-13fbc92ad3a3/parts/gen_list_add_item_at_pos.c", "C", 18, 0, 0, 0, 18, 5, 41
"/Users/sbukhari/Sandbox/CProgram/ASTanalysis/CodexUserStudyData/raw_data/632e58e4-4e9b-4311-a12a-13fbc92ad3a3/parts/gen_list_cost_sum.c", "C", 18, 0, 0, 0, 8, 5, 31
"/Users/sbukhari/Sandbox/CProgram/ASTanalysis/CodexUserStudyData/raw_data/632e58e4-4e9b-4311-a12a-13fbc92ad3a3/parts/gen_list_deduplicate.c", "C", 18, 0, 0, 0, 10, 5, 33
"/Users/sbukhari/Sandbox/CProgram/ASTanalysis/CodexUserStudyData/raw_data/632e58e4-4e9b-4311-a12a-13fbc92ad3a3/parts/gen_list_find_highest_price_item_position.c", "C", 18, 0, 0, 0, 8, 5, 31
"/Users/sbukhari/Sandbox/CProgram/ASTanalysis/CodexUserStudyData/raw_data/632e58e4-4e9b-4311-a12a-13fbc92ad3a3/parts/gen_list_init.c", "C", 19, 0, 0, 0, 6, 6, 31
"/Users/sbukhari/Sandbox/CProgram/ASTanalysis/CodexUserStudyData/raw_data/632e58e4-4e9b-4311-a12a-13fbc92ad3a3/parts/gen_list_item_to_string.c", "C", 17, 0, 0, 0, 11, 5, 33
"/Users/sbukhari/Sandbox/CProgram/ASTanalysis/CodexUserStudyData/raw_data/632e58e4-4e9b-4311-a12a-13fbc92ad3a3/parts/gen_list_load.c", "C", 18, 0, 0, 0, 12, 5, 35
"/Users/sbukhari/Sandbox/CProgram/ASTanalysis/CodexUserStudyData/raw_data/632e58e4-4e9b-4311-a12a-13fbc92ad3a3/parts/gen_list_print.c", "C", 17, 0, 0, 0, 20, 5, 42
"/Users/sbukhari/Sandbox/CProgram/ASTanalysis/CodexUserStudyData/raw_data/632e58e4-4e9b-4311-a12a-13fbc92ad3a3/parts/gen_list_remove_item_at_pos.c", "C", 18, 0, 0, 0, 8, 5, 31
"/Users/sbukhari/Sandbox/CProgram/ASTanalysis/CodexUserStudyData/raw_data/632e58e4-4e9b-4311-a12a-13fbc92ad3a3/parts/gen_list_save.c", "C", 18, 0, 0, 0, 11, 5, 34
"/Users/sbukhari/Sandbox/CProgram/ASTanalysis/CodexUserStudyData/raw_data/632e58e4-4e9b-4311-a12a-13fbc92ad3a3/parts/gen_list_swap_item_positions.c", "C", 17, 0, 0, 0, 8, 5, 30
"/Users/sbukhari/Sandbox/CProgram/ASTanalysis/CodexUserStudyData/raw_data/632e58e4-4e9b-4311-a12a-13fbc92ad3a3/parts/gen_list_update_item_at_pos.c", "C", 17, 0, 0, 0, 8, 5, 30
"/Users/sbukhari/Sandbox/CProgram/ASTanalysis/CodexUserStudyData/raw_data/632e58e4-4e9b-4311-a12a-13fbc92ad3a3/ref_testsuite.json", "JSON", 0, 323, 0, 0, 0, 1, 324
"/Users/sbukhari/Sandbox/CProgram/ASTanalysis/CodexUserStudyData/raw_data/632e58e4-4e9b-4311-a12a-13fbc92ad3a3/ref_testsuite_asan.json", "JSON", 0, 323, 0, 0, 0, 1, 324
"/Users/sbukhari/Sandbox/CProgram/ASTanalysis/CodexUserStudyData/raw_data/632e58e4-4e9b-4311-a12a-13fbc92ad3a3/ref_testsuite_asan_noleak.json", "JSON", 0, 323, 0, 0, 0, 1, 324
"/Users/sbukhari/Sandbox/CProgram/ASTanalysis/CodexUserStudyData/raw_data/6c026517-fcff-496b-a8d2-3b99e3714fa4/api_report.json", "JSON", 0, 14, 0, 0, 0, 1, 15
"/Users/sbukhari/Sandbox/CProgram/ASTanalysis/CodexUserStudyData/raw_data/6c026517-fcff-496b-a8d2-3b99e3714fa4/list.c", "C", 69, 0, 0, 0, 85, 23, 177
"/Users/sbukhari/Sandbox/CProgram/ASTanalysis/CodexUserStudyData/raw_data/6c026517-fcff-496b-a8d2-3b99e3714fa4/orig_testsuite.json", "JSON", 0, 92, 0, 0, 0, 1, 93
"/Users/sbukhari/Sandbox/CProgram/ASTanalysis/CodexUserStudyData/raw_data/6c026517-fcff-496b-a8d2-3b99e3714fa4/orig_testsuite_asan.json", "JSON", 0, 92, 0, 0, 0, 1, 93
"/Users/sbukhari/Sandbox/CProgram/ASTanalysis/CodexUserStudyData/raw_data/6c026517-fcff-496b-a8d2-3b99e3714fa4/orig_testsuite_asan_noleak.json", "JSON", 0, 92, 0, 0, 0, 1, 93
"/Users/sbukhari/Sandbox/CProgram/ASTanalysis/CodexUserStudyData/raw_data/6c026517-fcff-496b-a8d2-3b99e3714fa4/parts/gen_list_add_item_at_pos.c", "C", 18, 0, 0, 0, 18, 5, 41
"/Users/sbukhari/Sandbox/CProgram/ASTanalysis/CodexUserStudyData/raw_data/6c026517-fcff-496b-a8d2-3b99e3714fa4/parts/gen_list_cost_sum.c", "C", 18, 0, 0, 0, 8, 5, 31
"/Users/sbukhari/Sandbox/CProgram/ASTanalysis/CodexUserStudyData/raw_data/6c026517-fcff-496b-a8d2-3b99e3714fa4/parts/gen_list_deduplicate.c", "C", 18, 0, 0, 0, 11, 5, 34
"/Users/sbukhari/Sandbox/CProgram/ASTanalysis/CodexUserStudyData/raw_data/6c026517-fcff-496b-a8d2-3b99e3714fa4/parts/gen_list_find_highest_price_item_position.c", "C", 18, 0, 0, 0, 8, 5, 31
"/Users/sbukhari/Sandbox/CProgram/ASTanalysis/CodexUserStudyData/raw_data/6c026517-fcff-496b-a8d2-3b99e3714fa4/parts/gen_list_init.c", "C", 19, 0, 0, 0, 7, 6, 32
"/Users/sbukhari/Sandbox/CProgram/ASTanalysis/CodexUserStudyData/raw_data/6c026517-fcff-496b-a8d2-3b99e3714fa4/parts/gen_list_item_to_string.c", "C", 17, 0, 0, 0, 11, 5, 33
"/Users/sbukhari/Sandbox/CProgram/ASTanalysis/CodexUserStudyData/raw_data/6c026517-fcff-496b-a8d2-3b99e3714fa4/parts/gen_list_load.c", "C", 18, 0, 0, 0, 14, 7, 39
"/Users/sbukhari/Sandbox/CProgram/ASTanalysis/CodexUserStudyData/raw_data/6c026517-fcff-496b-a8d2-3b99e3714fa4/parts/gen_list_print.c", "C", 17, 0, 0, 0, 20, 5, 42
"/Users/sbukhari/Sandbox/CProgram/ASTanalysis/CodexUserStudyData/raw_data/6c026517-fcff-496b-a8d2-3b99e3714fa4/parts/gen_list_remove_item_at_pos.c", "C", 18, 0, 0, 0, 8, 5, 31
"/Users/sbukhari/Sandbox/CProgram/ASTanalysis/CodexUserStudyData/raw_data/6c026517-fcff-496b-a8d2-3b99e3714fa4/parts/gen_list_save.c", "C", 18, 0, 0, 0, 11, 5, 34
"/Users/sbukhari/Sandbox/CProgram/ASTanalysis/CodexUserStudyData/raw_data/6c026517-fcff-496b-a8d2-3b99e3714fa4/parts/gen_list_swap_item_positions.c", "C", 17, 0, 0, 0, 8, 5, 30
"/Users/sbukhari/Sandbox/CProgram/ASTanalysis/CodexUserStudyData/raw_data/6c026517-fcff-496b-a8d2-3b99e3714fa4/parts/gen_list_update_item_at_pos.c", "C", 17, 0, 0, 0, 8, 5, 30
"/Users/sbukhari/Sandbox/CProgram/ASTanalysis/CodexUserStudyData/raw_data/6c026517-fcff-496b-a8d2-3b99e3714fa4/ref_testsuite.json", "JSON", 0, 323, 0, 0, 0, 1, 324
"/Users/sbukhari/Sandbox/CProgram/ASTanalysis/CodexUserStudyData/raw_data/6c026517-fcff-496b-a8d2-3b99e3714fa4/ref_testsuite_asan.json", "JSON", 0, 323, 0, 0, 0, 1, 324
"/Users/sbukhari/Sandbox/CProgram/ASTanalysis/CodexUserStudyData/raw_data/6c026517-fcff-496b-a8d2-3b99e3714fa4/ref_testsuite_asan_noleak.json", "JSON", 0, 323, 0, 0, 0, 1, 324
"/Users/sbukhari/Sandbox/CProgram/ASTanalysis/CodexUserStudyData/raw_data/7193a853-f8dd-423a-90be-39d0023d598e/api_report.json", "JSON", 0, 14, 0, 0, 0, 1, 15
"/Users/sbukhari/Sandbox/CProgram/ASTanalysis/CodexUserStudyData/raw_data/7193a853-f8dd-423a-90be-39d0023d598e/list.c", "C", 193, 0, 0, 0, 72, 52, 317
"/Users/sbukhari/Sandbox/CProgram/ASTanalysis/CodexUserStudyData/raw_data/7193a853-f8dd-423a-90be-39d0023d598e/orig_testsuite.json", "JSON", 0, 92, 0, 0, 0, 1, 93
"/Users/sbukhari/Sandbox/CProgram/ASTanalysis/CodexUserStudyData/raw_data/7193a853-f8dd-423a-90be-39d0023d598e/orig_testsuite_asan.json", "JSON", 0, 92, 0, 0, 0, 1, 93
"/Users/sbukhari/Sandbox/CProgram/ASTanalysis/CodexUserStudyData/raw_data/7193a853-f8dd-423a-90be-39d0023d598e/orig_testsuite_asan_noleak.json", "JSON", 0, 92, 0, 0, 0, 1, 93
"/Users/sbukhari/Sandbox/CProgram/ASTanalysis/CodexUserStudyData/raw_data/7193a853-f8dd-423a-90be-39d0023d598e/parts/gen_list_add_item_at_pos.c", "C", 42, 0, 0, 0, 20, 11, 73
"/Users/sbukhari/Sandbox/CProgram/ASTanalysis/CodexUserStudyData/raw_data/7193a853-f8dd-423a-90be-39d0023d598e/parts/gen_list_cost_sum.c", "C", 27, 0, 0, 0, 9, 10, 46
"/Users/sbukhari/Sandbox/CProgram/ASTanalysis/CodexUserStudyData/raw_data/7193a853-f8dd-423a-90be-39d0023d598e/parts/gen_list_deduplicate.c", "C", 22, 0, 0, 0, 10, 7, 39
"/Users/sbukhari/Sandbox/CProgram/ASTanalysis/CodexUserStudyData/raw_data/7193a853-f8dd-423a-90be-39d0023d598e/parts/gen_list_find_highest_price_item_position.c", "C", 30, 0, 0, 0, 9, 9, 48
"/Users/sbukhari/Sandbox/CProgram/ASTanalysis/CodexUserStudyData/raw_data/7193a853-f8dd-423a-90be-39d0023d598e/parts/gen_list_init.c", "C", 19, 0, 0, 0, 6, 6, 31
"/Users/sbukhari/Sandbox/CProgram/ASTanalysis/CodexUserStudyData/raw_data/7193a853-f8dd-423a-90be-39d0023d598e/parts/gen_list_item_to_string.c", "C", 18, 0, 0, 0, 14, 6, 38
"/Users/sbukhari/Sandbox/CProgram/ASTanalysis/CodexUserStudyData/raw_data/7193a853-f8dd-423a-90be-39d0023d598e/parts/gen_list_load.c", "C", 18, 0, 0, 0, 11, 5, 34
"/Users/sbukhari/Sandbox/CProgram/ASTanalysis/CodexUserStudyData/raw_data/7193a853-f8dd-423a-90be-39d0023d598e/parts/gen_list_print.c", "C", 26, 0, 0, 0, 20, 5, 51
"/Users/sbukhari/Sandbox/CProgram/ASTanalysis/CodexUserStudyData/raw_data/7193a853-f8dd-423a-90be-39d0023d598e/parts/gen_list_remove_item_at_pos.c", "C", 38, 0, 0, 0, 10, 10, 58
"/Users/sbukhari/Sandbox/CProgram/ASTanalysis/CodexUserStudyData/raw_data/7193a853-f8dd-423a-90be-39d0023d598e/parts/gen_list_save.c", "C", 18, 0, 0, 0, 11, 7, 36
"/Users/sbukhari/Sandbox/CProgram/ASTanalysis/CodexUserStudyData/raw_data/7193a853-f8dd-423a-90be-39d0023d598e/parts/gen_list_swap_item_positions.c", "C", 58, 0, 0, 0, 13, 12, 83
"/Users/sbukhari/Sandbox/CProgram/ASTanalysis/CodexUserStudyData/raw_data/7193a853-f8dd-423a-90be-39d0023d598e/parts/gen_list_update_item_at_pos.c", "C", 32, 0, 0, 0, 11, 8, 51
"/Users/sbukhari/Sandbox/CProgram/ASTanalysis/CodexUserStudyData/raw_data/7193a853-f8dd-423a-90be-39d0023d598e/ref_testsuite.json", "JSON", 0, 323, 0, 0, 0, 1, 324
"/Users/sbukhari/Sandbox/CProgram/ASTanalysis/CodexUserStudyData/raw_data/7193a853-f8dd-423a-90be-39d0023d598e/ref_testsuite_asan.json", "JSON", 0, 323, 0, 0, 0, 1, 324
"/Users/sbukhari/Sandbox/CProgram/ASTanalysis/CodexUserStudyData/raw_data/7193a853-f8dd-423a-90be-39d0023d598e/ref_testsuite_asan_noleak.json", "JSON", 0, 323, 0, 0, 0, 1, 324
"/Users/sbukhari/Sandbox/CProgram/ASTanalysis/CodexUserStudyData/raw_data/74a8a6f6-fdda-4725-b99d-e6089cf74b51/api_report.json", "JSON", 0, 14, 0, 0, 0, 1, 15
"/Users/sbukhari/Sandbox/CProgram/ASTanalysis/CodexUserStudyData/raw_data/74a8a6f6-fdda-4725-b99d-e6089cf74b51/list.c", "C", 70, 0, 0, 0, 59, 17, 146
"/Users/sbukhari/Sandbox/CProgram/ASTanalysis/CodexUserStudyData/raw_data/74a8a6f6-fdda-4725-b99d-e6089cf74b51/orig_testsuite.json", "JSON", 0, 92, 0, 0, 0, 1, 93
"/Users/sbukhari/Sandbox/CProgram/ASTanalysis/CodexUserStudyData/raw_data/74a8a6f6-fdda-4725-b99d-e6089cf74b51/orig_testsuite_asan.json", "JSON", 0, 92, 0, 0, 0, 1, 93
"/Users/sbukhari/Sandbox/CProgram/ASTanalysis/CodexUserStudyData/raw_data/74a8a6f6-fdda-4725-b99d-e6089cf74b51/orig_testsuite_asan_noleak.json", "JSON", 0, 92, 0, 0, 0, 1, 93
"/Users/sbukhari/Sandbox/CProgram/ASTanalysis/CodexUserStudyData/raw_data/74a8a6f6-fdda-4725-b99d-e6089cf74b51/parts/gen_list_add_item_at_pos.c", "C", 26, 0, 0, 0, 18, 8, 52
"/Users/sbukhari/Sandbox/CProgram/ASTanalysis/CodexUserStudyData/raw_data/74a8a6f6-fdda-4725-b99d-e6089cf74b51/parts/gen_list_cost_sum.c", "C", 18, 0, 0, 0, 8, 5, 31
"/Users/sbukhari/Sandbox/CProgram/ASTanalysis/CodexUserStudyData/raw_data/74a8a6f6-fdda-4725-b99d-e6089cf74b51/parts/gen_list_deduplicate.c", "C", 18, 0, 0, 0, 5, 4, 27
"/Users/sbukhari/Sandbox/CProgram/ASTanalysis/CodexUserStudyData/raw_data/74a8a6f6-fdda-4725-b99d-e6089cf74b51/parts/gen_list_find_highest_price_item_position.c", "C", 18, 0, 0, 0, 8, 5, 31
"/Users/sbukhari/Sandbox/CProgram/ASTanalysis/CodexUserStudyData/raw_data/74a8a6f6-fdda-4725-b99d-e6089cf74b51/parts/gen_list_init.c", "C", 19, 0, 0, 0, 6, 6, 31
"/Users/sbukhari/Sandbox/CProgram/ASTanalysis/CodexUserStudyData/raw_data/74a8a6f6-fdda-4725-b99d-e6089cf74b51/parts/gen_list_item_to_string.c", "C", 17, 0, 0, 0, 11, 5, 33
"/Users/sbukhari/Sandbox/CProgram/ASTanalysis/CodexUserStudyData/raw_data/74a8a6f6-fdda-4725-b99d-e6089cf74b51/parts/gen_list_load.c", "C", 18, 0, 0, 0, 12, 5, 35
"/Users/sbukhari/Sandbox/CProgram/ASTanalysis/CodexUserStudyData/raw_data/74a8a6f6-fdda-4725-b99d-e6089cf74b51/parts/gen_list_print.c", "C", 25, 0, 0, 0, 19, 5, 49
"/Users/sbukhari/Sandbox/CProgram/ASTanalysis/CodexUserStudyData/raw_data/74a8a6f6-fdda-4725-b99d-e6089cf74b51/parts/gen_list_remove_item_at_pos.c", "C", 18, 0, 0, 0, 8, 5, 31
"/Users/sbukhari/Sandbox/CProgram/ASTanalysis/CodexUserStudyData/raw_data/74a8a6f6-fdda-4725-b99d-e6089cf74b51/parts/gen_list_save.c", "C", 18, 0, 0, 0, 11, 5, 34
"/Users/sbukhari/Sandbox/CProgram/ASTanalysis/CodexUserStudyData/raw_data/74a8a6f6-fdda-4725-b99d-e6089cf74b51/parts/gen_list_swap_item_positions.c", "C", 17, 0, 0, 0, 8, 5, 30
"/Users/sbukhari/Sandbox/CProgram/ASTanalysis/CodexUserStudyData/raw_data/74a8a6f6-fdda-4725-b99d-e6089cf74b51/parts/gen_list_update_item_at_pos.c", "C", 17, 0, 0, 0, 8, 5, 30
"/Users/sbukhari/Sandbox/CProgram/ASTanalysis/CodexUserStudyData/raw_data/74a8a6f6-fdda-4725-b99d-e6089cf74b51/ref_testsuite.json", "JSON", 0, 323, 0, 0, 0, 1, 324
"/Users/sbukhari/Sandbox/CProgram/ASTanalysis/CodexUserStudyData/raw_data/74a8a6f6-fdda-4725-b99d-e6089cf74b51/ref_testsuite_asan.json", "JSON", 0, 323, 0, 0, 0, 1, 324
"/Users/sbukhari/Sandbox/CProgram/ASTanalysis/CodexUserStudyData/raw_data/74a8a6f6-fdda-4725-b99d-e6089cf74b51/ref_testsuite_asan_noleak.json", "JSON", 0, 323, 0, 0, 0, 1, 324
"/Users/sbukhari/Sandbox/CProgram/ASTanalysis/CodexUserStudyData/raw_data/74bd8618-cc17-42a6-8657-abebc4b6b500/api_report.json", "JSON", 0, 14, 0, 0, 0, 1, 15
"/Users/sbukhari/Sandbox/CProgram/ASTanalysis/CodexUserStudyData/raw_data/74bd8618-cc17-42a6-8657-abebc4b6b500/list.c", "C", 147, 0, 0, 0, 84, 26, 257
"/Users/sbukhari/Sandbox/CProgram/ASTanalysis/CodexUserStudyData/raw_data/74bd8618-cc17-42a6-8657-abebc4b6b500/orig_testsuite.json", "JSON", 0, 92, 0, 0, 0, 1, 93
"/Users/sbukhari/Sandbox/CProgram/ASTanalysis/CodexUserStudyData/raw_data/74bd8618-cc17-42a6-8657-abebc4b6b500/orig_testsuite_asan.json", "JSON", 0, 92, 0, 0, 0, 1, 93
"/Users/sbukhari/Sandbox/CProgram/ASTanalysis/CodexUserStudyData/raw_data/74bd8618-cc17-42a6-8657-abebc4b6b500/orig_testsuite_asan_noleak.json", "JSON", 0, 92, 0, 0, 0, 1, 93
"/Users/sbukhari/Sandbox/CProgram/ASTanalysis/CodexUserStudyData/raw_data/74bd8618-cc17-42a6-8657-abebc4b6b500/parts/gen_list_add_item_at_pos.c", "C", 35, 0, 0, 0, 21, 8, 64
"/Users/sbukhari/Sandbox/CProgram/ASTanalysis/CodexUserStudyData/raw_data/74bd8618-cc17-42a6-8657-abebc4b6b500/parts/gen_list_cost_sum.c", "C", 18, 0, 0, 0, 8, 5, 31
"/Users/sbukhari/Sandbox/CProgram/ASTanalysis/CodexUserStudyData/raw_data/74bd8618-cc17-42a6-8657-abebc4b6b500/parts/gen_list_deduplicate.c", "C", 18, 0, 0, 0, 10, 5, 33
"/Users/sbukhari/Sandbox/CProgram/ASTanalysis/CodexUserStudyData/raw_data/74bd8618-cc17-42a6-8657-abebc4b6b500/parts/gen_list_find_highest_price_item_position.c", "C", 18, 0, 0, 0, 8, 5, 31
"/Users/sbukhari/Sandbox/CProgram/ASTanalysis/CodexUserStudyData/raw_data/74bd8618-cc17-42a6-8657-abebc4b6b500/parts/gen_list_init.c", "C", 19, 0, 0, 0, 6, 6, 31
"/Users/sbukhari/Sandbox/CProgram/ASTanalysis/CodexUserStudyData/raw_data/74bd8618-cc17-42a6-8657-abebc4b6b500/parts/gen_list_item_to_string.c", "C", 26, 0, 0, 0, 18, 6, 50
"/Users/sbukhari/Sandbox/CProgram/ASTanalysis/CodexUserStudyData/raw_data/74bd8618-cc17-42a6-8657-abebc4b6b500/parts/gen_list_load.c", "C", 18, 0, 0, 0, 12, 5, 35
"/Users/sbukhari/Sandbox/CProgram/ASTanalysis/CodexUserStudyData/raw_data/74bd8618-cc17-42a6-8657-abebc4b6b500/parts/gen_list_print.c", "C", 23, 0, 0, 0, 23, 5, 51
"/Users/sbukhari/Sandbox/CProgram/ASTanalysis/CodexUserStudyData/raw_data/74bd8618-cc17-42a6-8657-abebc4b6b500/parts/gen_list_remove_item_at_pos.c", "C", 33, 0, 0, 0, 13, 6, 52
"/Users/sbukhari/Sandbox/CProgram/ASTanalysis/CodexUserStudyData/raw_data/74bd8618-cc17-42a6-8657-abebc4b6b500/parts/gen_list_save.c", "C", 18, 0, 0, 0, 11, 5, 34
"/Users/sbukhari/Sandbox/CProgram/ASTanalysis/CodexUserStudyData/raw_data/74bd8618-cc17-42a6-8657-abebc4b6b500/parts/gen_list_swap_item_positions.c", "C", 44, 0, 0, 0, 12, 6, 62
"/Users/sbukhari/Sandbox/CProgram/ASTanalysis/CodexUserStudyData/raw_data/74bd8618-cc17-42a6-8657-abebc4b6b500/parts/gen_list_update_item_at_pos.c", "C", 32, 0, 0, 0, 12, 6, 50
"/Users/sbukhari/Sandbox/CProgram/ASTanalysis/CodexUserStudyData/raw_data/74bd8618-cc17-42a6-8657-abebc4b6b500/ref_testsuite.json", "JSON", 0, 323, 0, 0, 0, 1, 324
"/Users/sbukhari/Sandbox/CProgram/ASTanalysis/CodexUserStudyData/raw_data/74bd8618-cc17-42a6-8657-abebc4b6b500/ref_testsuite_asan.json", "JSON", 0, 323, 0, 0, 0, 1, 324
"/Users/sbukhari/Sandbox/CProgram/ASTanalysis/CodexUserStudyData/raw_data/74bd8618-cc17-42a6-8657-abebc4b6b500/ref_testsuite_asan_noleak.json", "JSON", 0, 323, 0, 0, 0, 1, 324
"/Users/sbukhari/Sandbox/CProgram/ASTanalysis/CodexUserStudyData/raw_data/752045ea-d911-4015-a0e5-66f513cb8751/api_report.json", "JSON", 0, 14, 0, 0, 0, 1, 15
"/Users/sbukhari/Sandbox/CProgram/ASTanalysis/CodexUserStudyData/raw_data/752045ea-d911-4015-a0e5-66f513cb8751/list.c", "C", 73, 0, 0, 0, 83, 19, 175
"/Users/sbukhari/Sandbox/CProgram/ASTanalysis/CodexUserStudyData/raw_data/752045ea-d911-4015-a0e5-66f513cb8751/orig_testsuite.json", "JSON", 0, 92, 0, 0, 0, 1, 93
"/Users/sbukhari/Sandbox/CProgram/ASTanalysis/CodexUserStudyData/raw_data/752045ea-d911-4015-a0e5-66f513cb8751/orig_testsuite_asan.json", "JSON", 0, 92, 0, 0, 0, 1, 93
"/Users/sbukhari/Sandbox/CProgram/ASTanalysis/CodexUserStudyData/raw_data/752045ea-d911-4015-a0e5-66f513cb8751/orig_testsuite_asan_noleak.json", "JSON", 0, 92, 0, 0, 0, 1, 93
"/Users/sbukhari/Sandbox/CProgram/ASTanalysis/CodexUserStudyData/raw_data/752045ea-d911-4015-a0e5-66f513cb8751/parts/gen_list_add_item_at_pos.c", "C", 22, 0, 0, 0, 21, 5, 48
"/Users/sbukhari/Sandbox/CProgram/ASTanalysis/CodexUserStudyData/raw_data/752045ea-d911-4015-a0e5-66f513cb8751/parts/gen_list_cost_sum.c", "C", 18, 0, 0, 0, 8, 5, 31
"/Users/sbukhari/Sandbox/CProgram/ASTanalysis/CodexUserStudyData/raw_data/752045ea-d911-4015-a0e5-66f513cb8751/parts/gen_list_deduplicate.c", "C", 18, 0, 0, 0, 10, 5, 33
"/Users/sbukhari/Sandbox/CProgram/ASTanalysis/CodexUserStudyData/raw_data/752045ea-d911-4015-a0e5-66f513cb8751/parts/gen_list_find_highest_price_item_position.c", "C", 18, 0, 0, 0, 8, 5, 31
"/Users/sbukhari/Sandbox/CProgram/ASTanalysis/CodexUserStudyData/raw_data/752045ea-d911-4015-a0e5-66f513cb8751/parts/gen_list_init.c", "C", 19, 0, 0, 0, 6, 6, 31
"/Users/sbukhari/Sandbox/CProgram/ASTanalysis/CodexUserStudyData/raw_data/752045ea-d911-4015-a0e5-66f513cb8751/parts/gen_list_item_to_string.c", "C", 17, 0, 0, 0, 11, 5, 33
"/Users/sbukhari/Sandbox/CProgram/ASTanalysis/CodexUserStudyData/raw_data/752045ea-d911-4015-a0e5-66f513cb8751/parts/gen_list_load.c", "C", 18, 0, 0, 0, 12, 5, 35
"/Users/sbukhari/Sandbox/CProgram/ASTanalysis/CodexUserStudyData/raw_data/752045ea-d911-4015-a0e5-66f513cb8751/parts/gen_list_print.c", "C", 26, 0, 0, 0, 20, 5, 51
"/Users/sbukhari/Sandbox/CProgram/ASTanalysis/CodexUserStudyData/raw_data/752045ea-d911-4015-a0e5-66f513cb8751/parts/gen_list_remove_item_at_pos.c", "C", 18, 0, 0, 0, 10, 5, 33
"/Users/sbukhari/Sandbox/CProgram/ASTanalysis/CodexUserStudyData/raw_data/752045ea-d911-4015-a0e5-66f513cb8751/parts/gen_list_save.c", "C", 18, 0, 0, 0, 11, 5, 34
"/Users/sbukhari/Sandbox/CProgram/ASTanalysis/CodexUserStudyData/raw_data/752045ea-d911-4015-a0e5-66f513cb8751/parts/gen_list_swap_item_positions.c", "C", 17, 0, 0, 0, 8, 5, 30
"/Users/sbukhari/Sandbox/CProgram/ASTanalysis/CodexUserStudyData/raw_data/752045ea-d911-4015-a0e5-66f513cb8751/parts/gen_list_update_item_at_pos.c", "C", 19, 0, 0, 0, 19, 6, 44
"/Users/sbukhari/Sandbox/CProgram/ASTanalysis/CodexUserStudyData/raw_data/752045ea-d911-4015-a0e5-66f513cb8751/ref_testsuite.json", "JSON", 0, 323, 0, 0, 0, 1, 324
"/Users/sbukhari/Sandbox/CProgram/ASTanalysis/CodexUserStudyData/raw_data/752045ea-d911-4015-a0e5-66f513cb8751/ref_testsuite_asan.json", "JSON", 0, 323, 0, 0, 0, 1, 324
"/Users/sbukhari/Sandbox/CProgram/ASTanalysis/CodexUserStudyData/raw_data/752045ea-d911-4015-a0e5-66f513cb8751/ref_testsuite_asan_noleak.json", "JSON", 0, 323, 0, 0, 0, 1, 324
"/Users/sbukhari/Sandbox/CProgram/ASTanalysis/CodexUserStudyData/raw_data/833d22d1-766e-4e96-af92-180a3c4a2d99/api_report.json", "JSON", 0, 14, 0, 0, 0, 1, 15
"/Users/sbukhari/Sandbox/CProgram/ASTanalysis/CodexUserStudyData/raw_data/833d22d1-766e-4e96-af92-180a3c4a2d99/list.c", "C", 241, 0, 0, 0, 62, 45, 348
"/Users/sbukhari/Sandbox/CProgram/ASTanalysis/CodexUserStudyData/raw_data/833d22d1-766e-4e96-af92-180a3c4a2d99/orig_testsuite.json", "JSON", 0, 92, 0, 0, 0, 1, 93
"/Users/sbukhari/Sandbox/CProgram/ASTanalysis/CodexUserStudyData/raw_data/833d22d1-766e-4e96-af92-180a3c4a2d99/orig_testsuite_asan.json", "JSON", 0, 92, 0, 0, 0, 1, 93
"/Users/sbukhari/Sandbox/CProgram/ASTanalysis/CodexUserStudyData/raw_data/833d22d1-766e-4e96-af92-180a3c4a2d99/orig_testsuite_asan_noleak.json", "JSON", 0, 92, 0, 0, 0, 1, 93
"/Users/sbukhari/Sandbox/CProgram/ASTanalysis/CodexUserStudyData/raw_data/833d22d1-766e-4e96-af92-180a3c4a2d99/parts/gen_list_add_item_at_pos.c", "C", 35, 0, 0, 0, 18, 5, 58
"/Users/sbukhari/Sandbox/CProgram/ASTanalysis/CodexUserStudyData/raw_data/833d22d1-766e-4e96-af92-180a3c4a2d99/parts/gen_list_cost_sum.c", "C", 24, 0, 0, 0, 8, 7, 39
"/Users/sbukhari/Sandbox/CProgram/ASTanalysis/CodexUserStudyData/raw_data/833d22d1-766e-4e96-af92-180a3c4a2d99/parts/gen_list_deduplicate.c", "C", 54, 0, 0, 0, 12, 12, 78
"/Users/sbukhari/Sandbox/CProgram/ASTanalysis/CodexUserStudyData/raw_data/833d22d1-766e-4e96-af92-180a3c4a2d99/parts/gen_list_find_highest_price_item_position.c", "C", 30, 0, 0, 0, 8, 7, 45
"/Users/sbukhari/Sandbox/CProgram/ASTanalysis/CodexUserStudyData/raw_data/833d22d1-766e-4e96-af92-180a3c4a2d99/parts/gen_list_init.c", "C", 19, 0, 0, 0, 6, 6, 31
"/Users/sbukhari/Sandbox/CProgram/ASTanalysis/CodexUserStudyData/raw_data/833d22d1-766e-4e96-af92-180a3c4a2d99/parts/gen_list_item_to_string.c", "C", 19, 0, 0, 0, 14, 6, 39
"/Users/sbukhari/Sandbox/CProgram/ASTanalysis/CodexUserStudyData/raw_data/833d22d1-766e-4e96-af92-180a3c4a2d99/parts/gen_list_load.c", "C", 38, 0, 0, 0, 18, 6, 62
"/Users/sbukhari/Sandbox/CProgram/ASTanalysis/CodexUserStudyData/raw_data/833d22d1-766e-4e96-af92-180a3c4a2d99/parts/gen_list_print.c", "C", 30, 0, 0, 0, 23, 7, 60
"/Users/sbukhari/Sandbox/CProgram/ASTanalysis/CodexUserStudyData/raw_data/833d22d1-766e-4e96-af92-180a3c4a2d99/parts/gen_list_remove_item_at_pos.c", "C", 35, 0, 0, 0, 10, 7, 52
"/Users/sbukhari/Sandbox/CProgram/ASTanalysis/CodexUserStudyData/raw_data/833d22d1-766e-4e96-af92-180a3c4a2d99/parts/gen_list_save.c", "C", 25, 0, 0, 0, 14, 10, 49
"/Users/sbukhari/Sandbox/CProgram/ASTanalysis/CodexUserStudyData/raw_data/833d22d1-766e-4e96-af92-180a3c4a2d99/parts/gen_list_swap_item_positions.c", "C", 49, 0, 0, 0, 8, 8, 65
"/Users/sbukhari/Sandbox/CProgram/ASTanalysis/CodexUserStudyData/raw_data/833d22d1-766e-4e96-af92-180a3c4a2d99/parts/gen_list_update_item_at_pos.c", "C", 38, 0, 0, 0, 12, 6, 56
"/Users/sbukhari/Sandbox/CProgram/ASTanalysis/CodexUserStudyData/raw_data/833d22d1-766e-4e96-af92-180a3c4a2d99/ref_testsuite.json", "JSON", 0, 323, 0, 0, 0, 1, 324
"/Users/sbukhari/Sandbox/CProgram/ASTanalysis/CodexUserStudyData/raw_data/833d22d1-766e-4e96-af92-180a3c4a2d99/ref_testsuite_asan.json", "JSON", 0, 323, 0, 0, 0, 1, 324
"/Users/sbukhari/Sandbox/CProgram/ASTanalysis/CodexUserStudyData/raw_data/833d22d1-766e-4e96-af92-180a3c4a2d99/ref_testsuite_asan_noleak.json", "JSON", 0, 323, 0, 0, 0, 1, 324
"/Users/sbukhari/Sandbox/CProgram/ASTanalysis/CodexUserStudyData/raw_data/925cb076-503f-4a8e-b8d9-0aac9efe5955/api_report.json", "JSON", 0, 14, 0, 0, 0, 1, 15
"/Users/sbukhari/Sandbox/CProgram/ASTanalysis/CodexUserStudyData/raw_data/925cb076-503f-4a8e-b8d9-0aac9efe5955/list.c", "C", 206, 0, 0, 0, 73, 62, 341
"/Users/sbukhari/Sandbox/CProgram/ASTanalysis/CodexUserStudyData/raw_data/925cb076-503f-4a8e-b8d9-0aac9efe5955/orig_testsuite.json", "JSON", 0, 92, 0, 0, 0, 1, 93
"/Users/sbukhari/Sandbox/CProgram/ASTanalysis/CodexUserStudyData/raw_data/925cb076-503f-4a8e-b8d9-0aac9efe5955/orig_testsuite_asan.json", "JSON", 0, 92, 0, 0, 0, 1, 93
"/Users/sbukhari/Sandbox/CProgram/ASTanalysis/CodexUserStudyData/raw_data/925cb076-503f-4a8e-b8d9-0aac9efe5955/orig_testsuite_asan_noleak.json", "JSON", 0, 92, 0, 0, 0, 1, 93
"/Users/sbukhari/Sandbox/CProgram/ASTanalysis/CodexUserStudyData/raw_data/925cb076-503f-4a8e-b8d9-0aac9efe5955/parts/gen_list_add_item_at_pos.c", "C", 55, 0, 0, 0, 18, 5, 78
"/Users/sbukhari/Sandbox/CProgram/ASTanalysis/CodexUserStudyData/raw_data/925cb076-503f-4a8e-b8d9-0aac9efe5955/parts/gen_list_cost_sum.c", "C", 25, 0, 0, 0, 9, 8, 42
"/Users/sbukhari/Sandbox/CProgram/ASTanalysis/CodexUserStudyData/raw_data/925cb076-503f-4a8e-b8d9-0aac9efe5955/parts/gen_list_deduplicate.c", "C", 18, 0, 0, 0, 10, 5, 33
"/Users/sbukhari/Sandbox/CProgram/ASTanalysis/CodexUserStudyData/raw_data/925cb076-503f-4a8e-b8d9-0aac9efe5955/parts/gen_list_find_highest_price_item_position.c", "C", 30, 0, 0, 0, 9, 8, 47
"/Users/sbukhari/Sandbox/CProgram/ASTanalysis/CodexUserStudyData/raw_data/925cb076-503f-4a8e-b8d9-0aac9efe5955/parts/gen_list_init.c", "C", 27, 0, 0, 0, 6, 7, 40
"/Users/sbukhari/Sandbox/CProgram/ASTanalysis/CodexUserStudyData/raw_data/925cb076-503f-4a8e-b8d9-0aac9efe5955/parts/gen_list_item_to_string.c", "C", 33, 0, 0, 0, 16, 6, 55
"/Users/sbukhari/Sandbox/CProgram/ASTanalysis/CodexUserStudyData/raw_data/925cb076-503f-4a8e-b8d9-0aac9efe5955/parts/gen_list_load.c", "C", 18, 0, 0, 0, 10, 5, 33
"/Users/sbukhari/Sandbox/CProgram/ASTanalysis/CodexUserStudyData/raw_data/925cb076-503f-4a8e-b8d9-0aac9efe5955/parts/gen_list_print.c", "C", 29, 0, 0, 0, 20, 5, 54
"/Users/sbukhari/Sandbox/CProgram/ASTanalysis/CodexUserStudyData/raw_data/925cb076-503f-4a8e-b8d9-0aac9efe5955/parts/gen_list_remove_item_at_pos.c", "C", 24, 0, 0, 0, 13, 7, 44
"/Users/sbukhari/Sandbox/CProgram/ASTanalysis/CodexUserStudyData/raw_data/925cb076-503f-4a8e-b8d9-0aac9efe5955/parts/gen_list_save.c", "C", 29, 0, 0, 0, 14, 8, 51
"/Users/sbukhari/Sandbox/CProgram/ASTanalysis/CodexUserStudyData/raw_data/925cb076-503f-4a8e-b8d9-0aac9efe5955/parts/gen_list_swap_item_positions.c", "C", 34, 0, 0, 0, 15, 10, 59
"/Users/sbukhari/Sandbox/CProgram/ASTanalysis/CodexUserStudyData/raw_data/925cb076-503f-4a8e-b8d9-0aac9efe5955/parts/gen_list_update_item_at_pos.c", "C", 24, 0, 0, 0, 13, 7, 44
"/Users/sbukhari/Sandbox/CProgram/ASTanalysis/CodexUserStudyData/raw_data/925cb076-503f-4a8e-b8d9-0aac9efe5955/ref_testsuite.json", "JSON", 0, 323, 0, 0, 0, 1, 324
"/Users/sbukhari/Sandbox/CProgram/ASTanalysis/CodexUserStudyData/raw_data/925cb076-503f-4a8e-b8d9-0aac9efe5955/ref_testsuite_asan.json", "JSON", 0, 323, 0, 0, 0, 1, 324
"/Users/sbukhari/Sandbox/CProgram/ASTanalysis/CodexUserStudyData/raw_data/925cb076-503f-4a8e-b8d9-0aac9efe5955/ref_testsuite_asan_noleak.json", "JSON", 0, 323, 0, 0, 0, 1, 324
"/Users/sbukhari/Sandbox/CProgram/ASTanalysis/CodexUserStudyData/raw_data/949d88c5-3896-4e45-a42e-8bff4c950949/api_report.json", "JSON", 0, 14, 0, 0, 0, 1, 15
"/Users/sbukhari/Sandbox/CProgram/ASTanalysis/CodexUserStudyData/raw_data/949d88c5-3896-4e45-a42e-8bff4c950949/list.c", "C", 72, 0, 0, 0, 88, 18, 178
"/Users/sbukhari/Sandbox/CProgram/ASTanalysis/CodexUserStudyData/raw_data/949d88c5-3896-4e45-a42e-8bff4c950949/orig_testsuite.json", "JSON", 0, 92, 0, 0, 0, 1, 93
"/Users/sbukhari/Sandbox/CProgram/ASTanalysis/CodexUserStudyData/raw_data/949d88c5-3896-4e45-a42e-8bff4c950949/orig_testsuite_asan.json", "JSON", 0, 92, 0, 0, 0, 1, 93
"/Users/sbukhari/Sandbox/CProgram/ASTanalysis/CodexUserStudyData/raw_data/949d88c5-3896-4e45-a42e-8bff4c950949/orig_testsuite_asan_noleak.json", "JSON", 0, 92, 0, 0, 0, 1, 93
"/Users/sbukhari/Sandbox/CProgram/ASTanalysis/CodexUserStudyData/raw_data/949d88c5-3896-4e45-a42e-8bff4c950949/parts/gen_list_add_item_at_pos.c", "C", 23, 0, 0, 0, 30, 5, 58
"/Users/sbukhari/Sandbox/CProgram/ASTanalysis/CodexUserStudyData/raw_data/949d88c5-3896-4e45-a42e-8bff4c950949/parts/gen_list_cost_sum.c", "C", 18, 0, 0, 0, 8, 5, 31
"/Users/sbukhari/Sandbox/CProgram/ASTanalysis/CodexUserStudyData/raw_data/949d88c5-3896-4e45-a42e-8bff4c950949/parts/gen_list_deduplicate.c", "C", 18, 0, 0, 0, 10, 5, 33
"/Users/sbukhari/Sandbox/CProgram/ASTanalysis/CodexUserStudyData/raw_data/949d88c5-3896-4e45-a42e-8bff4c950949/parts/gen_list_find_highest_price_item_position.c", "C", 18, 0, 0, 0, 8, 5, 31
"/Users/sbukhari/Sandbox/CProgram/ASTanalysis/CodexUserStudyData/raw_data/949d88c5-3896-4e45-a42e-8bff4c950949/parts/gen_list_init.c", "C", 19, 0, 0, 0, 6, 6, 31
"/Users/sbukhari/Sandbox/CProgram/ASTanalysis/CodexUserStudyData/raw_data/949d88c5-3896-4e45-a42e-8bff4c950949/parts/gen_list_item_to_string.c", "C", 19, 0, 0, 0, 20, 6, 45
"/Users/sbukhari/Sandbox/CProgram/ASTanalysis/CodexUserStudyData/raw_data/949d88c5-3896-4e45-a42e-8bff4c950949/parts/gen_list_load.c", "C", 18, 0, 0, 0, 12, 5, 35
"/Users/sbukhari/Sandbox/CProgram/ASTanalysis/CodexUserStudyData/raw_data/949d88c5-3896-4e45-a42e-8bff4c950949/parts/gen_list_print.c", "C", 25, 0, 0, 0, 19, 5, 49
"/Users/sbukhari/Sandbox/CProgram/ASTanalysis/CodexUserStudyData/raw_data/949d88c5-3896-4e45-a42e-8bff4c950949/parts/gen_list_remove_item_at_pos.c", "C", 18, 0, 0, 0, 8, 5, 31
"/Users/sbukhari/Sandbox/CProgram/ASTanalysis/CodexUserStudyData/raw_data/949d88c5-3896-4e45-a42e-8bff4c950949/parts/gen_list_save.c", "C", 18, 0, 0, 0, 11, 5, 34
"/Users/sbukhari/Sandbox/CProgram/ASTanalysis/CodexUserStudyData/raw_data/949d88c5-3896-4e45-a42e-8bff4c950949/parts/gen_list_swap_item_positions.c", "C", 17, 0, 0, 0, 8, 5, 30
"/Users/sbukhari/Sandbox/CProgram/ASTanalysis/CodexUserStudyData/raw_data/949d88c5-3896-4e45-a42e-8bff4c950949/parts/gen_list_update_item_at_pos.c", "C", 17, 0, 0, 0, 8, 5, 30
"/Users/sbukhari/Sandbox/CProgram/ASTanalysis/CodexUserStudyData/raw_data/949d88c5-3896-4e45-a42e-8bff4c950949/ref_testsuite.json", "JSON", 0, 323, 0, 0, 0, 1, 324
"/Users/sbukhari/Sandbox/CProgram/ASTanalysis/CodexUserStudyData/raw_data/949d88c5-3896-4e45-a42e-8bff4c950949/ref_testsuite_asan.json", "JSON", 0, 323, 0, 0, 0, 1, 324
"/Users/sbukhari/Sandbox/CProgram/ASTanalysis/CodexUserStudyData/raw_data/949d88c5-3896-4e45-a42e-8bff4c950949/ref_testsuite_asan_noleak.json", "JSON", 0, 323, 0, 0, 0, 1, 324
"/Users/sbukhari/Sandbox/CProgram/ASTanalysis/CodexUserStudyData/raw_data/94cc70d0-7086-4a40-894a-433c90f7d9c4/api_report.json", "JSON", 0, 14, 0, 0, 0, 1, 15
"/Users/sbukhari/Sandbox/CProgram/ASTanalysis/CodexUserStudyData/raw_data/94cc70d0-7086-4a40-894a-433c90f7d9c4/list.c", "C", 205, 0, 0, 0, 56, 35, 296
"/Users/sbukhari/Sandbox/CProgram/ASTanalysis/CodexUserStudyData/raw_data/94cc70d0-7086-4a40-894a-433c90f7d9c4/orig_testsuite.json", "JSON", 0, 92, 0, 0, 0, 1, 93
"/Users/sbukhari/Sandbox/CProgram/ASTanalysis/CodexUserStudyData/raw_data/94cc70d0-7086-4a40-894a-433c90f7d9c4/orig_testsuite_asan.json", "JSON", 0, 92, 0, 0, 0, 1, 93
"/Users/sbukhari/Sandbox/CProgram/ASTanalysis/CodexUserStudyData/raw_data/94cc70d0-7086-4a40-894a-433c90f7d9c4/orig_testsuite_asan_noleak.json", "JSON", 0, 92, 0, 0, 0, 1, 93
"/Users/sbukhari/Sandbox/CProgram/ASTanalysis/CodexUserStudyData/raw_data/94cc70d0-7086-4a40-894a-433c90f7d9c4/parts/gen_list_add_item_at_pos.c", "C", 38, 0, 0, 0, 20, 8, 66
"/Users/sbukhari/Sandbox/CProgram/ASTanalysis/CodexUserStudyData/raw_data/94cc70d0-7086-4a40-894a-433c90f7d9c4/parts/gen_list_cost_sum.c", "C", 23, 0, 0, 0, 7, 5, 35
"/Users/sbukhari/Sandbox/CProgram/ASTanalysis/CodexUserStudyData/raw_data/94cc70d0-7086-4a40-894a-433c90f7d9c4/parts/gen_list_deduplicate.c", "C", 31, 0, 0, 0, 10, 6, 47
"/Users/sbukhari/Sandbox/CProgram/ASTanalysis/CodexUserStudyData/raw_data/94cc70d0-7086-4a40-894a-433c90f7d9c4/parts/gen_list_find_highest_price_item_position.c", "C", 29, 0, 0, 0, 8, 5, 42
"/Users/sbukhari/Sandbox/CProgram/ASTanalysis/CodexUserStudyData/raw_data/94cc70d0-7086-4a40-894a-433c90f7d9c4/parts/gen_list_init.c", "C", 19, 0, 0, 0, 6, 6, 31
"/Users/sbukhari/Sandbox/CProgram/ASTanalysis/CodexUserStudyData/raw_data/94cc70d0-7086-4a40-894a-433c90f7d9c4/parts/gen_list_item_to_string.c", "C", 20, 0, 0, 0, 15, 5, 40
"/Users/sbukhari/Sandbox/CProgram/ASTanalysis/CodexUserStudyData/raw_data/94cc70d0-7086-4a40-894a-433c90f7d9c4/parts/gen_list_load.c", "C", 41, 0, 0, 0, 14, 9, 64
"/Users/sbukhari/Sandbox/CProgram/ASTanalysis/CodexUserStudyData/raw_data/94cc70d0-7086-4a40-894a-433c90f7d9c4/parts/gen_list_print.c", "C", 28, 0, 0, 0, 20, 5, 53
"/Users/sbukhari/Sandbox/CProgram/ASTanalysis/CodexUserStudyData/raw_data/94cc70d0-7086-4a40-894a-433c90f7d9c4/parts/gen_list_remove_item_at_pos.c", "C", 36, 0, 0, 0, 11, 7, 54
"/Users/sbukhari/Sandbox/CProgram/ASTanalysis/CodexUserStudyData/raw_data/94cc70d0-7086-4a40-894a-433c90f7d9c4/parts/gen_list_save.c", "C", 28, 0, 0, 0, 12, 8, 48
"/Users/sbukhari/Sandbox/CProgram/ASTanalysis/CodexUserStudyData/raw_data/94cc70d0-7086-4a40-894a-433c90f7d9c4/parts/gen_list_swap_item_positions.c", "C", 39, 0, 0, 0, 10, 9, 58
"/Users/sbukhari/Sandbox/CProgram/ASTanalysis/CodexUserStudyData/raw_data/94cc70d0-7086-4a40-894a-433c90f7d9c4/parts/gen_list_update_item_at_pos.c", "C", 28, 0, 0, 0, 10, 6, 44
"/Users/sbukhari/Sandbox/CProgram/ASTanalysis/CodexUserStudyData/raw_data/94cc70d0-7086-4a40-894a-433c90f7d9c4/ref_testsuite.json", "JSON", 0, 323, 0, 0, 0, 1, 324
"/Users/sbukhari/Sandbox/CProgram/ASTanalysis/CodexUserStudyData/raw_data/94cc70d0-7086-4a40-894a-433c90f7d9c4/ref_testsuite_asan.json", "JSON", 0, 323, 0, 0, 0, 1, 324
"/Users/sbukhari/Sandbox/CProgram/ASTanalysis/CodexUserStudyData/raw_data/94cc70d0-7086-4a40-894a-433c90f7d9c4/ref_testsuite_asan_noleak.json", "JSON", 0, 323, 0, 0, 0, 1, 324
"/Users/sbukhari/Sandbox/CProgram/ASTanalysis/CodexUserStudyData/raw_data/9702f54c-200b-41f5-9fc4-971af3d86785/api_report.json", "JSON", 0, 14, 0, 0, 0, 1, 15
"/Users/sbukhari/Sandbox/CProgram/ASTanalysis/CodexUserStudyData/raw_data/9702f54c-200b-41f5-9fc4-971af3d86785/list.c", "C", 281, 0, 0, 0, 115, 95, 491
"/Users/sbukhari/Sandbox/CProgram/ASTanalysis/CodexUserStudyData/raw_data/9702f54c-200b-41f5-9fc4-971af3d86785/orig_testsuite.json", "JSON", 0, 92, 0, 0, 0, 1, 93
"/Users/sbukhari/Sandbox/CProgram/ASTanalysis/CodexUserStudyData/raw_data/9702f54c-200b-41f5-9fc4-971af3d86785/orig_testsuite_asan.json", "JSON", 0, 92, 0, 0, 0, 1, 93
"/Users/sbukhari/Sandbox/CProgram/ASTanalysis/CodexUserStudyData/raw_data/9702f54c-200b-41f5-9fc4-971af3d86785/orig_testsuite_asan_noleak.json", "JSON", 0, 92, 0, 0, 0, 1, 93
"/Users/sbukhari/Sandbox/CProgram/ASTanalysis/CodexUserStudyData/raw_data/9702f54c-200b-41f5-9fc4-971af3d86785/parts/gen_list_add_item_at_pos.c", "C", 48, 0, 0, 0, 20, 12, 80
"/Users/sbukhari/Sandbox/CProgram/ASTanalysis/CodexUserStudyData/raw_data/9702f54c-200b-41f5-9fc4-971af3d86785/parts/gen_list_cost_sum.c", "C", 24, 0, 0, 0, 9, 7, 40
"/Users/sbukhari/Sandbox/CProgram/ASTanalysis/CodexUserStudyData/raw_data/9702f54c-200b-41f5-9fc4-971af3d86785/parts/gen_list_deduplicate.c", "C", 58, 0, 0, 0, 24, 21, 103
"/Users/sbukhari/Sandbox/CProgram/ASTanalysis/CodexUserStudyData/raw_data/9702f54c-200b-41f5-9fc4-971af3d86785/parts/gen_list_find_highest_price_item_position.c", "C", 29, 0, 0, 0, 10, 8, 47
"/Users/sbukhari/Sandbox/CProgram/ASTanalysis/CodexUserStudyData/raw_data/9702f54c-200b-41f5-9fc4-971af3d86785/parts/gen_list_init.c", "C", 19, 0, 0, 0, 6, 6, 31
"/Users/sbukhari/Sandbox/CProgram/ASTanalysis/CodexUserStudyData/raw_data/9702f54c-200b-41f5-9fc4-971af3d86785/parts/gen_list_item_to_string.c", "C", 26, 0, 0, 0, 17, 9, 52
"/Users/sbukhari/Sandbox/CProgram/ASTanalysis/CodexUserStudyData/raw_data/9702f54c-200b-41f5-9fc4-971af3d86785/parts/gen_list_load.c", "C", 44, 0, 0, 0, 22, 17, 83
"/Users/sbukhari/Sandbox/CProgram/ASTanalysis/CodexUserStudyData/raw_data/9702f54c-200b-41f5-9fc4-971af3d86785/parts/gen_list_print.c", "C", 32, 0, 0, 0, 21, 10, 63
"/Users/sbukhari/Sandbox/CProgram/ASTanalysis/CodexUserStudyData/raw_data/9702f54c-200b-41f5-9fc4-971af3d86785/parts/gen_list_remove_item_at_pos.c", "C", 38, 0, 0, 0, 27, 12, 77
"/Users/sbukhari/Sandbox/CProgram/ASTanalysis/CodexUserStudyData/raw_data/9702f54c-200b-41f5-9fc4-971af3d86785/parts/gen_list_save.c", "C", 34, 0, 0, 0, 16, 16, 66
"/Users/sbukhari/Sandbox/CProgram/ASTanalysis/CodexUserStudyData/raw_data/9702f54c-200b-41f5-9fc4-971af3d86785/parts/gen_list_swap_item_positions.c", "C", 50, 0, 0, 0, 9, 13, 72
"/Users/sbukhari/Sandbox/CProgram/ASTanalysis/CodexUserStudyData/raw_data/9702f54c-200b-41f5-9fc4-971af3d86785/parts/gen_list_update_item_at_pos.c", "C", 34, 0, 0, 0, 15, 10, 59
"/Users/sbukhari/Sandbox/CProgram/ASTanalysis/CodexUserStudyData/raw_data/9702f54c-200b-41f5-9fc4-971af3d86785/ref_testsuite.json", "JSON", 0, 323, 0, 0, 0, 1, 324
"/Users/sbukhari/Sandbox/CProgram/ASTanalysis/CodexUserStudyData/raw_data/9702f54c-200b-41f5-9fc4-971af3d86785/ref_testsuite_asan.json", "JSON", 0, 323, 0, 0, 0, 1, 324
"/Users/sbukhari/Sandbox/CProgram/ASTanalysis/CodexUserStudyData/raw_data/9702f54c-200b-41f5-9fc4-971af3d86785/ref_testsuite_asan_noleak.json", "JSON", 0, 323, 0, 0, 0, 1, 324
"/Users/sbukhari/Sandbox/CProgram/ASTanalysis/CodexUserStudyData/raw_data/a2ab1ed3-1881-42af-b18d-1197d0ea95ae/api_report.json", "JSON", 0, 14, 0, 0, 0, 1, 15
"/Users/sbukhari/Sandbox/CProgram/ASTanalysis/CodexUserStudyData/raw_data/a2ab1ed3-1881-42af-b18d-1197d0ea95ae/list.c", "C", 120, 0, 0, 0, 67, 21, 208
"/Users/sbukhari/Sandbox/CProgram/ASTanalysis/CodexUserStudyData/raw_data/a2ab1ed3-1881-42af-b18d-1197d0ea95ae/orig_testsuite.json", "JSON", 0, 92, 0, 0, 0, 1, 93
"/Users/sbukhari/Sandbox/CProgram/ASTanalysis/CodexUserStudyData/raw_data/a2ab1ed3-1881-42af-b18d-1197d0ea95ae/orig_testsuite_asan.json", "JSON", 0, 92, 0, 0, 0, 1, 93
"/Users/sbukhari/Sandbox/CProgram/ASTanalysis/CodexUserStudyData/raw_data/a2ab1ed3-1881-42af-b18d-1197d0ea95ae/orig_testsuite_asan_noleak.json", "JSON", 0, 92, 0, 0, 0, 1, 93
"/Users/sbukhari/Sandbox/CProgram/ASTanalysis/CodexUserStudyData/raw_data/a2ab1ed3-1881-42af-b18d-1197d0ea95ae/parts/gen_list_add_item_at_pos.c", "C", 18, 0, 0, 0, 18, 5, 41
"/Users/sbukhari/Sandbox/CProgram/ASTanalysis/CodexUserStudyData/raw_data/a2ab1ed3-1881-42af-b18d-1197d0ea95ae/parts/gen_list_cost_sum.c", "C", 18, 0, 0, 0, 8, 5, 31
"/Users/sbukhari/Sandbox/CProgram/ASTanalysis/CodexUserStudyData/raw_data/a2ab1ed3-1881-42af-b18d-1197d0ea95ae/parts/gen_list_deduplicate.c", "C", 18, 0, 0, 0, 10, 5, 33
"/Users/sbukhari/Sandbox/CProgram/ASTanalysis/CodexUserStudyData/raw_data/a2ab1ed3-1881-42af-b18d-1197d0ea95ae/parts/gen_list_find_highest_price_item_position.c", "C", 18, 0, 0, 0, 8, 5, 31
"/Users/sbukhari/Sandbox/CProgram/ASTanalysis/CodexUserStudyData/raw_data/a2ab1ed3-1881-42af-b18d-1197d0ea95ae/parts/gen_list_init.c", "C", 19, 0, 0, 0, 6, 6, 31
"/Users/sbukhari/Sandbox/CProgram/ASTanalysis/CodexUserStudyData/raw_data/a2ab1ed3-1881-42af-b18d-1197d0ea95ae/parts/gen_list_item_to_string.c", "C", 17, 0, 0, 0, 11, 5, 33
"/Users/sbukhari/Sandbox/CProgram/ASTanalysis/CodexUserStudyData/raw_data/a2ab1ed3-1881-42af-b18d-1197d0ea95ae/parts/gen_list_load.c", "C", 18, 0, 0, 0, 12, 5, 35
"/Users/sbukhari/Sandbox/CProgram/ASTanalysis/CodexUserStudyData/raw_data/a2ab1ed3-1881-42af-b18d-1197d0ea95ae/parts/gen_list_print.c", "C", 22, 0, 0, 0, 20, 5, 47
"/Users/sbukhari/Sandbox/CProgram/ASTanalysis/CodexUserStudyData/raw_data/a2ab1ed3-1881-42af-b18d-1197d0ea95ae/parts/gen_list_remove_item_at_pos.c", "C", 18, 0, 0, 0, 8, 5, 31
"/Users/sbukhari/Sandbox/CProgram/ASTanalysis/CodexUserStudyData/raw_data/a2ab1ed3-1881-42af-b18d-1197d0ea95ae/parts/gen_list_save.c", "C", 18, 0, 0, 0, 11, 5, 34
"/Users/sbukhari/Sandbox/CProgram/ASTanalysis/CodexUserStudyData/raw_data/a2ab1ed3-1881-42af-b18d-1197d0ea95ae/parts/gen_list_swap_item_positions.c", "C", 17, 0, 0, 0, 8, 5, 30
"/Users/sbukhari/Sandbox/CProgram/ASTanalysis/CodexUserStudyData/raw_data/a2ab1ed3-1881-42af-b18d-1197d0ea95ae/parts/gen_list_update_item_at_pos.c", "C", 17, 0, 0, 0, 8, 5, 30
"/Users/sbukhari/Sandbox/CProgram/ASTanalysis/CodexUserStudyData/raw_data/a2ab1ed3-1881-42af-b18d-1197d0ea95ae/ref_testsuite.json", "JSON", 0, 323, 0, 0, 0, 1, 324
"/Users/sbukhari/Sandbox/CProgram/ASTanalysis/CodexUserStudyData/raw_data/a2ab1ed3-1881-42af-b18d-1197d0ea95ae/ref_testsuite_asan.json", "JSON", 0, 323, 0, 0, 0, 1, 324
"/Users/sbukhari/Sandbox/CProgram/ASTanalysis/CodexUserStudyData/raw_data/a2ab1ed3-1881-42af-b18d-1197d0ea95ae/ref_testsuite_asan_noleak.json", "JSON", 0, 323, 0, 0, 0, 1, 324
"/Users/sbukhari/Sandbox/CProgram/ASTanalysis/CodexUserStudyData/raw_data/a391803d-b2e8-47cd-8319-305aae3983bc/api_report.json", "JSON", 0, 14, 0, 0, 0, 1, 15
"/Users/sbukhari/Sandbox/CProgram/ASTanalysis/CodexUserStudyData/raw_data/a391803d-b2e8-47cd-8319-305aae3983bc/list.c", "C", 263, 0, 0, 0, 91, 31, 385
"/Users/sbukhari/Sandbox/CProgram/ASTanalysis/CodexUserStudyData/raw_data/a391803d-b2e8-47cd-8319-305aae3983bc/orig_testsuite.json", "JSON", 0, 92, 0, 0, 0, 1, 93
"/Users/sbukhari/Sandbox/CProgram/ASTanalysis/CodexUserStudyData/raw_data/a391803d-b2e8-47cd-8319-305aae3983bc/orig_testsuite_asan.json", "JSON", 0, 92, 0, 0, 0, 1, 93
"/Users/sbukhari/Sandbox/CProgram/ASTanalysis/CodexUserStudyData/raw_data/a391803d-b2e8-47cd-8319-305aae3983bc/orig_testsuite_asan_noleak.json", "JSON", 0, 92, 0, 0, 0, 1, 93
"/Users/sbukhari/Sandbox/CProgram/ASTanalysis/CodexUserStudyData/raw_data/a391803d-b2e8-47cd-8319-305aae3983bc/parts/gen_list_add_item_at_pos.c", "C", 18, 0, 0, 0, 20, 6, 44
"/Users/sbukhari/Sandbox/CProgram/ASTanalysis/CodexUserStudyData/raw_data/a391803d-b2e8-47cd-8319-305aae3983bc/parts/gen_list_cost_sum.c", "C", 24, 0, 0, 0, 12, 7, 43
"/Users/sbukhari/Sandbox/CProgram/ASTanalysis/CodexUserStudyData/raw_data/a391803d-b2e8-47cd-8319-305aae3983bc/parts/gen_list_deduplicate.c", "C", 55, 0, 0, 0, 18, 6, 79
"/Users/sbukhari/Sandbox/CProgram/ASTanalysis/CodexUserStudyData/raw_data/a391803d-b2e8-47cd-8319-305aae3983bc/parts/gen_list_find_highest_price_item_position.c", "C", 18, 0, 0, 0, 10, 6, 34
"/Users/sbukhari/Sandbox/CProgram/ASTanalysis/CodexUserStudyData/raw_data/a391803d-b2e8-47cd-8319-305aae3983bc/parts/gen_list_init.c", "C", 19, 0, 0, 0, 8, 7, 34
"/Users/sbukhari/Sandbox/CProgram/ASTanalysis/CodexUserStudyData/raw_data/a391803d-b2e8-47cd-8319-305aae3983bc/parts/gen_list_item_to_string.c", "C", 22, 0, 0, 0, 16, 6, 44
"/Users/sbukhari/Sandbox/CProgram/ASTanalysis/CodexUserStudyData/raw_data/a391803d-b2e8-47cd-8319-305aae3983bc/parts/gen_list_load.c", "C", 47, 0, 0, 0, 21, 6, 74
"/Users/sbukhari/Sandbox/CProgram/ASTanalysis/CodexUserStudyData/raw_data/a391803d-b2e8-47cd-8319-305aae3983bc/parts/gen_list_print.c", "C", 17, 0, 0, 0, 22, 6, 45
"/Users/sbukhari/Sandbox/CProgram/ASTanalysis/CodexUserStudyData/raw_data/a391803d-b2e8-47cd-8319-305aae3983bc/parts/gen_list_remove_item_at_pos.c", "C", 18, 0, 0, 0, 10, 6, 34
"/Users/sbukhari/Sandbox/CProgram/ASTanalysis/CodexUserStudyData/raw_data/a391803d-b2e8-47cd-8319-305aae3983bc/parts/gen_list_save.c", "C", 29, 0, 0, 0, 17, 7, 53
"/Users/sbukhari/Sandbox/CProgram/ASTanalysis/CodexUserStudyData/raw_data/a391803d-b2e8-47cd-8319-305aae3983bc/parts/gen_list_swap_item_positions.c", "C", 17, 0, 0, 0, 10, 6, 33
"/Users/sbukhari/Sandbox/CProgram/ASTanalysis/CodexUserStudyData/raw_data/a391803d-b2e8-47cd-8319-305aae3983bc/parts/gen_list_update_item_at_pos.c", "C", 17, 0, 0, 0, 10, 6, 33
"/Users/sbukhari/Sandbox/CProgram/ASTanalysis/CodexUserStudyData/raw_data/a391803d-b2e8-47cd-8319-305aae3983bc/ref_testsuite.json", "JSON", 0, 323, 0, 0, 0, 1, 324
"/Users/sbukhari/Sandbox/CProgram/ASTanalysis/CodexUserStudyData/raw_data/a391803d-b2e8-47cd-8319-305aae3983bc/ref_testsuite_asan.json", "JSON", 0, 323, 0, 0, 0, 1, 324
"/Users/sbukhari/Sandbox/CProgram/ASTanalysis/CodexUserStudyData/raw_data/a391803d-b2e8-47cd-8319-305aae3983bc/ref_testsuite_asan_noleak.json", "JSON", 0, 323, 0, 0, 0, 1, 324
"/Users/sbukhari/Sandbox/CProgram/ASTanalysis/CodexUserStudyData/raw_data/a3edd088-a9ab-4b80-ae98-01ffcfca615b/api_report.json", "JSON", 0, 14, 0, 0, 0, 1, 15
"/Users/sbukhari/Sandbox/CProgram/ASTanalysis/CodexUserStudyData/raw_data/a3edd088-a9ab-4b80-ae98-01ffcfca615b/list.c", "C", 122, 0, 0, 0, 85, 28, 235
"/Users/sbukhari/Sandbox/CProgram/ASTanalysis/CodexUserStudyData/raw_data/a3edd088-a9ab-4b80-ae98-01ffcfca615b/orig_testsuite.json", "JSON", 0, 92, 0, 0, 0, 1, 93
"/Users/sbukhari/Sandbox/CProgram/ASTanalysis/CodexUserStudyData/raw_data/a3edd088-a9ab-4b80-ae98-01ffcfca615b/orig_testsuite_asan.json", "JSON", 0, 92, 0, 0, 0, 1, 93
"/Users/sbukhari/Sandbox/CProgram/ASTanalysis/CodexUserStudyData/raw_data/a3edd088-a9ab-4b80-ae98-01ffcfca615b/orig_testsuite_asan_noleak.json", "JSON", 0, 92, 0, 0, 0, 1, 93
"/Users/sbukhari/Sandbox/CProgram/ASTanalysis/CodexUserStudyData/raw_data/a3edd088-a9ab-4b80-ae98-01ffcfca615b/parts/gen_list_add_item_at_pos.c", "C", 33, 0, 0, 0, 23, 5, 61
"/Users/sbukhari/Sandbox/CProgram/ASTanalysis/CodexUserStudyData/raw_data/a3edd088-a9ab-4b80-ae98-01ffcfca615b/parts/gen_list_cost_sum.c", "C", 18, 0, 0, 0, 8, 5, 31
"/Users/sbukhari/Sandbox/CProgram/ASTanalysis/CodexUserStudyData/raw_data/a3edd088-a9ab-4b80-ae98-01ffcfca615b/parts/gen_list_deduplicate.c", "C", 18, 0, 0, 0, 10, 5, 33
"/Users/sbukhari/Sandbox/CProgram/ASTanalysis/CodexUserStudyData/raw_data/a3edd088-a9ab-4b80-ae98-01ffcfca615b/parts/gen_list_find_highest_price_item_position.c", "C", 18, 0, 0, 0, 8, 5, 31
"/Users/sbukhari/Sandbox/CProgram/ASTanalysis/CodexUserStudyData/raw_data/a3edd088-a9ab-4b80-ae98-01ffcfca615b/parts/gen_list_init.c", "C", 19, 0, 0, 0, 6, 6, 31
"/Users/sbukhari/Sandbox/CProgram/ASTanalysis/CodexUserStudyData/raw_data/a3edd088-a9ab-4b80-ae98-01ffcfca615b/parts/gen_list_item_to_string.c", "C", 17, 0, 0, 0, 11, 5, 33
"/Users/sbukhari/Sandbox/CProgram/ASTanalysis/CodexUserStudyData/raw_data/a3edd088-a9ab-4b80-ae98-01ffcfca615b/parts/gen_list_load.c", "C", 18, 0, 0, 0, 12, 5, 35
"/Users/sbukhari/Sandbox/CProgram/ASTanalysis/CodexUserStudyData/raw_data/a3edd088-a9ab-4b80-ae98-01ffcfca615b/parts/gen_list_print.c", "C", 23, 0, 0, 0, 20, 5, 48
"/Users/sbukhari/Sandbox/CProgram/ASTanalysis/CodexUserStudyData/raw_data/a3edd088-a9ab-4b80-ae98-01ffcfca615b/parts/gen_list_remove_item_at_pos.c", "C", 18, 0, 0, 0, 8, 5, 31
"/Users/sbukhari/Sandbox/CProgram/ASTanalysis/CodexUserStudyData/raw_data/a3edd088-a9ab-4b80-ae98-01ffcfca615b/parts/gen_list_save.c", "C", 18, 0, 0, 0, 11, 5, 34
"/Users/sbukhari/Sandbox/CProgram/ASTanalysis/CodexUserStudyData/raw_data/a3edd088-a9ab-4b80-ae98-01ffcfca615b/parts/gen_list_swap_item_positions.c", "C", 17, 0, 0, 0, 8, 5, 30
"/Users/sbukhari/Sandbox/CProgram/ASTanalysis/CodexUserStudyData/raw_data/a3edd088-a9ab-4b80-ae98-01ffcfca615b/parts/gen_list_update_item_at_pos.c", "C", 28, 0, 0, 0, 14, 6, 48
"/Users/sbukhari/Sandbox/CProgram/ASTanalysis/CodexUserStudyData/raw_data/a3edd088-a9ab-4b80-ae98-01ffcfca615b/ref_testsuite.json", "JSON", 0, 323, 0, 0, 0, 1, 324
"/Users/sbukhari/Sandbox/CProgram/ASTanalysis/CodexUserStudyData/raw_data/a3edd088-a9ab-4b80-ae98-01ffcfca615b/ref_testsuite_asan.json", "JSON", 0, 323, 0, 0, 0, 1, 324
"/Users/sbukhari/Sandbox/CProgram/ASTanalysis/CodexUserStudyData/raw_data/a3edd088-a9ab-4b80-ae98-01ffcfca615b/ref_testsuite_asan_noleak.json", "JSON", 0, 323, 0, 0, 0, 1, 324
"/Users/sbukhari/Sandbox/CProgram/ASTanalysis/CodexUserStudyData/raw_data/a4b3a969-44a1-4cea-87f5-86393eb85908/api_report.json", "JSON", 0, 14, 0, 0, 0, 1, 15
"/Users/sbukhari/Sandbox/CProgram/ASTanalysis/CodexUserStudyData/raw_data/a4b3a969-44a1-4cea-87f5-86393eb85908/list.c", "C", 189, 0, 0, 0, 76, 26, 291
"/Users/sbukhari/Sandbox/CProgram/ASTanalysis/CodexUserStudyData/raw_data/a4b3a969-44a1-4cea-87f5-86393eb85908/orig_testsuite.json", "JSON", 0, 92, 0, 0, 0, 1, 93
"/Users/sbukhari/Sandbox/CProgram/ASTanalysis/CodexUserStudyData/raw_data/a4b3a969-44a1-4cea-87f5-86393eb85908/orig_testsuite_asan.json", "JSON", 0, 92, 0, 0, 0, 1, 93
"/Users/sbukhari/Sandbox/CProgram/ASTanalysis/CodexUserStudyData/raw_data/a4b3a969-44a1-4cea-87f5-86393eb85908/orig_testsuite_asan_noleak.json", "JSON", 0, 92, 0, 0, 0, 1, 93
"/Users/sbukhari/Sandbox/CProgram/ASTanalysis/CodexUserStudyData/raw_data/a4b3a969-44a1-4cea-87f5-86393eb85908/parts/gen_list_add_item_at_pos.c", "C", 44, 0, 0, 0, 20, 6, 70
"/Users/sbukhari/Sandbox/CProgram/ASTanalysis/CodexUserStudyData/raw_data/a4b3a969-44a1-4cea-87f5-86393eb85908/parts/gen_list_cost_sum.c", "C", 18, 0, 0, 0, 8, 5, 31
"/Users/sbukhari/Sandbox/CProgram/ASTanalysis/CodexUserStudyData/raw_data/a4b3a969-44a1-4cea-87f5-86393eb85908/parts/gen_list_deduplicate.c", "C", 18, 0, 0, 0, 10, 6, 34
"/Users/sbukhari/Sandbox/CProgram/ASTanalysis/CodexUserStudyData/raw_data/a4b3a969-44a1-4cea-87f5-86393eb85908/parts/gen_list_find_highest_price_item_position.c", "C", 36, 0, 0, 0, 8, 5, 49
"/Users/sbukhari/Sandbox/CProgram/ASTanalysis/CodexUserStudyData/raw_data/a4b3a969-44a1-4cea-87f5-86393eb85908/parts/gen_list_init.c", "C", 19, 0, 0, 0, 6, 6, 31
"/Users/sbukhari/Sandbox/CProgram/ASTanalysis/CodexUserStudyData/raw_data/a4b3a969-44a1-4cea-87f5-86393eb85908/parts/gen_list_item_to_string.c", "C", 26, 0, 0, 0, 14, 5, 45
"/Users/sbukhari/Sandbox/CProgram/ASTanalysis/CodexUserStudyData/raw_data/a4b3a969-44a1-4cea-87f5-86393eb85908/parts/gen_list_load.c", "C", 18, 0, 0, 0, 12, 6, 36
"/Users/sbukhari/Sandbox/CProgram/ASTanalysis/CodexUserStudyData/raw_data/a4b3a969-44a1-4cea-87f5-86393eb85908/parts/gen_list_print.c", "C", 28, 0, 0, 0, 21, 6, 55
"/Users/sbukhari/Sandbox/CProgram/ASTanalysis/CodexUserStudyData/raw_data/a4b3a969-44a1-4cea-87f5-86393eb85908/parts/gen_list_remove_item_at_pos.c", "C", 37, 0, 0, 0, 11, 5, 53
"/Users/sbukhari/Sandbox/CProgram/ASTanalysis/CodexUserStudyData/raw_data/a4b3a969-44a1-4cea-87f5-86393eb85908/parts/gen_list_save.c", "C", 21, 0, 0, 0, 11, 6, 38
"/Users/sbukhari/Sandbox/CProgram/ASTanalysis/CodexUserStudyData/raw_data/a4b3a969-44a1-4cea-87f5-86393eb85908/parts/gen_list_swap_item_positions.c", "C", 41, 0, 0, 0, 11, 5, 57
"/Users/sbukhari/Sandbox/CProgram/ASTanalysis/CodexUserStudyData/raw_data/a4b3a969-44a1-4cea-87f5-86393eb85908/parts/gen_list_update_item_at_pos.c", "C", 37, 0, 0, 0, 13, 5, 55
"/Users/sbukhari/Sandbox/CProgram/ASTanalysis/CodexUserStudyData/raw_data/a4b3a969-44a1-4cea-87f5-86393eb85908/ref_testsuite.json", "JSON", 0, 323, 0, 0, 0, 1, 324
"/Users/sbukhari/Sandbox/CProgram/ASTanalysis/CodexUserStudyData/raw_data/a4b3a969-44a1-4cea-87f5-86393eb85908/ref_testsuite_asan.json", "JSON", 0, 323, 0, 0, 0, 1, 324
"/Users/sbukhari/Sandbox/CProgram/ASTanalysis/CodexUserStudyData/raw_data/a4b3a969-44a1-4cea-87f5-86393eb85908/ref_testsuite_asan_noleak.json", "JSON", 0, 323, 0, 0, 0, 1, 324
"/Users/sbukhari/Sandbox/CProgram/ASTanalysis/CodexUserStudyData/raw_data/a5ba06a2-cd4d-4aed-92ac-eeee80fe3e73/api_report.json", "JSON", 0, 14, 0, 0, 0, 1, 15
"/Users/sbukhari/Sandbox/CProgram/ASTanalysis/CodexUserStudyData/raw_data/a5ba06a2-cd4d-4aed-92ac-eeee80fe3e73/list.c", "C", 226, 0, 0, 0, 91, 24, 341
"/Users/sbukhari/Sandbox/CProgram/ASTanalysis/CodexUserStudyData/raw_data/a5ba06a2-cd4d-4aed-92ac-eeee80fe3e73/orig_testsuite.json", "JSON", 0, 92, 0, 0, 0, 1, 93
"/Users/sbukhari/Sandbox/CProgram/ASTanalysis/CodexUserStudyData/raw_data/a5ba06a2-cd4d-4aed-92ac-eeee80fe3e73/orig_testsuite_asan.json", "JSON", 0, 92, 0, 0, 0, 1, 93
"/Users/sbukhari/Sandbox/CProgram/ASTanalysis/CodexUserStudyData/raw_data/a5ba06a2-cd4d-4aed-92ac-eeee80fe3e73/orig_testsuite_asan_noleak.json", "JSON", 0, 92, 0, 0, 0, 1, 93
"/Users/sbukhari/Sandbox/CProgram/ASTanalysis/CodexUserStudyData/raw_data/a5ba06a2-cd4d-4aed-92ac-eeee80fe3e73/parts/gen_list_add_item_at_pos.c", "C", 46, 0, 0, 0, 24, 6, 76
"/Users/sbukhari/Sandbox/CProgram/ASTanalysis/CodexUserStudyData/raw_data/a5ba06a2-cd4d-4aed-92ac-eeee80fe3e73/parts/gen_list_cost_sum.c", "C", 26, 0, 0, 0, 8, 5, 39
"/Users/sbukhari/Sandbox/CProgram/ASTanalysis/CodexUserStudyData/raw_data/a5ba06a2-cd4d-4aed-92ac-eeee80fe3e73/parts/gen_list_deduplicate.c", "C", 37, 0, 0, 0, 14, 11, 62
"/Users/sbukhari/Sandbox/CProgram/ASTanalysis/CodexUserStudyData/raw_data/a5ba06a2-cd4d-4aed-92ac-eeee80fe3e73/parts/gen_list_find_highest_price_item_position.c", "C", 26, 0, 0, 0, 9, 5, 40
"/Users/sbukhari/Sandbox/CProgram/ASTanalysis/CodexUserStudyData/raw_data/a5ba06a2-cd4d-4aed-92ac-eeee80fe3e73/parts/gen_list_init.c", "C", 19, 0, 0, 0, 6, 6, 31
"/Users/sbukhari/Sandbox/CProgram/ASTanalysis/CodexUserStudyData/raw_data/a5ba06a2-cd4d-4aed-92ac-eeee80fe3e73/parts/gen_list_item_to_string.c", "C", 22, 0, 0, 0, 14, 5, 41
"/Users/sbukhari/Sandbox/CProgram/ASTanalysis/CodexUserStudyData/raw_data/a5ba06a2-cd4d-4aed-92ac-eeee80fe3e73/parts/gen_list_load.c", "C", 37, 0, 0, 0, 18, 5, 60
"/Users/sbukhari/Sandbox/CProgram/ASTanalysis/CodexUserStudyData/raw_data/a5ba06a2-cd4d-4aed-92ac-eeee80fe3e73/parts/gen_list_print.c", "C", 26, 0, 0, 0, 25, 5, 56
"/Users/sbukhari/Sandbox/CProgram/ASTanalysis/CodexUserStudyData/raw_data/a5ba06a2-cd4d-4aed-92ac-eeee80fe3e73/parts/gen_list_remove_item_at_pos.c", "C", 35, 0, 0, 0, 15, 5, 55
"/Users/sbukhari/Sandbox/CProgram/ASTanalysis/CodexUserStudyData/raw_data/a5ba06a2-cd4d-4aed-92ac-eeee80fe3e73/parts/gen_list_save.c", "C", 27, 0, 0, 0, 14, 5, 46
"/Users/sbukhari/Sandbox/CProgram/ASTanalysis/CodexUserStudyData/raw_data/a5ba06a2-cd4d-4aed-92ac-eeee80fe3e73/parts/gen_list_swap_item_positions.c", "C", 44, 0, 0, 0, 12, 5, 61
"/Users/sbukhari/Sandbox/CProgram/ASTanalysis/CodexUserStudyData/raw_data/a5ba06a2-cd4d-4aed-92ac-eeee80fe3e73/parts/gen_list_update_item_at_pos.c", "C", 36, 0, 0, 0, 13, 5, 54
"/Users/sbukhari/Sandbox/CProgram/ASTanalysis/CodexUserStudyData/raw_data/a5ba06a2-cd4d-4aed-92ac-eeee80fe3e73/ref_testsuite.json", "JSON", 0, 323, 0, 0, 0, 1, 324
"/Users/sbukhari/Sandbox/CProgram/ASTanalysis/CodexUserStudyData/raw_data/a5ba06a2-cd4d-4aed-92ac-eeee80fe3e73/ref_testsuite_asan.json", "JSON", 0, 323, 0, 0, 0, 1, 324
"/Users/sbukhari/Sandbox/CProgram/ASTanalysis/CodexUserStudyData/raw_data/a5ba06a2-cd4d-4aed-92ac-eeee80fe3e73/ref_testsuite_asan_noleak.json", "JSON", 0, 323, 0, 0, 0, 1, 324
"/Users/sbukhari/Sandbox/CProgram/ASTanalysis/CodexUserStudyData/raw_data/a80d5d0f-724e-4a28-8af1-02ca84993567/api_report.json", "JSON", 0, 14, 0, 0, 0, 1, 15
"/Users/sbukhari/Sandbox/CProgram/ASTanalysis/CodexUserStudyData/raw_data/a80d5d0f-724e-4a28-8af1-02ca84993567/list.c", "C", 188, 0, 0, 0, 54, 26, 268
"/Users/sbukhari/Sandbox/CProgram/ASTanalysis/CodexUserStudyData/raw_data/a80d5d0f-724e-4a28-8af1-02ca84993567/orig_testsuite.json", "JSON", 0, 92, 0, 0, 0, 1, 93
"/Users/sbukhari/Sandbox/CProgram/ASTanalysis/CodexUserStudyData/raw_data/a80d5d0f-724e-4a28-8af1-02ca84993567/orig_testsuite_asan.json", "JSON", 0, 92, 0, 0, 0, 1, 93
"/Users/sbukhari/Sandbox/CProgram/ASTanalysis/CodexUserStudyData/raw_data/a80d5d0f-724e-4a28-8af1-02ca84993567/orig_testsuite_asan_noleak.json", "JSON", 0, 92, 0, 0, 0, 1, 93
"/Users/sbukhari/Sandbox/CProgram/ASTanalysis/CodexUserStudyData/raw_data/a80d5d0f-724e-4a28-8af1-02ca84993567/parts/gen_list_add_item_at_pos.c", "C", 55, 0, 0, 0, 17, 5, 77
"/Users/sbukhari/Sandbox/CProgram/ASTanalysis/CodexUserStudyData/raw_data/a80d5d0f-724e-4a28-8af1-02ca84993567/parts/gen_list_cost_sum.c", "C", 17, 0, 0, 0, 6, 7, 30
"/Users/sbukhari/Sandbox/CProgram/ASTanalysis/CodexUserStudyData/raw_data/a80d5d0f-724e-4a28-8af1-02ca84993567/parts/gen_list_deduplicate.c", "C", 18, 0, 0, 0, 10, 6, 34
"/Users/sbukhari/Sandbox/CProgram/ASTanalysis/CodexUserStudyData/raw_data/a80d5d0f-724e-4a28-8af1-02ca84993567/parts/gen_list_find_highest_price_item_position.c", "C", 32, 0, 0, 0, 8, 6, 46
"/Users/sbukhari/Sandbox/CProgram/ASTanalysis/CodexUserStudyData/raw_data/a80d5d0f-724e-4a28-8af1-02ca84993567/parts/gen_list_init.c", "C", 19, 0, 0, 0, 6, 6, 31
"/Users/sbukhari/Sandbox/CProgram/ASTanalysis/CodexUserStudyData/raw_data/a80d5d0f-724e-4a28-8af1-02ca84993567/parts/gen_list_item_to_string.c", "C", 22, 0, 0, 0, 12, 5, 39
"/Users/sbukhari/Sandbox/CProgram/ASTanalysis/CodexUserStudyData/raw_data/a80d5d0f-724e-4a28-8af1-02ca84993567/parts/gen_list_load.c", "C", 18, 0, 0, 0, 10, 5, 33
"/Users/sbukhari/Sandbox/CProgram/ASTanalysis/CodexUserStudyData/raw_data/a80d5d0f-724e-4a28-8af1-02ca84993567/parts/gen_list_print.c", "C", 28, 0, 0, 0, 20, 5, 53
"/Users/sbukhari/Sandbox/CProgram/ASTanalysis/CodexUserStudyData/raw_data/a80d5d0f-724e-4a28-8af1-02ca84993567/parts/gen_list_remove_item_at_pos.c", "C", 41, 0, 0, 0, 9, 5, 55
"/Users/sbukhari/Sandbox/CProgram/ASTanalysis/CodexUserStudyData/raw_data/a80d5d0f-724e-4a28-8af1-02ca84993567/parts/gen_list_save.c", "C", 18, 0, 0, 0, 9, 5, 32
"/Users/sbukhari/Sandbox/CProgram/ASTanalysis/CodexUserStudyData/raw_data/a80d5d0f-724e-4a28-8af1-02ca84993567/parts/gen_list_swap_item_positions.c", "C", 42, 0, 0, 0, 7, 7, 56
"/Users/sbukhari/Sandbox/CProgram/ASTanalysis/CodexUserStudyData/raw_data/a80d5d0f-724e-4a28-8af1-02ca84993567/parts/gen_list_update_item_at_pos.c", "C", 33, 0, 0, 0, 9, 5, 47
"/Users/sbukhari/Sandbox/CProgram/ASTanalysis/CodexUserStudyData/raw_data/a80d5d0f-724e-4a28-8af1-02ca84993567/ref_testsuite.json", "JSON", 0, 323, 0, 0, 0, 1, 324
"/Users/sbukhari/Sandbox/CProgram/ASTanalysis/CodexUserStudyData/raw_data/a80d5d0f-724e-4a28-8af1-02ca84993567/ref_testsuite_asan.json", "JSON", 0, 323, 0, 0, 0, 1, 324
"/Users/sbukhari/Sandbox/CProgram/ASTanalysis/CodexUserStudyData/raw_data/a80d5d0f-724e-4a28-8af1-02ca84993567/ref_testsuite_asan_noleak.json", "JSON", 0, 323, 0, 0, 0, 1, 324
"/Users/sbukhari/Sandbox/CProgram/ASTanalysis/CodexUserStudyData/raw_data/a974cab3-f095-4360-969e-9942edfdedc1/api_report.json", "JSON", 0, 14, 0, 0, 0, 1, 15
"/Users/sbukhari/Sandbox/CProgram/ASTanalysis/CodexUserStudyData/raw_data/a974cab3-f095-4360-969e-9942edfdedc1/list.c", "C", 176, 0, 0, 0, 31, 13, 220
"/Users/sbukhari/Sandbox/CProgram/ASTanalysis/CodexUserStudyData/raw_data/a974cab3-f095-4360-969e-9942edfdedc1/orig_testsuite.json", "JSON", 0, 92, 0, 0, 0, 1, 93
"/Users/sbukhari/Sandbox/CProgram/ASTanalysis/CodexUserStudyData/raw_data/a974cab3-f095-4360-969e-9942edfdedc1/orig_testsuite_asan.json", "JSON", 0, 92, 0, 0, 0, 1, 93
"/Users/sbukhari/Sandbox/CProgram/ASTanalysis/CodexUserStudyData/raw_data/a974cab3-f095-4360-969e-9942edfdedc1/orig_testsuite_asan_noleak.json", "JSON", 0, 92, 0, 0, 0, 1, 93
"/Users/sbukhari/Sandbox/CProgram/ASTanalysis/CodexUserStudyData/raw_data/a974cab3-f095-4360-969e-9942edfdedc1/parts/gen_list_add_item_at_pos.c", "C", 43, 0, 0, 0, 9, 5, 57
"/Users/sbukhari/Sandbox/CProgram/ASTanalysis/CodexUserStudyData/raw_data/a974cab3-f095-4360-969e-9942edfdedc1/parts/gen_list_cost_sum.c", "C", 23, 0, 0, 0, 7, 5, 35
"/Users/sbukhari/Sandbox/CProgram/ASTanalysis/CodexUserStudyData/raw_data/a974cab3-f095-4360-969e-9942edfdedc1/parts/gen_list_deduplicate.c", "C", 18, 0, 0, 0, 8, 5, 31
"/Users/sbukhari/Sandbox/CProgram/ASTanalysis/CodexUserStudyData/raw_data/a974cab3-f095-4360-969e-9942edfdedc1/parts/gen_list_find_highest_price_item_position.c", "C", 28, 0, 0, 0, 8, 5, 41
"/Users/sbukhari/Sandbox/CProgram/ASTanalysis/CodexUserStudyData/raw_data/a974cab3-f095-4360-969e-9942edfdedc1/parts/gen_list_init.c", "C", 19, 0, 0, 0, 6, 6, 31
"/Users/sbukhari/Sandbox/CProgram/ASTanalysis/CodexUserStudyData/raw_data/a974cab3-f095-4360-969e-9942edfdedc1/parts/gen_list_item_to_string.c", "C", 18, 0, 0, 0, 12, 5, 35
"/Users/sbukhari/Sandbox/CProgram/ASTanalysis/CodexUserStudyData/raw_data/a974cab3-f095-4360-969e-9942edfdedc1/parts/gen_list_load.c", "C", 32, 0, 0, 0, 15, 5, 52
"/Users/sbukhari/Sandbox/CProgram/ASTanalysis/CodexUserStudyData/raw_data/a974cab3-f095-4360-969e-9942edfdedc1/parts/gen_list_print.c", "C", 25, 0, 0, 0, 8, 6, 39
"/Users/sbukhari/Sandbox/CProgram/ASTanalysis/CodexUserStudyData/raw_data/a974cab3-f095-4360-969e-9942edfdedc1/parts/gen_list_remove_item_at_pos.c", "C", 35, 0, 0, 0, 10, 5, 50
"/Users/sbukhari/Sandbox/CProgram/ASTanalysis/CodexUserStudyData/raw_data/a974cab3-f095-4360-969e-9942edfdedc1/parts/gen_list_save.c", "C", 27, 0, 0, 0, 12, 5, 44
"/Users/sbukhari/Sandbox/CProgram/ASTanalysis/CodexUserStudyData/raw_data/a974cab3-f095-4360-969e-9942edfdedc1/parts/gen_list_swap_item_positions.c", "C", 28, 0, 0, 0, 12, 5, 45
"/Users/sbukhari/Sandbox/CProgram/ASTanalysis/CodexUserStudyData/raw_data/a974cab3-f095-4360-969e-9942edfdedc1/parts/gen_list_update_item_at_pos.c", "C", 35, 0, 0, 0, 12, 5, 52
"/Users/sbukhari/Sandbox/CProgram/ASTanalysis/CodexUserStudyData/raw_data/a974cab3-f095-4360-969e-9942edfdedc1/ref_testsuite.json", "JSON", 0, 323, 0, 0, 0, 1, 324
"/Users/sbukhari/Sandbox/CProgram/ASTanalysis/CodexUserStudyData/raw_data/a974cab3-f095-4360-969e-9942edfdedc1/ref_testsuite_asan.json", "JSON", 0, 323, 0, 0, 0, 1, 324
"/Users/sbukhari/Sandbox/CProgram/ASTanalysis/CodexUserStudyData/raw_data/a974cab3-f095-4360-969e-9942edfdedc1/ref_testsuite_asan_noleak.json", "JSON", 0, 323, 0, 0, 0, 1, 324
"/Users/sbukhari/Sandbox/CProgram/ASTanalysis/CodexUserStudyData/raw_data/b0ce9d89-f33e-4770-abfb-11e9830da4c4/api_report.json", "JSON", 0, 14, 0, 0, 0, 1, 15
"/Users/sbukhari/Sandbox/CProgram/ASTanalysis/CodexUserStudyData/raw_data/b0ce9d89-f33e-4770-abfb-11e9830da4c4/list.c", "C", 92, 0, 0, 0, 77, 26, 195
"/Users/sbukhari/Sandbox/CProgram/ASTanalysis/CodexUserStudyData/raw_data/b0ce9d89-f33e-4770-abfb-11e9830da4c4/orig_testsuite.json", "JSON", 0, 92, 0, 0, 0, 1, 93
"/Users/sbukhari/Sandbox/CProgram/ASTanalysis/CodexUserStudyData/raw_data/b0ce9d89-f33e-4770-abfb-11e9830da4c4/orig_testsuite_asan.json", "JSON", 0, 92, 0, 0, 0, 1, 93
"/Users/sbukhari/Sandbox/CProgram/ASTanalysis/CodexUserStudyData/raw_data/b0ce9d89-f33e-4770-abfb-11e9830da4c4/orig_testsuite_asan_noleak.json", "JSON", 0, 92, 0, 0, 0, 1, 93
"/Users/sbukhari/Sandbox/CProgram/ASTanalysis/CodexUserStudyData/raw_data/b0ce9d89-f33e-4770-abfb-11e9830da4c4/parts/gen_list_add_item_at_pos.c", "C", 33, 0, 0, 0, 17, 10, 60
"/Users/sbukhari/Sandbox/CProgram/ASTanalysis/CodexUserStudyData/raw_data/b0ce9d89-f33e-4770-abfb-11e9830da4c4/parts/gen_list_cost_sum.c", "C", 18, 0, 0, 0, 8, 5, 31
"/Users/sbukhari/Sandbox/CProgram/ASTanalysis/CodexUserStudyData/raw_data/b0ce9d89-f33e-4770-abfb-11e9830da4c4/parts/gen_list_deduplicate.c", "C", 18, 0, 0, 0, 10, 5, 33
"/Users/sbukhari/Sandbox/CProgram/ASTanalysis/CodexUserStudyData/raw_data/b0ce9d89-f33e-4770-abfb-11e9830da4c4/parts/gen_list_find_highest_price_item_position.c", "C", 18, 0, 0, 0, 8, 5, 31
"/Users/sbukhari/Sandbox/CProgram/ASTanalysis/CodexUserStudyData/raw_data/b0ce9d89-f33e-4770-abfb-11e9830da4c4/parts/gen_list_init.c", "C", 19, 0, 0, 0, 6, 6, 31
"/Users/sbukhari/Sandbox/CProgram/ASTanalysis/CodexUserStudyData/raw_data/b0ce9d89-f33e-4770-abfb-11e9830da4c4/parts/gen_list_item_to_string.c", "C", 21, 0, 0, 0, 20, 8, 49
"/Users/sbukhari/Sandbox/CProgram/ASTanalysis/CodexUserStudyData/raw_data/b0ce9d89-f33e-4770-abfb-11e9830da4c4/parts/gen_list_load.c", "C", 18, 0, 0, 0, 12, 5, 35
"/Users/sbukhari/Sandbox/CProgram/ASTanalysis/CodexUserStudyData/raw_data/b0ce9d89-f33e-4770-abfb-11e9830da4c4/parts/gen_list_print.c", "C", 23, 0, 0, 0, 22, 5, 50
"/Users/sbukhari/Sandbox/CProgram/ASTanalysis/CodexUserStudyData/raw_data/b0ce9d89-f33e-4770-abfb-11e9830da4c4/parts/gen_list_remove_item_at_pos.c", "C", 18, 0, 0, 0, 8, 5, 31
"/Users/sbukhari/Sandbox/CProgram/ASTanalysis/CodexUserStudyData/raw_data/b0ce9d89-f33e-4770-abfb-11e9830da4c4/parts/gen_list_save.c", "C", 18, 0, 0, 0, 11, 5, 34
"/Users/sbukhari/Sandbox/CProgram/ASTanalysis/CodexUserStudyData/raw_data/b0ce9d89-f33e-4770-abfb-11e9830da4c4/parts/gen_list_swap_item_positions.c", "C", 17, 0, 0, 0, 8, 5, 30
"/Users/sbukhari/Sandbox/CProgram/ASTanalysis/CodexUserStudyData/raw_data/b0ce9d89-f33e-4770-abfb-11e9830da4c4/parts/gen_list_update_item_at_pos.c", "C", 18, 0, 0, 0, 11, 5, 34
"/Users/sbukhari/Sandbox/CProgram/ASTanalysis/CodexUserStudyData/raw_data/b0ce9d89-f33e-4770-abfb-11e9830da4c4/ref_testsuite.json", "JSON", 0, 323, 0, 0, 0, 1, 324
"/Users/sbukhari/Sandbox/CProgram/ASTanalysis/CodexUserStudyData/raw_data/b0ce9d89-f33e-4770-abfb-11e9830da4c4/ref_testsuite_asan.json", "JSON", 0, 323, 0, 0, 0, 1, 324
"/Users/sbukhari/Sandbox/CProgram/ASTanalysis/CodexUserStudyData/raw_data/b0ce9d89-f33e-4770-abfb-11e9830da4c4/ref_testsuite_asan_noleak.json", "JSON", 0, 323, 0, 0, 0, 1, 324
"/Users/sbukhari/Sandbox/CProgram/ASTanalysis/CodexUserStudyData/raw_data/b59feaf2-4c48-4ec0-8d00-3428362914a7/api_report.json", "JSON", 0, 14, 0, 0, 0, 1, 15
"/Users/sbukhari/Sandbox/CProgram/ASTanalysis/CodexUserStudyData/raw_data/b59feaf2-4c48-4ec0-8d00-3428362914a7/list.c", "C", 88, 0, 0, 0, 74, 17, 179
"/Users/sbukhari/Sandbox/CProgram/ASTanalysis/CodexUserStudyData/raw_data/b59feaf2-4c48-4ec0-8d00-3428362914a7/orig_testsuite.json", "JSON", 0, 92, 0, 0, 0, 1, 93
"/Users/sbukhari/Sandbox/CProgram/ASTanalysis/CodexUserStudyData/raw_data/b59feaf2-4c48-4ec0-8d00-3428362914a7/orig_testsuite_asan.json", "JSON", 0, 92, 0, 0, 0, 1, 93
"/Users/sbukhari/Sandbox/CProgram/ASTanalysis/CodexUserStudyData/raw_data/b59feaf2-4c48-4ec0-8d00-3428362914a7/orig_testsuite_asan_noleak.json", "JSON", 0, 92, 0, 0, 0, 1, 93
"/Users/sbukhari/Sandbox/CProgram/ASTanalysis/CodexUserStudyData/raw_data/b59feaf2-4c48-4ec0-8d00-3428362914a7/parts/gen_list_add_item_at_pos.c", "C", 37, 0, 0, 0, 21, 5, 63
"/Users/sbukhari/Sandbox/CProgram/ASTanalysis/CodexUserStudyData/raw_data/b59feaf2-4c48-4ec0-8d00-3428362914a7/parts/gen_list_cost_sum.c", "C", 18, 0, 0, 0, 8, 5, 31
"/Users/sbukhari/Sandbox/CProgram/ASTanalysis/CodexUserStudyData/raw_data/b59feaf2-4c48-4ec0-8d00-3428362914a7/parts/gen_list_deduplicate.c", "C", 18, 0, 0, 0, 10, 5, 33
"/Users/sbukhari/Sandbox/CProgram/ASTanalysis/CodexUserStudyData/raw_data/b59feaf2-4c48-4ec0-8d00-3428362914a7/parts/gen_list_find_highest_price_item_position.c", "C", 18, 0, 0, 0, 8, 5, 31
"/Users/sbukhari/Sandbox/CProgram/ASTanalysis/CodexUserStudyData/raw_data/b59feaf2-4c48-4ec0-8d00-3428362914a7/parts/gen_list_init.c", "C", 19, 0, 0, 0, 6, 6, 31
"/Users/sbukhari/Sandbox/CProgram/ASTanalysis/CodexUserStudyData/raw_data/b59feaf2-4c48-4ec0-8d00-3428362914a7/parts/gen_list_item_to_string.c", "C", 17, 0, 0, 0, 11, 5, 33
"/Users/sbukhari/Sandbox/CProgram/ASTanalysis/CodexUserStudyData/raw_data/b59feaf2-4c48-4ec0-8d00-3428362914a7/parts/gen_list_load.c", "C", 18, 0, 0, 0, 12, 5, 35
"/Users/sbukhari/Sandbox/CProgram/ASTanalysis/CodexUserStudyData/raw_data/b59feaf2-4c48-4ec0-8d00-3428362914a7/parts/gen_list_print.c", "C", 17, 0, 0, 0, 20, 5, 42
"/Users/sbukhari/Sandbox/CProgram/ASTanalysis/CodexUserStudyData/raw_data/b59feaf2-4c48-4ec0-8d00-3428362914a7/parts/gen_list_remove_item_at_pos.c", "C", 18, 0, 0, 0, 8, 5, 31
"/Users/sbukhari/Sandbox/CProgram/ASTanalysis/CodexUserStudyData/raw_data/b59feaf2-4c48-4ec0-8d00-3428362914a7/parts/gen_list_save.c", "C", 18, 0, 0, 0, 11, 5, 34
"/Users/sbukhari/Sandbox/CProgram/ASTanalysis/CodexUserStudyData/raw_data/b59feaf2-4c48-4ec0-8d00-3428362914a7/parts/gen_list_swap_item_positions.c", "C", 17, 0, 0, 0, 8, 5, 30
"/Users/sbukhari/Sandbox/CProgram/ASTanalysis/CodexUserStudyData/raw_data/b59feaf2-4c48-4ec0-8d00-3428362914a7/parts/gen_list_update_item_at_pos.c", "C", 17, 0, 0, 0, 8, 5, 30
"/Users/sbukhari/Sandbox/CProgram/ASTanalysis/CodexUserStudyData/raw_data/b59feaf2-4c48-4ec0-8d00-3428362914a7/ref_testsuite.json", "JSON", 0, 323, 0, 0, 0, 1, 324
"/Users/sbukhari/Sandbox/CProgram/ASTanalysis/CodexUserStudyData/raw_data/b59feaf2-4c48-4ec0-8d00-3428362914a7/ref_testsuite_asan.json", "JSON", 0, 323, 0, 0, 0, 1, 324
"/Users/sbukhari/Sandbox/CProgram/ASTanalysis/CodexUserStudyData/raw_data/b59feaf2-4c48-4ec0-8d00-3428362914a7/ref_testsuite_asan_noleak.json", "JSON", 0, 323, 0, 0, 0, 1, 324
"/Users/sbukhari/Sandbox/CProgram/ASTanalysis/CodexUserStudyData/raw_data/bbea417b-a3f1-451b-a25d-d9dfb2c8aed2/api_report.json", "JSON", 0, 14, 0, 0, 0, 1, 15
"/Users/sbukhari/Sandbox/CProgram/ASTanalysis/CodexUserStudyData/raw_data/bbea417b-a3f1-451b-a25d-d9dfb2c8aed2/list.c", "C", 79, 0, 0, 0, 63, 22, 164
"/Users/sbukhari/Sandbox/CProgram/ASTanalysis/CodexUserStudyData/raw_data/bbea417b-a3f1-451b-a25d-d9dfb2c8aed2/orig_testsuite.json", "JSON", 0, 92, 0, 0, 0, 1, 93
"/Users/sbukhari/Sandbox/CProgram/ASTanalysis/CodexUserStudyData/raw_data/bbea417b-a3f1-451b-a25d-d9dfb2c8aed2/orig_testsuite_asan.json", "JSON", 0, 92, 0, 0, 0, 1, 93
"/Users/sbukhari/Sandbox/CProgram/ASTanalysis/CodexUserStudyData/raw_data/bbea417b-a3f1-451b-a25d-d9dfb2c8aed2/orig_testsuite_asan_noleak.json", "JSON", 0, 92, 0, 0, 0, 1, 93
"/Users/sbukhari/Sandbox/CProgram/ASTanalysis/CodexUserStudyData/raw_data/bbea417b-a3f1-451b-a25d-d9dfb2c8aed2/parts/gen_list_add_item_at_pos.c", "C", 31, 0, 0, 0, 18, 8, 57
"/Users/sbukhari/Sandbox/CProgram/ASTanalysis/CodexUserStudyData/raw_data/bbea417b-a3f1-451b-a25d-d9dfb2c8aed2/parts/gen_list_cost_sum.c", "C", 18, 0, 0, 0, 8, 5, 31
"/Users/sbukhari/Sandbox/CProgram/ASTanalysis/CodexUserStudyData/raw_data/bbea417b-a3f1-451b-a25d-d9dfb2c8aed2/parts/gen_list_deduplicate.c", "C", 17, 0, 0, 0, 8, 5, 30
"/Users/sbukhari/Sandbox/CProgram/ASTanalysis/CodexUserStudyData/raw_data/bbea417b-a3f1-451b-a25d-d9dfb2c8aed2/parts/gen_list_find_highest_price_item_position.c", "C", 18, 0, 0, 0, 8, 5, 31
"/Users/sbukhari/Sandbox/CProgram/ASTanalysis/CodexUserStudyData/raw_data/bbea417b-a3f1-451b-a25d-d9dfb2c8aed2/parts/gen_list_init.c", "C", 19, 0, 0, 0, 6, 6, 31
"/Users/sbukhari/Sandbox/CProgram/ASTanalysis/CodexUserStudyData/raw_data/bbea417b-a3f1-451b-a25d-d9dfb2c8aed2/parts/gen_list_item_to_string.c", "C", 21, 0, 0, 0, 12, 6, 39
"/Users/sbukhari/Sandbox/CProgram/ASTanalysis/CodexUserStudyData/raw_data/bbea417b-a3f1-451b-a25d-d9dfb2c8aed2/parts/gen_list_load.c", "C", 17, 0, 0, 0, 10, 5, 32
"/Users/sbukhari/Sandbox/CProgram/ASTanalysis/CodexUserStudyData/raw_data/bbea417b-a3f1-451b-a25d-d9dfb2c8aed2/parts/gen_list_print.c", "C", 24, 0, 0, 0, 21, 6, 51
"/Users/sbukhari/Sandbox/CProgram/ASTanalysis/CodexUserStudyData/raw_data/bbea417b-a3f1-451b-a25d-d9dfb2c8aed2/parts/gen_list_remove_item_at_pos.c", "C", 18, 0, 0, 0, 8, 5, 31
"/Users/sbukhari/Sandbox/CProgram/ASTanalysis/CodexUserStudyData/raw_data/bbea417b-a3f1-451b-a25d-d9dfb2c8aed2/parts/gen_list_save.c", "C", 17, 0, 0, 0, 9, 5, 31
"/Users/sbukhari/Sandbox/CProgram/ASTanalysis/CodexUserStudyData/raw_data/bbea417b-a3f1-451b-a25d-d9dfb2c8aed2/parts/gen_list_swap_item_positions.c", "C", 17, 0, 0, 0, 8, 5, 30
"/Users/sbukhari/Sandbox/CProgram/ASTanalysis/CodexUserStudyData/raw_data/bbea417b-a3f1-451b-a25d-d9dfb2c8aed2/parts/gen_list_update_item_at_pos.c", "C", 17, 0, 0, 0, 8, 5, 30
"/Users/sbukhari/Sandbox/CProgram/ASTanalysis/CodexUserStudyData/raw_data/bbea417b-a3f1-451b-a25d-d9dfb2c8aed2/ref_testsuite.json", "JSON", 0, 323, 0, 0, 0, 1, 324
"/Users/sbukhari/Sandbox/CProgram/ASTanalysis/CodexUserStudyData/raw_data/bbea417b-a3f1-451b-a25d-d9dfb2c8aed2/ref_testsuite_asan.json", "JSON", 0, 323, 0, 0, 0, 1, 324
"/Users/sbukhari/Sandbox/CProgram/ASTanalysis/CodexUserStudyData/raw_data/bbea417b-a3f1-451b-a25d-d9dfb2c8aed2/ref_testsuite_asan_noleak.json", "JSON", 0, 323, 0, 0, 0, 1, 324
"/Users/sbukhari/Sandbox/CProgram/ASTanalysis/CodexUserStudyData/raw_data/be6fa0a5-e7ff-4ae0-b846-57d9385acd84/api_report.json", "JSON", 0, 14, 0, 0, 0, 1, 15
"/Users/sbukhari/Sandbox/CProgram/ASTanalysis/CodexUserStudyData/raw_data/be6fa0a5-e7ff-4ae0-b846-57d9385acd84/list.c", "C", 210, 0, 0, 0, 56, 57, 323
"/Users/sbukhari/Sandbox/CProgram/ASTanalysis/CodexUserStudyData/raw_data/be6fa0a5-e7ff-4ae0-b846-57d9385acd84/orig_testsuite.json", "JSON", 0, 92, 0, 0, 0, 1, 93
"/Users/sbukhari/Sandbox/CProgram/ASTanalysis/CodexUserStudyData/raw_data/be6fa0a5-e7ff-4ae0-b846-57d9385acd84/orig_testsuite_asan.json", "JSON", 0, 92, 0, 0, 0, 1, 93
"/Users/sbukhari/Sandbox/CProgram/ASTanalysis/CodexUserStudyData/raw_data/be6fa0a5-e7ff-4ae0-b846-57d9385acd84/orig_testsuite_asan_noleak.json", "JSON", 0, 92, 0, 0, 0, 1, 93
"/Users/sbukhari/Sandbox/CProgram/ASTanalysis/CodexUserStudyData/raw_data/be6fa0a5-e7ff-4ae0-b846-57d9385acd84/parts/gen_list_add_item_at_pos.c", "C", 41, 0, 0, 0, 17, 11, 69
"/Users/sbukhari/Sandbox/CProgram/ASTanalysis/CodexUserStudyData/raw_data/be6fa0a5-e7ff-4ae0-b846-57d9385acd84/parts/gen_list_cost_sum.c", "C", 26, 0, 0, 0, 7, 7, 40
"/Users/sbukhari/Sandbox/CProgram/ASTanalysis/CodexUserStudyData/raw_data/be6fa0a5-e7ff-4ae0-b846-57d9385acd84/parts/gen_list_deduplicate.c", "C", 18, 0, 0, 0, 8, 5, 31
"/Users/sbukhari/Sandbox/CProgram/ASTanalysis/CodexUserStudyData/raw_data/be6fa0a5-e7ff-4ae0-b846-57d9385acd84/parts/gen_list_find_highest_price_item_position.c", "C", 33, 0, 0, 0, 8, 9, 50
"/Users/sbukhari/Sandbox/CProgram/ASTanalysis/CodexUserStudyData/raw_data/be6fa0a5-e7ff-4ae0-b846-57d9385acd84/parts/gen_list_init.c", "C", 19, 0, 0, 0, 6, 6, 31
"/Users/sbukhari/Sandbox/CProgram/ASTanalysis/CodexUserStudyData/raw_data/be6fa0a5-e7ff-4ae0-b846-57d9385acd84/parts/gen_list_item_to_string.c", "C", 21, 0, 0, 0, 12, 7, 40
"/Users/sbukhari/Sandbox/CProgram/ASTanalysis/CodexUserStudyData/raw_data/be6fa0a5-e7ff-4ae0-b846-57d9385acd84/parts/gen_list_load.c", "C", 21, 0, 0, 0, 12, 5, 38
"/Users/sbukhari/Sandbox/CProgram/ASTanalysis/CodexUserStudyData/raw_data/be6fa0a5-e7ff-4ae0-b846-57d9385acd84/parts/gen_list_print.c", "C", 26, 0, 0, 0, 19, 7, 52
"/Users/sbukhari/Sandbox/CProgram/ASTanalysis/CodexUserStudyData/raw_data/be6fa0a5-e7ff-4ae0-b846-57d9385acd84/parts/gen_list_remove_item_at_pos.c", "C", 35, 0, 0, 0, 12, 10, 57
"/Users/sbukhari/Sandbox/CProgram/ASTanalysis/CodexUserStudyData/raw_data/be6fa0a5-e7ff-4ae0-b846-57d9385acd84/parts/gen_list_save.c", "C", 25, 0, 0, 0, 13, 7, 45
"/Users/sbukhari/Sandbox/CProgram/ASTanalysis/CodexUserStudyData/raw_data/be6fa0a5-e7ff-4ae0-b846-57d9385acd84/parts/gen_list_swap_item_positions.c", "C", 54, 0, 0, 0, 9, 12, 75
"/Users/sbukhari/Sandbox/CProgram/ASTanalysis/CodexUserStudyData/raw_data/be6fa0a5-e7ff-4ae0-b846-57d9385acd84/parts/gen_list_update_item_at_pos.c", "C", 33, 0, 0, 0, 9, 9, 51
"/Users/sbukhari/Sandbox/CProgram/ASTanalysis/CodexUserStudyData/raw_data/be6fa0a5-e7ff-4ae0-b846-57d9385acd84/ref_testsuite.json", "JSON", 0, 323, 0, 0, 0, 1, 324
"/Users/sbukhari/Sandbox/CProgram/ASTanalysis/CodexUserStudyData/raw_data/be6fa0a5-e7ff-4ae0-b846-57d9385acd84/ref_testsuite_asan.json", "JSON", 0, 323, 0, 0, 0, 1, 324
"/Users/sbukhari/Sandbox/CProgram/ASTanalysis/CodexUserStudyData/raw_data/be6fa0a5-e7ff-4ae0-b846-57d9385acd84/ref_testsuite_asan_noleak.json", "JSON", 0, 323, 0, 0, 0, 1, 324
"/Users/sbukhari/Sandbox/CProgram/ASTanalysis/CodexUserStudyData/raw_data/c23b2615-700f-48f2-b33d-3433d1c25bb6/api_report.json", "JSON", 0, 14, 0, 0, 0, 1, 15
"/Users/sbukhari/Sandbox/CProgram/ASTanalysis/CodexUserStudyData/raw_data/c23b2615-700f-48f2-b33d-3433d1c25bb6/list.c", "C", 245, 0, 0, 0, 74, 19, 338
"/Users/sbukhari/Sandbox/CProgram/ASTanalysis/CodexUserStudyData/raw_data/c23b2615-700f-48f2-b33d-3433d1c25bb6/orig_testsuite.json", "JSON", 0, 92, 0, 0, 0, 1, 93
"/Users/sbukhari/Sandbox/CProgram/ASTanalysis/CodexUserStudyData/raw_data/c23b2615-700f-48f2-b33d-3433d1c25bb6/orig_testsuite_asan.json", "JSON", 0, 92, 0, 0, 0, 1, 93
"/Users/sbukhari/Sandbox/CProgram/ASTanalysis/CodexUserStudyData/raw_data/c23b2615-700f-48f2-b33d-3433d1c25bb6/orig_testsuite_asan_noleak.json", "JSON", 0, 92, 0, 0, 0, 1, 93
"/Users/sbukhari/Sandbox/CProgram/ASTanalysis/CodexUserStudyData/raw_data/c23b2615-700f-48f2-b33d-3433d1c25bb6/parts/gen_list_add_item_at_pos.c", "C", 59, 0, 0, 0, 19, 5, 83
"/Users/sbukhari/Sandbox/CProgram/ASTanalysis/CodexUserStudyData/raw_data/c23b2615-700f-48f2-b33d-3433d1c25bb6/parts/gen_list_cost_sum.c", "C", 25, 0, 0, 0, 9, 5, 39
"/Users/sbukhari/Sandbox/CProgram/ASTanalysis/CodexUserStudyData/raw_data/c23b2615-700f-48f2-b33d-3433d1c25bb6/parts/gen_list_deduplicate.c", "C", 20, 0, 0, 0, 11, 5, 36
"/Users/sbukhari/Sandbox/CProgram/ASTanalysis/CodexUserStudyData/raw_data/c23b2615-700f-48f2-b33d-3433d1c25bb6/parts/gen_list_find_highest_price_item_position.c", "C", 33, 0, 0, 0, 9, 5, 47
"/Users/sbukhari/Sandbox/CProgram/ASTanalysis/CodexUserStudyData/raw_data/c23b2615-700f-48f2-b33d-3433d1c25bb6/parts/gen_list_init.c", "C", 19, 0, 0, 0, 6, 6, 31
"/Users/sbukhari/Sandbox/CProgram/ASTanalysis/CodexUserStudyData/raw_data/c23b2615-700f-48f2-b33d-3433d1c25bb6/parts/gen_list_item_to_string.c", "C", 21, 0, 0, 0, 14, 5, 40
"/Users/sbukhari/Sandbox/CProgram/ASTanalysis/CodexUserStudyData/raw_data/c23b2615-700f-48f2-b33d-3433d1c25bb6/parts/gen_list_load.c", "C", 31, 0, 0, 0, 14, 7, 52
"/Users/sbukhari/Sandbox/CProgram/ASTanalysis/CodexUserStudyData/raw_data/c23b2615-700f-48f2-b33d-3433d1c25bb6/parts/gen_list_print.c", "C", 30, 0, 0, 0, 22, 5, 57
"/Users/sbukhari/Sandbox/CProgram/ASTanalysis/CodexUserStudyData/raw_data/c23b2615-700f-48f2-b33d-3433d1c25bb6/parts/gen_list_remove_item_at_pos.c", "C", 38, 0, 0, 0, 11, 5, 54
"/Users/sbukhari/Sandbox/CProgram/ASTanalysis/CodexUserStudyData/raw_data/c23b2615-700f-48f2-b33d-3433d1c25bb6/parts/gen_list_save.c", "C", 31, 0, 0, 0, 13, 5, 49
"/Users/sbukhari/Sandbox/CProgram/ASTanalysis/CodexUserStudyData/raw_data/c23b2615-700f-48f2-b33d-3433d1c25bb6/parts/gen_list_swap_item_positions.c", "C", 55, 0, 0, 0, 9, 5, 69
"/Users/sbukhari/Sandbox/CProgram/ASTanalysis/CodexUserStudyData/raw_data/c23b2615-700f-48f2-b33d-3433d1c25bb6/parts/gen_list_update_item_at_pos.c", "C", 38, 0, 0, 0, 13, 5, 56
"/Users/sbukhari/Sandbox/CProgram/ASTanalysis/CodexUserStudyData/raw_data/c23b2615-700f-48f2-b33d-3433d1c25bb6/ref_testsuite.json", "JSON", 0, 323, 0, 0, 0, 1, 324
"/Users/sbukhari/Sandbox/CProgram/ASTanalysis/CodexUserStudyData/raw_data/c23b2615-700f-48f2-b33d-3433d1c25bb6/ref_testsuite_asan.json", "JSON", 0, 323, 0, 0, 0, 1, 324
"/Users/sbukhari/Sandbox/CProgram/ASTanalysis/CodexUserStudyData/raw_data/c23b2615-700f-48f2-b33d-3433d1c25bb6/ref_testsuite_asan_noleak.json", "JSON", 0, 323, 0, 0, 0, 1, 324
"/Users/sbukhari/Sandbox/CProgram/ASTanalysis/CodexUserStudyData/raw_data/c8a48b56-ce2e-4d25-8dd8-a23b5e6549b5/api_report.json", "JSON", 0, 14, 0, 0, 0, 1, 15
"/Users/sbukhari/Sandbox/CProgram/ASTanalysis/CodexUserStudyData/raw_data/c8a48b56-ce2e-4d25-8dd8-a23b5e6549b5/list.c", "C", 203, 0, 0, 0, 75, 33, 311
"/Users/sbukhari/Sandbox/CProgram/ASTanalysis/CodexUserStudyData/raw_data/c8a48b56-ce2e-4d25-8dd8-a23b5e6549b5/orig_testsuite.json", "JSON", 0, 92, 0, 0, 0, 1, 93
"/Users/sbukhari/Sandbox/CProgram/ASTanalysis/CodexUserStudyData/raw_data/c8a48b56-ce2e-4d25-8dd8-a23b5e6549b5/orig_testsuite_asan.json", "JSON", 0, 92, 0, 0, 0, 1, 93
"/Users/sbukhari/Sandbox/CProgram/ASTanalysis/CodexUserStudyData/raw_data/c8a48b56-ce2e-4d25-8dd8-a23b5e6549b5/orig_testsuite_asan_noleak.json", "JSON", 0, 92, 0, 0, 0, 1, 93
"/Users/sbukhari/Sandbox/CProgram/ASTanalysis/CodexUserStudyData/raw_data/c8a48b56-ce2e-4d25-8dd8-a23b5e6549b5/parts/gen_list_add_item_at_pos.c", "C", 38, 0, 0, 0, 20, 6, 64
"/Users/sbukhari/Sandbox/CProgram/ASTanalysis/CodexUserStudyData/raw_data/c8a48b56-ce2e-4d25-8dd8-a23b5e6549b5/parts/gen_list_cost_sum.c", "C", 29, 0, 0, 0, 10, 6, 45
"/Users/sbukhari/Sandbox/CProgram/ASTanalysis/CodexUserStudyData/raw_data/c8a48b56-ce2e-4d25-8dd8-a23b5e6549b5/parts/gen_list_deduplicate.c", "C", 46, 0, 0, 0, 15, 10, 71
"/Users/sbukhari/Sandbox/CProgram/ASTanalysis/CodexUserStudyData/raw_data/c8a48b56-ce2e-4d25-8dd8-a23b5e6549b5/parts/gen_list_find_highest_price_item_position.c", "C", 34, 0, 0, 0, 10, 6, 50
"/Users/sbukhari/Sandbox/CProgram/ASTanalysis/CodexUserStudyData/raw_data/c8a48b56-ce2e-4d25-8dd8-a23b5e6549b5/parts/gen_list_init.c", "C", 19, 0, 0, 0, 6, 6, 31
"/Users/sbukhari/Sandbox/CProgram/ASTanalysis/CodexUserStudyData/raw_data/c8a48b56-ce2e-4d25-8dd8-a23b5e6549b5/parts/gen_list_item_to_string.c", "C", 20, 0, 0, 0, 14, 6, 40
"/Users/sbukhari/Sandbox/CProgram/ASTanalysis/CodexUserStudyData/raw_data/c8a48b56-ce2e-4d25-8dd8-a23b5e6549b5/parts/gen_list_load.c", "C", 29, 0, 0, 0, 16, 6, 51
"/Users/sbukhari/Sandbox/CProgram/ASTanalysis/CodexUserStudyData/raw_data/c8a48b56-ce2e-4d25-8dd8-a23b5e6549b5/parts/gen_list_print.c", "C", 25, 0, 0, 0, 21, 5, 51
"/Users/sbukhari/Sandbox/CProgram/ASTanalysis/CodexUserStudyData/raw_data/c8a48b56-ce2e-4d25-8dd8-a23b5e6549b5/parts/gen_list_remove_item_at_pos.c", "C", 32, 0, 0, 0, 15, 7, 54
"/Users/sbukhari/Sandbox/CProgram/ASTanalysis/CodexUserStudyData/raw_data/c8a48b56-ce2e-4d25-8dd8-a23b5e6549b5/parts/gen_list_save.c", "C", 26, 0, 0, 0, 15, 6, 47
"/Users/sbukhari/Sandbox/CProgram/ASTanalysis/CodexUserStudyData/raw_data/c8a48b56-ce2e-4d25-8dd8-a23b5e6549b5/parts/gen_list_swap_item_positions.c", "C", 36, 0, 0, 0, 11, 7, 54
"/Users/sbukhari/Sandbox/CProgram/ASTanalysis/CodexUserStudyData/raw_data/c8a48b56-ce2e-4d25-8dd8-a23b5e6549b5/parts/gen_list_update_item_at_pos.c", "C", 24, 0, 0, 0, 13, 5, 42
"/Users/sbukhari/Sandbox/CProgram/ASTanalysis/CodexUserStudyData/raw_data/c8a48b56-ce2e-4d25-8dd8-a23b5e6549b5/ref_testsuite.json", "JSON", 0, 323, 0, 0, 0, 1, 324
"/Users/sbukhari/Sandbox/CProgram/ASTanalysis/CodexUserStudyData/raw_data/c8a48b56-ce2e-4d25-8dd8-a23b5e6549b5/ref_testsuite_asan.json", "JSON", 0, 323, 0, 0, 0, 1, 324
"/Users/sbukhari/Sandbox/CProgram/ASTanalysis/CodexUserStudyData/raw_data/c8a48b56-ce2e-4d25-8dd8-a23b5e6549b5/ref_testsuite_asan_noleak.json", "JSON", 0, 323, 0, 0, 0, 1, 324
"/Users/sbukhari/Sandbox/CProgram/ASTanalysis/CodexUserStudyData/raw_data/caa12fcb-10a7-4f65-997b-0e1b1ba2c96d/api_report.json", "JSON", 0, 14, 0, 0, 0, 1, 15
"/Users/sbukhari/Sandbox/CProgram/ASTanalysis/CodexUserStudyData/raw_data/caa12fcb-10a7-4f65-997b-0e1b1ba2c96d/list.c", "C", 87, 0, 0, 0, 76, 17, 180
"/Users/sbukhari/Sandbox/CProgram/ASTanalysis/CodexUserStudyData/raw_data/caa12fcb-10a7-4f65-997b-0e1b1ba2c96d/orig_testsuite.json", "JSON", 0, 92, 0, 0, 0, 1, 93
"/Users/sbukhari/Sandbox/CProgram/ASTanalysis/CodexUserStudyData/raw_data/caa12fcb-10a7-4f65-997b-0e1b1ba2c96d/orig_testsuite_asan.json", "JSON", 0, 92, 0, 0, 0, 1, 93
"/Users/sbukhari/Sandbox/CProgram/ASTanalysis/CodexUserStudyData/raw_data/caa12fcb-10a7-4f65-997b-0e1b1ba2c96d/orig_testsuite_asan_noleak.json", "JSON", 0, 92, 0, 0, 0, 1, 93
"/Users/sbukhari/Sandbox/CProgram/ASTanalysis/CodexUserStudyData/raw_data/caa12fcb-10a7-4f65-997b-0e1b1ba2c96d/parts/gen_list_add_item_at_pos.c", "C", 18, 0, 0, 0, 18, 5, 41
"/Users/sbukhari/Sandbox/CProgram/ASTanalysis/CodexUserStudyData/raw_data/caa12fcb-10a7-4f65-997b-0e1b1ba2c96d/parts/gen_list_cost_sum.c", "C", 23, 0, 0, 0, 10, 5, 38
"/Users/sbukhari/Sandbox/CProgram/ASTanalysis/CodexUserStudyData/raw_data/caa12fcb-10a7-4f65-997b-0e1b1ba2c96d/parts/gen_list_deduplicate.c", "C", 18, 0, 0, 0, 10, 5, 33
"/Users/sbukhari/Sandbox/CProgram/ASTanalysis/CodexUserStudyData/raw_data/caa12fcb-10a7-4f65-997b-0e1b1ba2c96d/parts/gen_list_find_highest_price_item_position.c", "C", 29, 0, 0, 0, 11, 5, 45
"/Users/sbukhari/Sandbox/CProgram/ASTanalysis/CodexUserStudyData/raw_data/caa12fcb-10a7-4f65-997b-0e1b1ba2c96d/parts/gen_list_init.c", "C", 19, 0, 0, 0, 6, 6, 31
"/Users/sbukhari/Sandbox/CProgram/ASTanalysis/CodexUserStudyData/raw_data/caa12fcb-10a7-4f65-997b-0e1b1ba2c96d/parts/gen_list_item_to_string.c", "C", 25, 0, 0, 0, 15, 5, 45
"/Users/sbukhari/Sandbox/CProgram/ASTanalysis/CodexUserStudyData/raw_data/caa12fcb-10a7-4f65-997b-0e1b1ba2c96d/parts/gen_list_load.c", "C", 18, 0, 0, 0, 12, 5, 35
"/Users/sbukhari/Sandbox/CProgram/ASTanalysis/CodexUserStudyData/raw_data/caa12fcb-10a7-4f65-997b-0e1b1ba2c96d/parts/gen_list_print.c", "C", 22, 0, 0, 0, 21, 5, 48
"/Users/sbukhari/Sandbox/CProgram/ASTanalysis/CodexUserStudyData/raw_data/caa12fcb-10a7-4f65-997b-0e1b1ba2c96d/parts/gen_list_remove_item_at_pos.c", "C", 18, 0, 0, 0, 8, 5, 31
"/Users/sbukhari/Sandbox/CProgram/ASTanalysis/CodexUserStudyData/raw_data/caa12fcb-10a7-4f65-997b-0e1b1ba2c96d/parts/gen_list_save.c", "C", 18, 0, 0, 0, 11, 5, 34
"/Users/sbukhari/Sandbox/CProgram/ASTanalysis/CodexUserStudyData/raw_data/caa12fcb-10a7-4f65-997b-0e1b1ba2c96d/parts/gen_list_swap_item_positions.c", "C", 17, 0, 0, 0, 8, 5, 30
"/Users/sbukhari/Sandbox/CProgram/ASTanalysis/CodexUserStudyData/raw_data/caa12fcb-10a7-4f65-997b-0e1b1ba2c96d/parts/gen_list_update_item_at_pos.c", "C", 17, 0, 0, 0, 8, 5, 30
"/Users/sbukhari/Sandbox/CProgram/ASTanalysis/CodexUserStudyData/raw_data/caa12fcb-10a7-4f65-997b-0e1b1ba2c96d/ref_testsuite.json", "JSON", 0, 323, 0, 0, 0, 1, 324
"/Users/sbukhari/Sandbox/CProgram/ASTanalysis/CodexUserStudyData/raw_data/caa12fcb-10a7-4f65-997b-0e1b1ba2c96d/ref_testsuite_asan.json", "JSON", 0, 323, 0, 0, 0, 1, 324
"/Users/sbukhari/Sandbox/CProgram/ASTanalysis/CodexUserStudyData/raw_data/caa12fcb-10a7-4f65-997b-0e1b1ba2c96d/ref_testsuite_asan_noleak.json", "JSON", 0, 323, 0, 0, 0, 1, 324
"/Users/sbukhari/Sandbox/CProgram/ASTanalysis/CodexUserStudyData/raw_data/cushman-001_00/api_report.json", "JSON", 0, 14, 0, 0, 0, 1, 15
"/Users/sbukhari/Sandbox/CProgram/ASTanalysis/CodexUserStudyData/raw_data/cushman-001_00/list.c", "C", 207, 0, 0, 0, 55, 17, 279
"/Users/sbukhari/Sandbox/CProgram/ASTanalysis/CodexUserStudyData/raw_data/cushman-001_00/orig_testsuite.json", "JSON", 0, 92, 0, 0, 0, 1, 93
"/Users/sbukhari/Sandbox/CProgram/ASTanalysis/CodexUserStudyData/raw_data/cushman-001_00/orig_testsuite_asan.json", "JSON", 0, 92, 0, 0, 0, 1, 93
"/Users/sbukhari/Sandbox/CProgram/ASTanalysis/CodexUserStudyData/raw_data/cushman-001_00/orig_testsuite_asan_noleak.json", "JSON", 0, 92, 0, 0, 0, 1, 93
"/Users/sbukhari/Sandbox/CProgram/ASTanalysis/CodexUserStudyData/raw_data/cushman-001_00/parts/gen_list_add_item_at_pos.c", "C", 34, 0, 0, 0, 17, 5, 56
"/Users/sbukhari/Sandbox/CProgram/ASTanalysis/CodexUserStudyData/raw_data/cushman-001_00/parts/gen_list_cost_sum.c", "C", 28, 0, 0, 0, 6, 5, 39
"/Users/sbukhari/Sandbox/CProgram/ASTanalysis/CodexUserStudyData/raw_data/cushman-001_00/parts/gen_list_deduplicate.c", "C", 36, 0, 0, 0, 9, 5, 50
"/Users/sbukhari/Sandbox/CProgram/ASTanalysis/CodexUserStudyData/raw_data/cushman-001_00/parts/gen_list_find_highest_price_item_position.c", "C", 32, 0, 0, 0, 6, 5, 43
"/Users/sbukhari/Sandbox/CProgram/ASTanalysis/CodexUserStudyData/raw_data/cushman-001_00/parts/gen_list_init.c", "C", 18, 0, 0, 0, 5, 5, 28
"/Users/sbukhari/Sandbox/CProgram/ASTanalysis/CodexUserStudyData/raw_data/cushman-001_00/parts/gen_list_item_to_string.c", "C", 22, 0, 0, 0, 11, 5, 38
"/Users/sbukhari/Sandbox/CProgram/ASTanalysis/CodexUserStudyData/raw_data/cushman-001_00/parts/gen_list_load.c", "C", 17, 0, 0, 0, 11, 5, 33
"/Users/sbukhari/Sandbox/CProgram/ASTanalysis/CodexUserStudyData/raw_data/cushman-001_00/parts/gen_list_print.c", "C", 29, 0, 0, 0, 19, 5, 53
"/Users/sbukhari/Sandbox/CProgram/ASTanalysis/CodexUserStudyData/raw_data/cushman-001_00/parts/gen_list_remove_item_at_pos.c", "C", 37, 0, 0, 0, 9, 5, 51
"/Users/sbukhari/Sandbox/CProgram/ASTanalysis/CodexUserStudyData/raw_data/cushman-001_00/parts/gen_list_save.c", "C", 33, 0, 0, 0, 10, 5, 48
"/Users/sbukhari/Sandbox/CProgram/ASTanalysis/CodexUserStudyData/raw_data/cushman-001_00/parts/gen_list_swap_item_positions.c", "C", 42, 0, 0, 0, 9, 5, 56
"/Users/sbukhari/Sandbox/CProgram/ASTanalysis/CodexUserStudyData/raw_data/cushman-001_00/parts/gen_list_update_item_at_pos.c", "C", 34, 0, 0, 0, 6, 5, 45
"/Users/sbukhari/Sandbox/CProgram/ASTanalysis/CodexUserStudyData/raw_data/cushman-001_00/ref_testsuite.json", "JSON", 0, 323, 0, 0, 0, 1, 324
"/Users/sbukhari/Sandbox/CProgram/ASTanalysis/CodexUserStudyData/raw_data/cushman-001_00/ref_testsuite_asan.json", "JSON", 0, 323, 0, 0, 0, 1, 324
"/Users/sbukhari/Sandbox/CProgram/ASTanalysis/CodexUserStudyData/raw_data/cushman-001_00/ref_testsuite_asan_noleak.json", "JSON", 0, 323, 0, 0, 0, 1, 324
"/Users/sbukhari/Sandbox/CProgram/ASTanalysis/CodexUserStudyData/raw_data/cushman-001_01/api_report.json", "JSON", 0, 14, 0, 0, 0, 1, 15
"/Users/sbukhari/Sandbox/CProgram/ASTanalysis/CodexUserStudyData/raw_data/cushman-001_01/list.c", "C", 262, 0, 0, 0, 53, 17, 332
"/Users/sbukhari/Sandbox/CProgram/ASTanalysis/CodexUserStudyData/raw_data/cushman-001_01/orig_testsuite.json", "JSON", 0, 92, 0, 0, 0, 1, 93
"/Users/sbukhari/Sandbox/CProgram/ASTanalysis/CodexUserStudyData/raw_data/cushman-001_01/orig_testsuite_asan.json", "JSON", 0, 92, 0, 0, 0, 1, 93
"/Users/sbukhari/Sandbox/CProgram/ASTanalysis/CodexUserStudyData/raw_data/cushman-001_01/orig_testsuite_asan_noleak.json", "JSON", 0, 92, 0, 0, 0, 1, 93
"/Users/sbukhari/Sandbox/CProgram/ASTanalysis/CodexUserStudyData/raw_data/cushman-001_01/parts/gen_list_add_item_at_pos.c", "C", 47, 0, 0, 0, 15, 5, 67
"/Users/sbukhari/Sandbox/CProgram/ASTanalysis/CodexUserStudyData/raw_data/cushman-001_01/parts/gen_list_cost_sum.c", "C", 27, 0, 0, 0, 6, 5, 38
"/Users/sbukhari/Sandbox/CProgram/ASTanalysis/CodexUserStudyData/raw_data/cushman-001_01/parts/gen_list_deduplicate.c", "C", 40, 0, 0, 0, 9, 5, 54
"/Users/sbukhari/Sandbox/CProgram/ASTanalysis/CodexUserStudyData/raw_data/cushman-001_01/parts/gen_list_find_highest_price_item_position.c", "C", 31, 0, 0, 0, 6, 5, 42
"/Users/sbukhari/Sandbox/CProgram/ASTanalysis/CodexUserStudyData/raw_data/cushman-001_01/parts/gen_list_init.c", "C", 27, 0, 0, 0, 5, 5, 37
"/Users/sbukhari/Sandbox/CProgram/ASTanalysis/CodexUserStudyData/raw_data/cushman-001_01/parts/gen_list_item_to_string.c", "C", 25, 0, 0, 0, 9, 5, 39
"/Users/sbukhari/Sandbox/CProgram/ASTanalysis/CodexUserStudyData/raw_data/cushman-001_01/parts/gen_list_load.c", "C", 38, 0, 0, 0, 12, 5, 55
"/Users/sbukhari/Sandbox/CProgram/ASTanalysis/CodexUserStudyData/raw_data/cushman-001_01/parts/gen_list_print.c", "C", 29, 0, 0, 0, 18, 5, 52
"/Users/sbukhari/Sandbox/CProgram/ASTanalysis/CodexUserStudyData/raw_data/cushman-001_01/parts/gen_list_remove_item_at_pos.c", "C", 39, 0, 0, 0, 7, 5, 51
"/Users/sbukhari/Sandbox/CProgram/ASTanalysis/CodexUserStudyData/raw_data/cushman-001_01/parts/gen_list_save.c", "C", 28, 0, 0, 0, 11, 5, 44
"/Users/sbukhari/Sandbox/CProgram/ASTanalysis/CodexUserStudyData/raw_data/cushman-001_01/parts/gen_list_swap_item_positions.c", "C", 52, 0, 0, 0, 6, 5, 63
"/Users/sbukhari/Sandbox/CProgram/ASTanalysis/CodexUserStudyData/raw_data/cushman-001_01/parts/gen_list_update_item_at_pos.c", "C", 33, 0, 0, 0, 7, 5, 45
"/Users/sbukhari/Sandbox/CProgram/ASTanalysis/CodexUserStudyData/raw_data/cushman-001_01/ref_testsuite.json", "JSON", 0, 323, 0, 0, 0, 1, 324
"/Users/sbukhari/Sandbox/CProgram/ASTanalysis/CodexUserStudyData/raw_data/cushman-001_01/ref_testsuite_asan.json", "JSON", 0, 323, 0, 0, 0, 1, 324
"/Users/sbukhari/Sandbox/CProgram/ASTanalysis/CodexUserStudyData/raw_data/cushman-001_01/ref_testsuite_asan_noleak.json", "JSON", 0, 323, 0, 0, 0, 1, 324
"/Users/sbukhari/Sandbox/CProgram/ASTanalysis/CodexUserStudyData/raw_data/cushman-001_02/api_report.json", "JSON", 0, 14, 0, 0, 0, 1, 15
"/Users/sbukhari/Sandbox/CProgram/ASTanalysis/CodexUserStudyData/raw_data/cushman-001_02/list.c", "C", 229, 0, 0, 0, 86, 17, 332
"/Users/sbukhari/Sandbox/CProgram/ASTanalysis/CodexUserStudyData/raw_data/cushman-001_02/orig_testsuite.json", "JSON", 0, 92, 0, 0, 0, 1, 93
"/Users/sbukhari/Sandbox/CProgram/ASTanalysis/CodexUserStudyData/raw_data/cushman-001_02/orig_testsuite_asan.json", "JSON", 0, 92, 0, 0, 0, 1, 93
"/Users/sbukhari/Sandbox/CProgram/ASTanalysis/CodexUserStudyData/raw_data/cushman-001_02/orig_testsuite_asan_noleak.json", "JSON", 0, 92, 0, 0, 0, 1, 93
"/Users/sbukhari/Sandbox/CProgram/ASTanalysis/CodexUserStudyData/raw_data/cushman-001_02/parts/gen_list_add_item_at_pos.c", "C", 42, 0, 0, 0, 21, 5, 68
"/Users/sbukhari/Sandbox/CProgram/ASTanalysis/CodexUserStudyData/raw_data/cushman-001_02/parts/gen_list_cost_sum.c", "C", 31, 0, 0, 0, 10, 5, 46
"/Users/sbukhari/Sandbox/CProgram/ASTanalysis/CodexUserStudyData/raw_data/cushman-001_02/parts/gen_list_deduplicate.c", "C", 17, 0, 0, 0, 9, 5, 31
"/Users/sbukhari/Sandbox/CProgram/ASTanalysis/CodexUserStudyData/raw_data/cushman-001_02/parts/gen_list_find_highest_price_item_position.c", "C", 36, 0, 0, 0, 9, 5, 50
"/Users/sbukhari/Sandbox/CProgram/ASTanalysis/CodexUserStudyData/raw_data/cushman-001_02/parts/gen_list_init.c", "C", 18, 0, 0, 0, 5, 5, 28
"/Users/sbukhari/Sandbox/CProgram/ASTanalysis/CodexUserStudyData/raw_data/cushman-001_02/parts/gen_list_item_to_string.c", "C", 25, 0, 0, 0, 10, 5, 40
"/Users/sbukhari/Sandbox/CProgram/ASTanalysis/CodexUserStudyData/raw_data/cushman-001_02/parts/gen_list_load.c", "C", 17, 0, 0, 0, 11, 5, 33
"/Users/sbukhari/Sandbox/CProgram/ASTanalysis/CodexUserStudyData/raw_data/cushman-001_02/parts/gen_list_print.c", "C", 32, 0, 0, 0, 18, 5, 55
"/Users/sbukhari/Sandbox/CProgram/ASTanalysis/CodexUserStudyData/raw_data/cushman-001_02/parts/gen_list_remove_item_at_pos.c", "C", 41, 0, 0, 0, 11, 5, 57
"/Users/sbukhari/Sandbox/CProgram/ASTanalysis/CodexUserStudyData/raw_data/cushman-001_02/parts/gen_list_save.c", "C", 33, 0, 0, 0, 15, 5, 53
"/Users/sbukhari/Sandbox/CProgram/ASTanalysis/CodexUserStudyData/raw_data/cushman-001_02/parts/gen_list_swap_item_positions.c", "C", 53, 0, 0, 0, 11, 5, 69
"/Users/sbukhari/Sandbox/CProgram/ASTanalysis/CodexUserStudyData/raw_data/cushman-001_02/parts/gen_list_update_item_at_pos.c", "C", 39, 0, 0, 0, 13, 5, 57
"/Users/sbukhari/Sandbox/CProgram/ASTanalysis/CodexUserStudyData/raw_data/cushman-001_02/ref_testsuite.json", "JSON", 0, 323, 0, 0, 0, 1, 324
"/Users/sbukhari/Sandbox/CProgram/ASTanalysis/CodexUserStudyData/raw_data/cushman-001_02/ref_testsuite_asan.json", "JSON", 0, 323, 0, 0, 0, 1, 324
"/Users/sbukhari/Sandbox/CProgram/ASTanalysis/CodexUserStudyData/raw_data/cushman-001_02/ref_testsuite_asan_noleak.json", "JSON", 0, 323, 0, 0, 0, 1, 324
"/Users/sbukhari/Sandbox/CProgram/ASTanalysis/CodexUserStudyData/raw_data/cushman-001_03/api_report.json", "JSON", 0, 14, 0, 0, 0, 1, 15
"/Users/sbukhari/Sandbox/CProgram/ASTanalysis/CodexUserStudyData/raw_data/cushman-001_03/list.c", "C", 251, 0, 0, 0, 126, 28, 405
"/Users/sbukhari/Sandbox/CProgram/ASTanalysis/CodexUserStudyData/raw_data/cushman-001_03/orig_testsuite.json", "JSON", 0, 92, 0, 0, 0, 1, 93
"/Users/sbukhari/Sandbox/CProgram/ASTanalysis/CodexUserStudyData/raw_data/cushman-001_03/orig_testsuite_asan.json", "JSON", 0, 92, 0, 0, 0, 1, 93
"/Users/sbukhari/Sandbox/CProgram/ASTanalysis/CodexUserStudyData/raw_data/cushman-001_03/orig_testsuite_asan_noleak.json", "JSON", 0, 92, 0, 0, 0, 1, 93
"/Users/sbukhari/Sandbox/CProgram/ASTanalysis/CodexUserStudyData/raw_data/cushman-001_03/parts/gen_list_add_item_at_pos.c", "C", 36, 0, 0, 0, 24, 6, 66
"/Users/sbukhari/Sandbox/CProgram/ASTanalysis/CodexUserStudyData/raw_data/cushman-001_03/parts/gen_list_cost_sum.c", "C", 36, 0, 0, 0, 18, 5, 59
"/Users/sbukhari/Sandbox/CProgram/ASTanalysis/CodexUserStudyData/raw_data/cushman-001_03/parts/gen_list_deduplicate.c", "C", 17, 0, 0, 0, 9, 5, 31
"/Users/sbukhari/Sandbox/CProgram/ASTanalysis/CodexUserStudyData/raw_data/cushman-001_03/parts/gen_list_find_highest_price_item_position.c", "C", 54, 0, 0, 0, 28, 5, 87
"/Users/sbukhari/Sandbox/CProgram/ASTanalysis/CodexUserStudyData/raw_data/cushman-001_03/parts/gen_list_init.c", "C", 18, 0, 0, 0, 5, 5, 28
"/Users/sbukhari/Sandbox/CProgram/ASTanalysis/CodexUserStudyData/raw_data/cushman-001_03/parts/gen_list_item_to_string.c", "C", 33, 0, 0, 0, 20, 8, 61
"/Users/sbukhari/Sandbox/CProgram/ASTanalysis/CodexUserStudyData/raw_data/cushman-001_03/parts/gen_list_load.c", "C", 17, 0, 0, 0, 11, 5, 33
"/Users/sbukhari/Sandbox/CProgram/ASTanalysis/CodexUserStudyData/raw_data/cushman-001_03/parts/gen_list_print.c", "C", 40, 0, 0, 0, 26, 8, 74
"/Users/sbukhari/Sandbox/CProgram/ASTanalysis/CodexUserStudyData/raw_data/cushman-001_03/parts/gen_list_remove_item_at_pos.c", "C", 32, 0, 0, 0, 14, 6, 52
"/Users/sbukhari/Sandbox/CProgram/ASTanalysis/CodexUserStudyData/raw_data/cushman-001_03/parts/gen_list_save.c", "C", 48, 0, 0, 0, 24, 5, 77
"/Users/sbukhari/Sandbox/CProgram/ASTanalysis/CodexUserStudyData/raw_data/cushman-001_03/parts/gen_list_swap_item_positions.c", "C", 43, 0, 0, 0, 22, 7, 72
"/Users/sbukhari/Sandbox/CProgram/ASTanalysis/CodexUserStudyData/raw_data/cushman-001_03/parts/gen_list_update_item_at_pos.c", "C", 32, 0, 0, 0, 14, 6, 52
"/Users/sbukhari/Sandbox/CProgram/ASTanalysis/CodexUserStudyData/raw_data/cushman-001_03/ref_testsuite.json", "JSON", 0, 323, 0, 0, 0, 1, 324
"/Users/sbukhari/Sandbox/CProgram/ASTanalysis/CodexUserStudyData/raw_data/cushman-001_03/ref_testsuite_asan.json", "JSON", 0, 323, 0, 0, 0, 1, 324
"/Users/sbukhari/Sandbox/CProgram/ASTanalysis/CodexUserStudyData/raw_data/cushman-001_03/ref_testsuite_asan_noleak.json", "JSON", 0, 323, 0, 0, 0, 1, 324
"/Users/sbukhari/Sandbox/CProgram/ASTanalysis/CodexUserStudyData/raw_data/cushman-001_04/api_report.json", "JSON", 0, 14, 0, 0, 0, 1, 15
"/Users/sbukhari/Sandbox/CProgram/ASTanalysis/CodexUserStudyData/raw_data/cushman-001_04/list.c", "C", 228, 0, 0, 0, 57, 17, 302
"/Users/sbukhari/Sandbox/CProgram/ASTanalysis/CodexUserStudyData/raw_data/cushman-001_04/orig_testsuite.json", "JSON", 0, 92, 0, 0, 0, 1, 93
"/Users/sbukhari/Sandbox/CProgram/ASTanalysis/CodexUserStudyData/raw_data/cushman-001_04/orig_testsuite_asan.json", "JSON", 0, 92, 0, 0, 0, 1, 93
"/Users/sbukhari/Sandbox/CProgram/ASTanalysis/CodexUserStudyData/raw_data/cushman-001_04/orig_testsuite_asan_noleak.json", "JSON", 0, 92, 0, 0, 0, 1, 93
"/Users/sbukhari/Sandbox/CProgram/ASTanalysis/CodexUserStudyData/raw_data/cushman-001_04/parts/gen_list_add_item_at_pos.c", "C", 54, 0, 0, 0, 22, 5, 81
"/Users/sbukhari/Sandbox/CProgram/ASTanalysis/CodexUserStudyData/raw_data/cushman-001_04/parts/gen_list_cost_sum.c", "C", 28, 0, 0, 0, 6, 5, 39
"/Users/sbukhari/Sandbox/CProgram/ASTanalysis/CodexUserStudyData/raw_data/cushman-001_04/parts/gen_list_deduplicate.c", "C", 34, 0, 0, 0, 10, 5, 49
"/Users/sbukhari/Sandbox/CProgram/ASTanalysis/CodexUserStudyData/raw_data/cushman-001_04/parts/gen_list_find_highest_price_item_position.c", "C", 35, 0, 0, 0, 7, 5, 47
"/Users/sbukhari/Sandbox/CProgram/ASTanalysis/CodexUserStudyData/raw_data/cushman-001_04/parts/gen_list_init.c", "C", 26, 0, 0, 0, 5, 5, 36
"/Users/sbukhari/Sandbox/CProgram/ASTanalysis/CodexUserStudyData/raw_data/cushman-001_04/parts/gen_list_item_to_string.c", "C", 22, 0, 0, 0, 13, 5, 40
"/Users/sbukhari/Sandbox/CProgram/ASTanalysis/CodexUserStudyData/raw_data/cushman-001_04/parts/gen_list_load.c", "C", 17, 0, 0, 0, 11, 5, 33
"/Users/sbukhari/Sandbox/CProgram/ASTanalysis/CodexUserStudyData/raw_data/cushman-001_04/parts/gen_list_print.c", "C", 28, 0, 0, 0, 20, 5, 53
"/Users/sbukhari/Sandbox/CProgram/ASTanalysis/CodexUserStudyData/raw_data/cushman-001_04/parts/gen_list_remove_item_at_pos.c", "C", 34, 0, 0, 0, 10, 5, 49
"/Users/sbukhari/Sandbox/CProgram/ASTanalysis/CodexUserStudyData/raw_data/cushman-001_04/parts/gen_list_save.c", "C", 32, 0, 0, 0, 11, 5, 48
"/Users/sbukhari/Sandbox/CProgram/ASTanalysis/CodexUserStudyData/raw_data/cushman-001_04/parts/gen_list_swap_item_positions.c", "C", 39, 0, 0, 0, 12, 5, 56
"/Users/sbukhari/Sandbox/CProgram/ASTanalysis/CodexUserStudyData/raw_data/cushman-001_04/parts/gen_list_update_item_at_pos.c", "C", 34, 0, 0, 0, 11, 5, 50
"/Users/sbukhari/Sandbox/CProgram/ASTanalysis/CodexUserStudyData/raw_data/cushman-001_04/ref_testsuite.json", "JSON", 0, 323, 0, 0, 0, 1, 324
"/Users/sbukhari/Sandbox/CProgram/ASTanalysis/CodexUserStudyData/raw_data/cushman-001_04/ref_testsuite_asan.json", "JSON", 0, 323, 0, 0, 0, 1, 324
"/Users/sbukhari/Sandbox/CProgram/ASTanalysis/CodexUserStudyData/raw_data/cushman-001_04/ref_testsuite_asan_noleak.json", "JSON", 0, 323, 0, 0, 0, 1, 324
"/Users/sbukhari/Sandbox/CProgram/ASTanalysis/CodexUserStudyData/raw_data/cushman-001_05/api_report.json", "JSON", 0, 14, 0, 0, 0, 1, 15
"/Users/sbukhari/Sandbox/CProgram/ASTanalysis/CodexUserStudyData/raw_data/cushman-001_05/list.c", "C", 252, 0, 0, 0, 126, 77, 455
"/Users/sbukhari/Sandbox/CProgram/ASTanalysis/CodexUserStudyData/raw_data/cushman-001_05/orig_testsuite.json", "JSON", 0, 92, 0, 0, 0, 1, 93
"/Users/sbukhari/Sandbox/CProgram/ASTanalysis/CodexUserStudyData/raw_data/cushman-001_05/orig_testsuite_asan.json", "JSON", 0, 92, 0, 0, 0, 1, 93
"/Users/sbukhari/Sandbox/CProgram/ASTanalysis/CodexUserStudyData/raw_data/cushman-001_05/orig_testsuite_asan_noleak.json", "JSON", 0, 92, 0, 0, 0, 1, 93
"/Users/sbukhari/Sandbox/CProgram/ASTanalysis/CodexUserStudyData/raw_data/cushman-001_05/parts/gen_list_add_item_at_pos.c", "C", 48, 0, 0, 0, 24, 13, 85
"/Users/sbukhari/Sandbox/CProgram/ASTanalysis/CodexUserStudyData/raw_data/cushman-001_05/parts/gen_list_cost_sum.c", "C", 29, 0, 0, 0, 10, 9, 48
"/Users/sbukhari/Sandbox/CProgram/ASTanalysis/CodexUserStudyData/raw_data/cushman-001_05/parts/gen_list_deduplicate.c", "C", 32, 0, 0, 0, 11, 8, 51
"/Users/sbukhari/Sandbox/CProgram/ASTanalysis/CodexUserStudyData/raw_data/cushman-001_05/parts/gen_list_find_highest_price_item_position.c", "C", 31, 0, 0, 0, 9, 8, 48
"/Users/sbukhari/Sandbox/CProgram/ASTanalysis/CodexUserStudyData/raw_data/cushman-001_05/parts/gen_list_init.c", "C", 28, 0, 0, 0, 10, 9, 47
"/Users/sbukhari/Sandbox/CProgram/ASTanalysis/CodexUserStudyData/raw_data/cushman-001_05/parts/gen_list_item_to_string.c", "C", 30, 0, 0, 0, 14, 10, 54
"/Users/sbukhari/Sandbox/CProgram/ASTanalysis/CodexUserStudyData/raw_data/cushman-001_05/parts/gen_list_load.c", "C", 17, 0, 0, 0, 11, 5, 33
"/Users/sbukhari/Sandbox/CProgram/ASTanalysis/CodexUserStudyData/raw_data/cushman-001_05/parts/gen_list_print.c", "C", 34, 0, 0, 0, 25, 11, 70
"/Users/sbukhari/Sandbox/CProgram/ASTanalysis/CodexUserStudyData/raw_data/cushman-001_05/parts/gen_list_remove_item_at_pos.c", "C", 44, 0, 0, 0, 12, 12, 68
"/Users/sbukhari/Sandbox/CProgram/ASTanalysis/CodexUserStudyData/raw_data/cushman-001_05/parts/gen_list_save.c", "C", 30, 0, 0, 0, 15, 11, 56
"/Users/sbukhari/Sandbox/CProgram/ASTanalysis/CodexUserStudyData/raw_data/cushman-001_05/parts/gen_list_swap_item_positions.c", "C", 41, 0, 0, 0, 12, 11, 64
"/Users/sbukhari/Sandbox/CProgram/ASTanalysis/CodexUserStudyData/raw_data/cushman-001_05/parts/gen_list_update_item_at_pos.c", "C", 43, 0, 0, 0, 14, 13, 70
"/Users/sbukhari/Sandbox/CProgram/ASTanalysis/CodexUserStudyData/raw_data/cushman-001_05/ref_testsuite.json", "JSON", 0, 323, 0, 0, 0, 1, 324
"/Users/sbukhari/Sandbox/CProgram/ASTanalysis/CodexUserStudyData/raw_data/cushman-001_05/ref_testsuite_asan.json", "JSON", 0, 323, 0, 0, 0, 1, 324
"/Users/sbukhari/Sandbox/CProgram/ASTanalysis/CodexUserStudyData/raw_data/cushman-001_05/ref_testsuite_asan_noleak.json", "JSON", 0, 323, 0, 0, 0, 1, 324
"/Users/sbukhari/Sandbox/CProgram/ASTanalysis/CodexUserStudyData/raw_data/cushman-001_06/api_report.json", "JSON", 0, 14, 0, 0, 0, 1, 15
"/Users/sbukhari/Sandbox/CProgram/ASTanalysis/CodexUserStudyData/raw_data/cushman-001_06/list.c", "C", 150, 0, 0, 0, 72, 34, 256
"/Users/sbukhari/Sandbox/CProgram/ASTanalysis/CodexUserStudyData/raw_data/cushman-001_06/orig_testsuite.json", "JSON", 0, 92, 0, 0, 0, 1, 93
"/Users/sbukhari/Sandbox/CProgram/ASTanalysis/CodexUserStudyData/raw_data/cushman-001_06/orig_testsuite_asan.json", "JSON", 0, 92, 0, 0, 0, 1, 93
"/Users/sbukhari/Sandbox/CProgram/ASTanalysis/CodexUserStudyData/raw_data/cushman-001_06/orig_testsuite_asan_noleak.json", "JSON", 0, 92, 0, 0, 0, 1, 93
"/Users/sbukhari/Sandbox/CProgram/ASTanalysis/CodexUserStudyData/raw_data/cushman-001_06/parts/gen_list_add_item_at_pos.c", "C", 45, 0, 0, 0, 20, 10, 75
"/Users/sbukhari/Sandbox/CProgram/ASTanalysis/CodexUserStudyData/raw_data/cushman-001_06/parts/gen_list_cost_sum.c", "C", 17, 0, 0, 0, 5, 5, 27
"/Users/sbukhari/Sandbox/CProgram/ASTanalysis/CodexUserStudyData/raw_data/cushman-001_06/parts/gen_list_deduplicate.c", "C", 17, 0, 0, 0, 7, 5, 29
"/Users/sbukhari/Sandbox/CProgram/ASTanalysis/CodexUserStudyData/raw_data/cushman-001_06/parts/gen_list_find_highest_price_item_position.c", "C", 17, 0, 0, 0, 5, 5, 27
"/Users/sbukhari/Sandbox/CProgram/ASTanalysis/CodexUserStudyData/raw_data/cushman-001_06/parts/gen_list_init.c", "C", 18, 0, 0, 0, 5, 5, 28
"/Users/sbukhari/Sandbox/CProgram/ASTanalysis/CodexUserStudyData/raw_data/cushman-001_06/parts/gen_list_item_to_string.c", "C", 32, 0, 0, 0, 11, 8, 51
"/Users/sbukhari/Sandbox/CProgram/ASTanalysis/CodexUserStudyData/raw_data/cushman-001_06/parts/gen_list_load.c", "C", 17, 0, 0, 0, 9, 5, 31
"/Users/sbukhari/Sandbox/CProgram/ASTanalysis/CodexUserStudyData/raw_data/cushman-001_06/parts/gen_list_print.c", "C", 32, 0, 0, 0, 20, 8, 60
"/Users/sbukhari/Sandbox/CProgram/ASTanalysis/CodexUserStudyData/raw_data/cushman-001_06/parts/gen_list_remove_item_at_pos.c", "C", 39, 0, 0, 0, 9, 8, 56
"/Users/sbukhari/Sandbox/CProgram/ASTanalysis/CodexUserStudyData/raw_data/cushman-001_06/parts/gen_list_save.c", "C", 17, 0, 0, 0, 8, 5, 30
"/Users/sbukhari/Sandbox/CProgram/ASTanalysis/CodexUserStudyData/raw_data/cushman-001_06/parts/gen_list_swap_item_positions.c", "C", 17, 0, 0, 0, 5, 5, 27
"/Users/sbukhari/Sandbox/CProgram/ASTanalysis/CodexUserStudyData/raw_data/cushman-001_06/parts/gen_list_update_item_at_pos.c", "C", 37, 0, 0, 0, 9, 8, 54
"/Users/sbukhari/Sandbox/CProgram/ASTanalysis/CodexUserStudyData/raw_data/cushman-001_06/ref_testsuite.json", "JSON", 0, 323, 0, 0, 0, 1, 324
"/Users/sbukhari/Sandbox/CProgram/ASTanalysis/CodexUserStudyData/raw_data/cushman-001_06/ref_testsuite_asan.json", "JSON", 0, 323, 0, 0, 0, 1, 324
"/Users/sbukhari/Sandbox/CProgram/ASTanalysis/CodexUserStudyData/raw_data/cushman-001_06/ref_testsuite_asan_noleak.json", "JSON", 0, 323, 0, 0, 0, 1, 324
"/Users/sbukhari/Sandbox/CProgram/ASTanalysis/CodexUserStudyData/raw_data/cushman-001_07/api_report.json", "JSON", 0, 14, 0, 0, 0, 1, 15
"/Users/sbukhari/Sandbox/CProgram/ASTanalysis/CodexUserStudyData/raw_data/cushman-001_07/list.c", "C", 275, 0, 0, 0, 56, 51, 382
"/Users/sbukhari/Sandbox/CProgram/ASTanalysis/CodexUserStudyData/raw_data/cushman-001_07/orig_testsuite.json", "JSON", 0, 92, 0, 0, 0, 1, 93
"/Users/sbukhari/Sandbox/CProgram/ASTanalysis/CodexUserStudyData/raw_data/cushman-001_07/orig_testsuite_asan.json", "JSON", 0, 92, 0, 0, 0, 1, 93
"/Users/sbukhari/Sandbox/CProgram/ASTanalysis/CodexUserStudyData/raw_data/cushman-001_07/orig_testsuite_asan_noleak.json", "JSON", 0, 92, 0, 0, 0, 1, 93
"/Users/sbukhari/Sandbox/CProgram/ASTanalysis/CodexUserStudyData/raw_data/cushman-001_07/parts/gen_list_add_item_at_pos.c", "C", 59, 0, 0, 0, 16, 13, 88
"/Users/sbukhari/Sandbox/CProgram/ASTanalysis/CodexUserStudyData/raw_data/cushman-001_07/parts/gen_list_cost_sum.c", "C", 27, 0, 0, 0, 5, 7, 39
"/Users/sbukhari/Sandbox/CProgram/ASTanalysis/CodexUserStudyData/raw_data/cushman-001_07/parts/gen_list_deduplicate.c", "C", 41, 0, 0, 0, 7, 9, 57
"/Users/sbukhari/Sandbox/CProgram/ASTanalysis/CodexUserStudyData/raw_data/cushman-001_07/parts/gen_list_find_highest_price_item_position.c", "C", 31, 0, 0, 0, 5, 7, 43
"/Users/sbukhari/Sandbox/CProgram/ASTanalysis/CodexUserStudyData/raw_data/cushman-001_07/parts/gen_list_init.c", "C", 21, 0, 0, 0, 5, 6, 32
"/Users/sbukhari/Sandbox/CProgram/ASTanalysis/CodexUserStudyData/raw_data/cushman-001_07/parts/gen_list_item_to_string.c", "C", 29, 0, 0, 0, 8, 6, 43
"/Users/sbukhari/Sandbox/CProgram/ASTanalysis/CodexUserStudyData/raw_data/cushman-001_07/parts/gen_list_load.c", "C", 17, 0, 0, 0, 11, 5, 33
"/Users/sbukhari/Sandbox/CProgram/ASTanalysis/CodexUserStudyData/raw_data/cushman-001_07/parts/gen_list_print.c", "C", 29, 0, 0, 0, 17, 7, 53
"/Users/sbukhari/Sandbox/CProgram/ASTanalysis/CodexUserStudyData/raw_data/cushman-001_07/parts/gen_list_remove_item_at_pos.c", "C", 54, 0, 0, 0, 5, 9, 68
"/Users/sbukhari/Sandbox/CProgram/ASTanalysis/CodexUserStudyData/raw_data/cushman-001_07/parts/gen_list_save.c", "C", 30, 0, 0, 0, 8, 8, 46
"/Users/sbukhari/Sandbox/CProgram/ASTanalysis/CodexUserStudyData/raw_data/cushman-001_07/parts/gen_list_swap_item_positions.c", "C", 47, 0, 0, 0, 5, 9, 61
"/Users/sbukhari/Sandbox/CProgram/ASTanalysis/CodexUserStudyData/raw_data/cushman-001_07/parts/gen_list_update_item_at_pos.c", "C", 45, 0, 0, 0, 5, 8, 58
"/Users/sbukhari/Sandbox/CProgram/ASTanalysis/CodexUserStudyData/raw_data/cushman-001_07/ref_testsuite.json", "JSON", 0, 323, 0, 0, 0, 1, 324
"/Users/sbukhari/Sandbox/CProgram/ASTanalysis/CodexUserStudyData/raw_data/cushman-001_07/ref_testsuite_asan.json", "JSON", 0, 323, 0, 0, 0, 1, 324
"/Users/sbukhari/Sandbox/CProgram/ASTanalysis/CodexUserStudyData/raw_data/cushman-001_07/ref_testsuite_asan_noleak.json", "JSON", 0, 323, 0, 0, 0, 1, 324
"/Users/sbukhari/Sandbox/CProgram/ASTanalysis/CodexUserStudyData/raw_data/cushman-001_08/api_report.json", "JSON", 0, 14, 0, 0, 0, 1, 15
"/Users/sbukhari/Sandbox/CProgram/ASTanalysis/CodexUserStudyData/raw_data/cushman-001_08/list.c", "C", 193, 0, 0, 0, 78, 64, 335
"/Users/sbukhari/Sandbox/CProgram/ASTanalysis/CodexUserStudyData/raw_data/cushman-001_08/orig_testsuite.json", "JSON", 0, 92, 0, 0, 0, 1, 93
"/Users/sbukhari/Sandbox/CProgram/ASTanalysis/CodexUserStudyData/raw_data/cushman-001_08/orig_testsuite_asan.json", "JSON", 0, 92, 0, 0, 0, 1, 93
"/Users/sbukhari/Sandbox/CProgram/ASTanalysis/CodexUserStudyData/raw_data/cushman-001_08/orig_testsuite_asan_noleak.json", "JSON", 0, 92, 0, 0, 0, 1, 93
"/Users/sbukhari/Sandbox/CProgram/ASTanalysis/CodexUserStudyData/raw_data/cushman-001_08/parts/gen_list_add_item_at_pos.c", "C", 48, 0, 0, 0, 18, 11, 77
"/Users/sbukhari/Sandbox/CProgram/ASTanalysis/CodexUserStudyData/raw_data/cushman-001_08/parts/gen_list_cost_sum.c", "C", 27, 0, 0, 0, 7, 9, 43
"/Users/sbukhari/Sandbox/CProgram/ASTanalysis/CodexUserStudyData/raw_data/cushman-001_08/parts/gen_list_deduplicate.c", "C", 17, 0, 0, 0, 9, 5, 31
"/Users/sbukhari/Sandbox/CProgram/ASTanalysis/CodexUserStudyData/raw_data/cushman-001_08/parts/gen_list_find_highest_price_item_position.c", "C", 30, 0, 0, 0, 7, 9, 46
"/Users/sbukhari/Sandbox/CProgram/ASTanalysis/CodexUserStudyData/raw_data/cushman-001_08/parts/gen_list_init.c", "C", 18, 0, 0, 0, 5, 5, 28
"/Users/sbukhari/Sandbox/CProgram/ASTanalysis/CodexUserStudyData/raw_data/cushman-001_08/parts/gen_list_item_to_string.c", "C", 32, 0, 0, 0, 11, 13, 56
"/Users/sbukhari/Sandbox/CProgram/ASTanalysis/CodexUserStudyData/raw_data/cushman-001_08/parts/gen_list_load.c", "C", 17, 0, 0, 0, 11, 5, 33
"/Users/sbukhari/Sandbox/CProgram/ASTanalysis/CodexUserStudyData/raw_data/cushman-001_08/parts/gen_list_print.c", "C", 26, 0, 0, 0, 17, 6, 49
"/Users/sbukhari/Sandbox/CProgram/ASTanalysis/CodexUserStudyData/raw_data/cushman-001_08/parts/gen_list_remove_item_at_pos.c", "C", 35, 0, 0, 0, 8, 11, 54
"/Users/sbukhari/Sandbox/CProgram/ASTanalysis/CodexUserStudyData/raw_data/cushman-001_08/parts/gen_list_save.c", "C", 29, 0, 0, 0, 11, 10, 50
"/Users/sbukhari/Sandbox/CProgram/ASTanalysis/CodexUserStudyData/raw_data/cushman-001_08/parts/gen_list_swap_item_positions.c", "C", 40, 0, 0, 0, 8, 13, 61
"/Users/sbukhari/Sandbox/CProgram/ASTanalysis/CodexUserStudyData/raw_data/cushman-001_08/parts/gen_list_update_item_at_pos.c", "C", 29, 0, 0, 0, 7, 10, 46
"/Users/sbukhari/Sandbox/CProgram/ASTanalysis/CodexUserStudyData/raw_data/cushman-001_08/ref_testsuite.json", "JSON", 0, 323, 0, 0, 0, 1, 324
"/Users/sbukhari/Sandbox/CProgram/ASTanalysis/CodexUserStudyData/raw_data/cushman-001_08/ref_testsuite_asan.json", "JSON", 0, 323, 0, 0, 0, 1, 324
"/Users/sbukhari/Sandbox/CProgram/ASTanalysis/CodexUserStudyData/raw_data/cushman-001_08/ref_testsuite_asan_noleak.json", "JSON", 0, 323, 0, 0, 0, 1, 324
"/Users/sbukhari/Sandbox/CProgram/ASTanalysis/CodexUserStudyData/raw_data/cushman-001_09/api_report.json", "JSON", 0, 14, 0, 0, 0, 1, 15
"/Users/sbukhari/Sandbox/CProgram/ASTanalysis/CodexUserStudyData/raw_data/cushman-001_09/list.c", "C", 236, 0, 0, 0, 55, 17, 308
"/Users/sbukhari/Sandbox/CProgram/ASTanalysis/CodexUserStudyData/raw_data/cushman-001_09/orig_testsuite.json", "JSON", 0, 92, 0, 0, 0, 1, 93
"/Users/sbukhari/Sandbox/CProgram/ASTanalysis/CodexUserStudyData/raw_data/cushman-001_09/orig_testsuite_asan.json", "JSON", 0, 92, 0, 0, 0, 1, 93
"/Users/sbukhari/Sandbox/CProgram/ASTanalysis/CodexUserStudyData/raw_data/cushman-001_09/orig_testsuite_asan_noleak.json", "JSON", 0, 92, 0, 0, 0, 1, 93
"/Users/sbukhari/Sandbox/CProgram/ASTanalysis/CodexUserStudyData/raw_data/cushman-001_09/parts/gen_list_add_item_at_pos.c", "C", 42, 0, 0, 0, 15, 5, 62
"/Users/sbukhari/Sandbox/CProgram/ASTanalysis/CodexUserStudyData/raw_data/cushman-001_09/parts/gen_list_cost_sum.c", "C", 28, 0, 0, 0, 5, 5, 38
"/Users/sbukhari/Sandbox/CProgram/ASTanalysis/CodexUserStudyData/raw_data/cushman-001_09/parts/gen_list_deduplicate.c", "C", 39, 0, 0, 0, 7, 5, 51
"/Users/sbukhari/Sandbox/CProgram/ASTanalysis/CodexUserStudyData/raw_data/cushman-001_09/parts/gen_list_find_highest_price_item_position.c", "C", 34, 0, 0, 0, 5, 5, 44
"/Users/sbukhari/Sandbox/CProgram/ASTanalysis/CodexUserStudyData/raw_data/cushman-001_09/parts/gen_list_init.c", "C", 27, 0, 0, 0, 5, 5, 37
"/Users/sbukhari/Sandbox/CProgram/ASTanalysis/CodexUserStudyData/raw_data/cushman-001_09/parts/gen_list_item_to_string.c", "C", 22, 0, 0, 0, 8, 5, 35
"/Users/sbukhari/Sandbox/CProgram/ASTanalysis/CodexUserStudyData/raw_data/cushman-001_09/parts/gen_list_load.c", "C", 17, 0, 0, 0, 11, 5, 33
"/Users/sbukhari/Sandbox/CProgram/ASTanalysis/CodexUserStudyData/raw_data/cushman-001_09/parts/gen_list_print.c", "C", 30, 0, 0, 0, 17, 5, 52
"/Users/sbukhari/Sandbox/CProgram/ASTanalysis/CodexUserStudyData/raw_data/cushman-001_09/parts/gen_list_remove_item_at_pos.c", "C", 37, 0, 0, 0, 5, 5, 47
"/Users/sbukhari/Sandbox/CProgram/ASTanalysis/CodexUserStudyData/raw_data/cushman-001_09/parts/gen_list_save.c", "C", 30, 0, 0, 0, 8, 5, 43
"/Users/sbukhari/Sandbox/CProgram/ASTanalysis/CodexUserStudyData/raw_data/cushman-001_09/parts/gen_list_swap_item_positions.c", "C", 55, 0, 0, 0, 5, 5, 65
"/Users/sbukhari/Sandbox/CProgram/ASTanalysis/CodexUserStudyData/raw_data/cushman-001_09/parts/gen_list_update_item_at_pos.c", "C", 30, 0, 0, 0, 5, 5, 40
"/Users/sbukhari/Sandbox/CProgram/ASTanalysis/CodexUserStudyData/raw_data/cushman-001_09/ref_testsuite.json", "JSON", 0, 323, 0, 0, 0, 1, 324
"/Users/sbukhari/Sandbox/CProgram/ASTanalysis/CodexUserStudyData/raw_data/cushman-001_09/ref_testsuite_asan.json", "JSON", 0, 323, 0, 0, 0, 1, 324
"/Users/sbukhari/Sandbox/CProgram/ASTanalysis/CodexUserStudyData/raw_data/cushman-001_09/ref_testsuite_asan_noleak.json", "JSON", 0, 323, 0, 0, 0, 1, 324
"/Users/sbukhari/Sandbox/CProgram/ASTanalysis/CodexUserStudyData/raw_data/dac37585-9926-4e20-8ac1-40addd42f1a8/api_report.json", "JSON", 0, 14, 0, 0, 0, 1, 15
"/Users/sbukhari/Sandbox/CProgram/ASTanalysis/CodexUserStudyData/raw_data/dac37585-9926-4e20-8ac1-40addd42f1a8/list.c", "C", 189, 0, 0, 0, 101, 20, 310
"/Users/sbukhari/Sandbox/CProgram/ASTanalysis/CodexUserStudyData/raw_data/dac37585-9926-4e20-8ac1-40addd42f1a8/orig_testsuite.json", "JSON", 0, 92, 0, 0, 0, 1, 93
"/Users/sbukhari/Sandbox/CProgram/ASTanalysis/CodexUserStudyData/raw_data/dac37585-9926-4e20-8ac1-40addd42f1a8/orig_testsuite_asan.json", "JSON", 0, 92, 0, 0, 0, 1, 93
"/Users/sbukhari/Sandbox/CProgram/ASTanalysis/CodexUserStudyData/raw_data/dac37585-9926-4e20-8ac1-40addd42f1a8/orig_testsuite_asan_noleak.json", "JSON", 0, 92, 0, 0, 0, 1, 93
"/Users/sbukhari/Sandbox/CProgram/ASTanalysis/CodexUserStudyData/raw_data/dac37585-9926-4e20-8ac1-40addd42f1a8/parts/gen_list_add_item_at_pos.c", "C", 42, 0, 0, 0, 21, 6, 69
"/Users/sbukhari/Sandbox/CProgram/ASTanalysis/CodexUserStudyData/raw_data/dac37585-9926-4e20-8ac1-40addd42f1a8/parts/gen_list_cost_sum.c", "C", 18, 0, 0, 0, 8, 5, 31
"/Users/sbukhari/Sandbox/CProgram/ASTanalysis/CodexUserStudyData/raw_data/dac37585-9926-4e20-8ac1-40addd42f1a8/parts/gen_list_deduplicate.c", "C", 18, 0, 0, 0, 10, 5, 33
"/Users/sbukhari/Sandbox/CProgram/ASTanalysis/CodexUserStudyData/raw_data/dac37585-9926-4e20-8ac1-40addd42f1a8/parts/gen_list_find_highest_price_item_position.c", "C", 18, 0, 0, 0, 8, 5, 31
"/Users/sbukhari/Sandbox/CProgram/ASTanalysis/CodexUserStudyData/raw_data/dac37585-9926-4e20-8ac1-40addd42f1a8/parts/gen_list_init.c", "C", 19, 0, 0, 0, 6, 5, 30
"/Users/sbukhari/Sandbox/CProgram/ASTanalysis/CodexUserStudyData/raw_data/dac37585-9926-4e20-8ac1-40addd42f1a8/parts/gen_list_item_to_string.c", "C", 21, 0, 0, 0, 13, 5, 39
"/Users/sbukhari/Sandbox/CProgram/ASTanalysis/CodexUserStudyData/raw_data/dac37585-9926-4e20-8ac1-40addd42f1a8/parts/gen_list_load.c", "C", 18, 0, 0, 0, 12, 5, 35
"/Users/sbukhari/Sandbox/CProgram/ASTanalysis/CodexUserStudyData/raw_data/dac37585-9926-4e20-8ac1-40addd42f1a8/parts/gen_list_print.c", "C", 30, 0, 0, 0, 22, 5, 57
"/Users/sbukhari/Sandbox/CProgram/ASTanalysis/CodexUserStudyData/raw_data/dac37585-9926-4e20-8ac1-40addd42f1a8/parts/gen_list_remove_item_at_pos.c", "C", 41, 0, 0, 0, 17, 5, 63
"/Users/sbukhari/Sandbox/CProgram/ASTanalysis/CodexUserStudyData/raw_data/dac37585-9926-4e20-8ac1-40addd42f1a8/parts/gen_list_save.c", "C", 18, 0, 0, 0, 11, 5, 34
"/Users/sbukhari/Sandbox/CProgram/ASTanalysis/CodexUserStudyData/raw_data/dac37585-9926-4e20-8ac1-40addd42f1a8/parts/gen_list_swap_item_positions.c", "C", 68, 0, 0, 0, 23, 6, 97
"/Users/sbukhari/Sandbox/CProgram/ASTanalysis/CodexUserStudyData/raw_data/dac37585-9926-4e20-8ac1-40addd42f1a8/parts/gen_list_update_item_at_pos.c", "C", 32, 0, 0, 0, 12, 5, 49
"/Users/sbukhari/Sandbox/CProgram/ASTanalysis/CodexUserStudyData/raw_data/dac37585-9926-4e20-8ac1-40addd42f1a8/ref_testsuite.json", "JSON", 0, 323, 0, 0, 0, 1, 324
"/Users/sbukhari/Sandbox/CProgram/ASTanalysis/CodexUserStudyData/raw_data/dac37585-9926-4e20-8ac1-40addd42f1a8/ref_testsuite_asan.json", "JSON", 0, 323, 0, 0, 0, 1, 324
"/Users/sbukhari/Sandbox/CProgram/ASTanalysis/CodexUserStudyData/raw_data/dac37585-9926-4e20-8ac1-40addd42f1a8/ref_testsuite_asan_noleak.json", "JSON", 0, 323, 0, 0, 0, 1, 324
"/Users/sbukhari/Sandbox/CProgram/ASTanalysis/CodexUserStudyData/raw_data/davinci-001_00/api_report.json", "JSON", 0, 14, 0, 0, 0, 1, 15
"/Users/sbukhari/Sandbox/CProgram/ASTanalysis/CodexUserStudyData/raw_data/davinci-001_00/list.c", "C", 334, 0, 0, 0, 53, 17, 404
"/Users/sbukhari/Sandbox/CProgram/ASTanalysis/CodexUserStudyData/raw_data/davinci-001_00/orig_testsuite.json", "JSON", 0, 92, 0, 0, 0, 1, 93
"/Users/sbukhari/Sandbox/CProgram/ASTanalysis/CodexUserStudyData/raw_data/davinci-001_00/orig_testsuite_asan.json", "JSON", 0, 92, 0, 0, 0, 1, 93
"/Users/sbukhari/Sandbox/CProgram/ASTanalysis/CodexUserStudyData/raw_data/davinci-001_00/orig_testsuite_asan_noleak.json", "JSON", 0, 92, 0, 0, 0, 1, 93
"/Users/sbukhari/Sandbox/CProgram/ASTanalysis/CodexUserStudyData/raw_data/davinci-001_00/parts/gen_list_add_item_at_pos.c", "C", 44, 0, 0, 0, 15, 5, 64
"/Users/sbukhari/Sandbox/CProgram/ASTanalysis/CodexUserStudyData/raw_data/davinci-001_00/parts/gen_list_cost_sum.c", "C", 28, 0, 0, 0, 5, 5, 38
"/Users/sbukhari/Sandbox/CProgram/ASTanalysis/CodexUserStudyData/raw_data/davinci-001_00/parts/gen_list_deduplicate.c", "C", 40, 0, 0, 0, 7, 5, 52
"/Users/sbukhari/Sandbox/CProgram/ASTanalysis/CodexUserStudyData/raw_data/davinci-001_00/parts/gen_list_find_highest_price_item_position.c", "C", 32, 0, 0, 0, 5, 5, 42
"/Users/sbukhari/Sandbox/CProgram/ASTanalysis/CodexUserStudyData/raw_data/davinci-001_00/parts/gen_list_init.c", "C", 22, 0, 0, 0, 5, 5, 32
"/Users/sbukhari/Sandbox/CProgram/ASTanalysis/CodexUserStudyData/raw_data/davinci-001_00/parts/gen_list_item_to_string.c", "C", 54, 0, 0, 0, 8, 5, 67
"/Users/sbukhari/Sandbox/CProgram/ASTanalysis/CodexUserStudyData/raw_data/davinci-001_00/parts/gen_list_load.c", "C", 60, 0, 0, 0, 9, 5, 74
"/Users/sbukhari/Sandbox/CProgram/ASTanalysis/CodexUserStudyData/raw_data/davinci-001_00/parts/gen_list_print.c", "C", 57, 0, 0, 0, 17, 5, 79
"/Users/sbukhari/Sandbox/CProgram/ASTanalysis/CodexUserStudyData/raw_data/davinci-001_00/parts/gen_list_remove_item_at_pos.c", "C", 33, 0, 0, 0, 5, 5, 43
"/Users/sbukhari/Sandbox/CProgram/ASTanalysis/CodexUserStudyData/raw_data/davinci-001_00/parts/gen_list_save.c", "C", 38, 0, 0, 0, 8, 5, 51
"/Users/sbukhari/Sandbox/CProgram/ASTanalysis/CodexUserStudyData/raw_data/davinci-001_00/parts/gen_list_swap_item_positions.c", "C", 47, 0, 0, 0, 5, 5, 57
"/Users/sbukhari/Sandbox/CProgram/ASTanalysis/CodexUserStudyData/raw_data/davinci-001_00/parts/gen_list_update_item_at_pos.c", "C", 34, 0, 0, 0, 5, 5, 44
"/Users/sbukhari/Sandbox/CProgram/ASTanalysis/CodexUserStudyData/raw_data/davinci-001_00/ref_testsuite.json", "JSON", 0, 323, 0, 0, 0, 1, 324
"/Users/sbukhari/Sandbox/CProgram/ASTanalysis/CodexUserStudyData/raw_data/davinci-001_00/ref_testsuite_asan.json", "JSON", 0, 323, 0, 0, 0, 1, 324
"/Users/sbukhari/Sandbox/CProgram/ASTanalysis/CodexUserStudyData/raw_data/davinci-001_00/ref_testsuite_asan_noleak.json", "JSON", 0, 323, 0, 0, 0, 1, 324
"/Users/sbukhari/Sandbox/CProgram/ASTanalysis/CodexUserStudyData/raw_data/davinci-001_01/api_report.json", "JSON", 0, 14, 0, 0, 0, 1, 15
"/Users/sbukhari/Sandbox/CProgram/ASTanalysis/CodexUserStudyData/raw_data/davinci-001_01/list.c", "C", 315, 0, 0, 0, 108, 17, 440
"/Users/sbukhari/Sandbox/CProgram/ASTanalysis/CodexUserStudyData/raw_data/davinci-001_01/orig_testsuite.json", "JSON", 0, 92, 0, 0, 0, 1, 93
"/Users/sbukhari/Sandbox/CProgram/ASTanalysis/CodexUserStudyData/raw_data/davinci-001_01/orig_testsuite_asan.json", "JSON", 0, 92, 0, 0, 0, 1, 93
"/Users/sbukhari/Sandbox/CProgram/ASTanalysis/CodexUserStudyData/raw_data/davinci-001_01/orig_testsuite_asan_noleak.json", "JSON", 0, 92, 0, 0, 0, 1, 93
"/Users/sbukhari/Sandbox/CProgram/ASTanalysis/CodexUserStudyData/raw_data/davinci-001_01/parts/gen_list_add_item_at_pos.c", "C", 45, 0, 0, 0, 20, 5, 70
"/Users/sbukhari/Sandbox/CProgram/ASTanalysis/CodexUserStudyData/raw_data/davinci-001_01/parts/gen_list_cost_sum.c", "C", 29, 0, 0, 0, 8, 5, 42
"/Users/sbukhari/Sandbox/CProgram/ASTanalysis/CodexUserStudyData/raw_data/davinci-001_01/parts/gen_list_deduplicate.c", "C", 35, 0, 0, 0, 11, 5, 51
"/Users/sbukhari/Sandbox/CProgram/ASTanalysis/CodexUserStudyData/raw_data/davinci-001_01/parts/gen_list_find_highest_price_item_position.c", "C", 33, 0, 0, 0, 9, 5, 47
"/Users/sbukhari/Sandbox/CProgram/ASTanalysis/CodexUserStudyData/raw_data/davinci-001_01/parts/gen_list_init.c", "C", 25, 0, 0, 0, 5, 5, 35
"/Users/sbukhari/Sandbox/CProgram/ASTanalysis/CodexUserStudyData/raw_data/davinci-001_01/parts/gen_list_item_to_string.c", "C", 38, 0, 0, 0, 17, 5, 60
"/Users/sbukhari/Sandbox/CProgram/ASTanalysis/CodexUserStudyData/raw_data/davinci-001_01/parts/gen_list_load.c", "C", 45, 0, 0, 0, 9, 5, 59
"/Users/sbukhari/Sandbox/CProgram/ASTanalysis/CodexUserStudyData/raw_data/davinci-001_01/parts/gen_list_print.c", "C", 41, 0, 0, 0, 26, 5, 72
"/Users/sbukhari/Sandbox/CProgram/ASTanalysis/CodexUserStudyData/raw_data/davinci-001_01/parts/gen_list_remove_item_at_pos.c", "C", 42, 0, 0, 0, 10, 5, 57
"/Users/sbukhari/Sandbox/CProgram/ASTanalysis/CodexUserStudyData/raw_data/davinci-001_01/parts/gen_list_save.c", "C", 38, 0, 0, 0, 8, 5, 51
"/Users/sbukhari/Sandbox/CProgram/ASTanalysis/CodexUserStudyData/raw_data/davinci-001_01/parts/gen_list_swap_item_positions.c", "C", 56, 0, 0, 0, 13, 5, 74
"/Users/sbukhari/Sandbox/CProgram/ASTanalysis/CodexUserStudyData/raw_data/davinci-001_01/parts/gen_list_update_item_at_pos.c", "C", 43, 0, 0, 0, 13, 5, 61
"/Users/sbukhari/Sandbox/CProgram/ASTanalysis/CodexUserStudyData/raw_data/davinci-001_01/ref_testsuite.json", "JSON", 0, 323, 0, 0, 0, 1, 324
"/Users/sbukhari/Sandbox/CProgram/ASTanalysis/CodexUserStudyData/raw_data/davinci-001_01/ref_testsuite_asan.json", "JSON", 0, 323, 0, 0, 0, 1, 324
"/Users/sbukhari/Sandbox/CProgram/ASTanalysis/CodexUserStudyData/raw_data/davinci-001_01/ref_testsuite_asan_noleak.json", "JSON", 0, 323, 0, 0, 0, 1, 324
"/Users/sbukhari/Sandbox/CProgram/ASTanalysis/CodexUserStudyData/raw_data/davinci-001_02/api_report.json", "JSON", 0, 14, 0, 0, 0, 1, 15
"/Users/sbukhari/Sandbox/CProgram/ASTanalysis/CodexUserStudyData/raw_data/davinci-001_02/list.c", "C", 122, 0, 0, 0, 80, 31, 233
"/Users/sbukhari/Sandbox/CProgram/ASTanalysis/CodexUserStudyData/raw_data/davinci-001_02/orig_testsuite.json", "JSON", 0, 92, 0, 0, 0, 1, 93
"/Users/sbukhari/Sandbox/CProgram/ASTanalysis/CodexUserStudyData/raw_data/davinci-001_02/orig_testsuite_asan.json", "JSON", 0, 92, 0, 0, 0, 1, 93
"/Users/sbukhari/Sandbox/CProgram/ASTanalysis/CodexUserStudyData/raw_data/davinci-001_02/orig_testsuite_asan_noleak.json", "JSON", 0, 92, 0, 0, 0, 1, 93
"/Users/sbukhari/Sandbox/CProgram/ASTanalysis/CodexUserStudyData/raw_data/davinci-001_02/parts/gen_list_add_item_at_pos.c", "C", 17, 0, 0, 0, 17, 5, 39
"/Users/sbukhari/Sandbox/CProgram/ASTanalysis/CodexUserStudyData/raw_data/davinci-001_02/parts/gen_list_cost_sum.c", "C", 17, 0, 0, 0, 7, 5, 29
"/Users/sbukhari/Sandbox/CProgram/ASTanalysis/CodexUserStudyData/raw_data/davinci-001_02/parts/gen_list_deduplicate.c", "C", 17, 0, 0, 0, 9, 5, 31
"/Users/sbukhari/Sandbox/CProgram/ASTanalysis/CodexUserStudyData/raw_data/davinci-001_02/parts/gen_list_find_highest_price_item_position.c", "C", 17, 0, 0, 0, 7, 5, 29
"/Users/sbukhari/Sandbox/CProgram/ASTanalysis/CodexUserStudyData/raw_data/davinci-001_02/parts/gen_list_init.c", "C", 22, 0, 0, 0, 6, 6, 34
"/Users/sbukhari/Sandbox/CProgram/ASTanalysis/CodexUserStudyData/raw_data/davinci-001_02/parts/gen_list_item_to_string.c", "C", 27, 0, 0, 0, 11, 8, 46
"/Users/sbukhari/Sandbox/CProgram/ASTanalysis/CodexUserStudyData/raw_data/davinci-001_02/parts/gen_list_load.c", "C", 49, 0, 0, 0, 15, 10, 74
"/Users/sbukhari/Sandbox/CProgram/ASTanalysis/CodexUserStudyData/raw_data/davinci-001_02/parts/gen_list_print.c", "C", 30, 0, 0, 0, 19, 7, 56
"/Users/sbukhari/Sandbox/CProgram/ASTanalysis/CodexUserStudyData/raw_data/davinci-001_02/parts/gen_list_remove_item_at_pos.c", "C", 17, 0, 0, 0, 7, 5, 29
"/Users/sbukhari/Sandbox/CProgram/ASTanalysis/CodexUserStudyData/raw_data/davinci-001_02/parts/gen_list_save.c", "C", 30, 0, 0, 0, 9, 8, 47
"/Users/sbukhari/Sandbox/CProgram/ASTanalysis/CodexUserStudyData/raw_data/davinci-001_02/parts/gen_list_swap_item_positions.c", "C", 17, 0, 0, 0, 7, 5, 29
"/Users/sbukhari/Sandbox/CProgram/ASTanalysis/CodexUserStudyData/raw_data/davinci-001_02/parts/gen_list_update_item_at_pos.c", "C", 17, 0, 0, 0, 7, 5, 29
"/Users/sbukhari/Sandbox/CProgram/ASTanalysis/CodexUserStudyData/raw_data/davinci-001_02/ref_testsuite.json", "JSON", 0, 323, 0, 0, 0, 1, 324
"/Users/sbukhari/Sandbox/CProgram/ASTanalysis/CodexUserStudyData/raw_data/davinci-001_02/ref_testsuite_asan.json", "JSON", 0, 323, 0, 0, 0, 1, 324
"/Users/sbukhari/Sandbox/CProgram/ASTanalysis/CodexUserStudyData/raw_data/davinci-001_02/ref_testsuite_asan_noleak.json", "JSON", 0, 323, 0, 0, 0, 1, 324
"/Users/sbukhari/Sandbox/CProgram/ASTanalysis/CodexUserStudyData/raw_data/davinci-001_03/api_report.json", "JSON", 0, 14, 0, 0, 0, 1, 15
"/Users/sbukhari/Sandbox/CProgram/ASTanalysis/CodexUserStudyData/raw_data/davinci-001_03/list.c", "C", 236, 0, 0, 0, 54, 17, 307
"/Users/sbukhari/Sandbox/CProgram/ASTanalysis/CodexUserStudyData/raw_data/davinci-001_03/orig_testsuite.json", "JSON", 0, 92, 0, 0, 0, 1, 93
"/Users/sbukhari/Sandbox/CProgram/ASTanalysis/CodexUserStudyData/raw_data/davinci-001_03/orig_testsuite_asan.json", "JSON", 0, 92, 0, 0, 0, 1, 93
"/Users/sbukhari/Sandbox/CProgram/ASTanalysis/CodexUserStudyData/raw_data/davinci-001_03/orig_testsuite_asan_noleak.json", "JSON", 0, 92, 0, 0, 0, 1, 93
"/Users/sbukhari/Sandbox/CProgram/ASTanalysis/CodexUserStudyData/raw_data/davinci-001_03/parts/gen_list_add_item_at_pos.c", "C", 38, 0, 0, 0, 15, 5, 58
"/Users/sbukhari/Sandbox/CProgram/ASTanalysis/CodexUserStudyData/raw_data/davinci-001_03/parts/gen_list_cost_sum.c", "C", 24, 0, 0, 0, 5, 5, 34
"/Users/sbukhari/Sandbox/CProgram/ASTanalysis/CodexUserStudyData/raw_data/davinci-001_03/parts/gen_list_deduplicate.c", "C", 30, 0, 0, 0, 8, 5, 43
"/Users/sbukhari/Sandbox/CProgram/ASTanalysis/CodexUserStudyData/raw_data/davinci-001_03/parts/gen_list_find_highest_price_item_position.c", "C", 30, 0, 0, 0, 5, 5, 40
"/Users/sbukhari/Sandbox/CProgram/ASTanalysis/CodexUserStudyData/raw_data/davinci-001_03/parts/gen_list_init.c", "C", 18, 0, 0, 0, 5, 5, 28
"/Users/sbukhari/Sandbox/CProgram/ASTanalysis/CodexUserStudyData/raw_data/davinci-001_03/parts/gen_list_item_to_string.c", "C", 30, 0, 0, 0, 8, 5, 43
"/Users/sbukhari/Sandbox/CProgram/ASTanalysis/CodexUserStudyData/raw_data/davinci-001_03/parts/gen_list_load.c", "C", 57, 0, 0, 0, 9, 5, 71
"/Users/sbukhari/Sandbox/CProgram/ASTanalysis/CodexUserStudyData/raw_data/davinci-001_03/parts/gen_list_print.c", "C", 24, 0, 0, 0, 17, 5, 46
"/Users/sbukhari/Sandbox/CProgram/ASTanalysis/CodexUserStudyData/raw_data/davinci-001_03/parts/gen_list_remove_item_at_pos.c", "C", 35, 0, 0, 0, 5, 5, 45
"/Users/sbukhari/Sandbox/CProgram/ASTanalysis/CodexUserStudyData/raw_data/davinci-001_03/parts/gen_list_save.c", "C", 27, 0, 0, 0, 8, 5, 40
"/Users/sbukhari/Sandbox/CProgram/ASTanalysis/CodexUserStudyData/raw_data/davinci-001_03/parts/gen_list_swap_item_positions.c", "C", 49, 0, 0, 0, 5, 5, 59
"/Users/sbukhari/Sandbox/CProgram/ASTanalysis/CodexUserStudyData/raw_data/davinci-001_03/parts/gen_list_update_item_at_pos.c", "C", 29, 0, 0, 0, 5, 5, 39
"/Users/sbukhari/Sandbox/CProgram/ASTanalysis/CodexUserStudyData/raw_data/davinci-001_03/ref_testsuite.json", "JSON", 0, 323, 0, 0, 0, 1, 324
"/Users/sbukhari/Sandbox/CProgram/ASTanalysis/CodexUserStudyData/raw_data/davinci-001_03/ref_testsuite_asan.json", "JSON", 0, 323, 0, 0, 0, 1, 324
"/Users/sbukhari/Sandbox/CProgram/ASTanalysis/CodexUserStudyData/raw_data/davinci-001_03/ref_testsuite_asan_noleak.json", "JSON", 0, 323, 0, 0, 0, 1, 324
"/Users/sbukhari/Sandbox/CProgram/ASTanalysis/CodexUserStudyData/raw_data/davinci-001_04/api_report.json", "JSON", 0, 14, 0, 0, 0, 1, 15
"/Users/sbukhari/Sandbox/CProgram/ASTanalysis/CodexUserStudyData/raw_data/davinci-001_04/list.c", "C", 236, 0, 0, 0, 53, 28, 317
"/Users/sbukhari/Sandbox/CProgram/ASTanalysis/CodexUserStudyData/raw_data/davinci-001_04/orig_testsuite.json", "JSON", 0, 92, 0, 0, 0, 1, 93
"/Users/sbukhari/Sandbox/CProgram/ASTanalysis/CodexUserStudyData/raw_data/davinci-001_04/orig_testsuite_asan.json", "JSON", 0, 92, 0, 0, 0, 1, 93
"/Users/sbukhari/Sandbox/CProgram/ASTanalysis/CodexUserStudyData/raw_data/davinci-001_04/orig_testsuite_asan_noleak.json", "JSON", 0, 92, 0, 0, 0, 1, 93
"/Users/sbukhari/Sandbox/CProgram/ASTanalysis/CodexUserStudyData/raw_data/davinci-001_04/parts/gen_list_add_item_at_pos.c", "C", 35, 0, 0, 0, 15, 7, 57
"/Users/sbukhari/Sandbox/CProgram/ASTanalysis/CodexUserStudyData/raw_data/davinci-001_04/parts/gen_list_cost_sum.c", "C", 27, 0, 0, 0, 5, 5, 37
"/Users/sbukhari/Sandbox/CProgram/ASTanalysis/CodexUserStudyData/raw_data/davinci-001_04/parts/gen_list_deduplicate.c", "C", 39, 0, 0, 0, 7, 5, 51
"/Users/sbukhari/Sandbox/CProgram/ASTanalysis/CodexUserStudyData/raw_data/davinci-001_04/parts/gen_list_find_highest_price_item_position.c", "C", 33, 0, 0, 0, 5, 5, 43
"/Users/sbukhari/Sandbox/CProgram/ASTanalysis/CodexUserStudyData/raw_data/davinci-001_04/parts/gen_list_init.c", "C", 22, 0, 0, 0, 5, 5, 32
"/Users/sbukhari/Sandbox/CProgram/ASTanalysis/CodexUserStudyData/raw_data/davinci-001_04/parts/gen_list_item_to_string.c", "C", 28, 0, 0, 0, 8, 6, 42
"/Users/sbukhari/Sandbox/CProgram/ASTanalysis/CodexUserStudyData/raw_data/davinci-001_04/parts/gen_list_load.c", "C", 40, 0, 0, 0, 9, 5, 54
"/Users/sbukhari/Sandbox/CProgram/ASTanalysis/CodexUserStudyData/raw_data/davinci-001_04/parts/gen_list_print.c", "C", 30, 0, 0, 0, 17, 5, 52
"/Users/sbukhari/Sandbox/CProgram/ASTanalysis/CodexUserStudyData/raw_data/davinci-001_04/parts/gen_list_remove_item_at_pos.c", "C", 32, 0, 0, 0, 5, 7, 44
"/Users/sbukhari/Sandbox/CProgram/ASTanalysis/CodexUserStudyData/raw_data/davinci-001_04/parts/gen_list_save.c", "C", 30, 0, 0, 0, 8, 5, 43
"/Users/sbukhari/Sandbox/CProgram/ASTanalysis/CodexUserStudyData/raw_data/davinci-001_04/parts/gen_list_swap_item_positions.c", "C", 43, 0, 0, 0, 5, 9, 57
"/Users/sbukhari/Sandbox/CProgram/ASTanalysis/CodexUserStudyData/raw_data/davinci-001_04/parts/gen_list_update_item_at_pos.c", "C", 32, 0, 0, 0, 5, 7, 44
"/Users/sbukhari/Sandbox/CProgram/ASTanalysis/CodexUserStudyData/raw_data/davinci-001_04/ref_testsuite.json", "JSON", 0, 323, 0, 0, 0, 1, 324
"/Users/sbukhari/Sandbox/CProgram/ASTanalysis/CodexUserStudyData/raw_data/davinci-001_04/ref_testsuite_asan.json", "JSON", 0, 323, 0, 0, 0, 1, 324
"/Users/sbukhari/Sandbox/CProgram/ASTanalysis/CodexUserStudyData/raw_data/davinci-001_04/ref_testsuite_asan_noleak.json", "JSON", 0, 323, 0, 0, 0, 1, 324
"/Users/sbukhari/Sandbox/CProgram/ASTanalysis/CodexUserStudyData/raw_data/davinci-001_05/api_report.json", "JSON", 0, 14, 0, 0, 0, 1, 15
"/Users/sbukhari/Sandbox/CProgram/ASTanalysis/CodexUserStudyData/raw_data/davinci-001_05/list.c", "C", 186, 0, 0, 0, 89, 47, 322
"/Users/sbukhari/Sandbox/CProgram/ASTanalysis/CodexUserStudyData/raw_data/davinci-001_05/orig_testsuite.json", "JSON", 0, 92, 0, 0, 0, 1, 93
"/Users/sbukhari/Sandbox/CProgram/ASTanalysis/CodexUserStudyData/raw_data/davinci-001_05/orig_testsuite_asan.json", "JSON", 0, 92, 0, 0, 0, 1, 93
"/Users/sbukhari/Sandbox/CProgram/ASTanalysis/CodexUserStudyData/raw_data/davinci-001_05/orig_testsuite_asan_noleak.json", "JSON", 0, 92, 0, 0, 0, 1, 93
"/Users/sbukhari/Sandbox/CProgram/ASTanalysis/CodexUserStudyData/raw_data/davinci-001_05/parts/gen_list_add_item_at_pos.c", "C", 17, 0, 0, 0, 17, 5, 39
"/Users/sbukhari/Sandbox/CProgram/ASTanalysis/CodexUserStudyData/raw_data/davinci-001_05/parts/gen_list_cost_sum.c", "C", 32, 0, 0, 0, 8, 9, 49
"/Users/sbukhari/Sandbox/CProgram/ASTanalysis/CodexUserStudyData/raw_data/davinci-001_05/parts/gen_list_deduplicate.c", "C", 38, 0, 0, 0, 9, 7, 54
"/Users/sbukhari/Sandbox/CProgram/ASTanalysis/CodexUserStudyData/raw_data/davinci-001_05/parts/gen_list_find_highest_price_item_position.c", "C", 17, 0, 0, 0, 7, 5, 29
"/Users/sbukhari/Sandbox/CProgram/ASTanalysis/CodexUserStudyData/raw_data/davinci-001_05/parts/gen_list_init.c", "C", 26, 0, 0, 0, 7, 7, 40
"/Users/sbukhari/Sandbox/CProgram/ASTanalysis/CodexUserStudyData/raw_data/davinci-001_05/parts/gen_list_item_to_string.c", "C", 48, 0, 0, 0, 18, 15, 81
"/Users/sbukhari/Sandbox/CProgram/ASTanalysis/CodexUserStudyData/raw_data/davinci-001_05/parts/gen_list_load.c", "C", 46, 0, 0, 0, 13, 9, 68
"/Users/sbukhari/Sandbox/CProgram/ASTanalysis/CodexUserStudyData/raw_data/davinci-001_05/parts/gen_list_print.c", "C", 30, 0, 0, 0, 19, 8, 57
"/Users/sbukhari/Sandbox/CProgram/ASTanalysis/CodexUserStudyData/raw_data/davinci-001_05/parts/gen_list_remove_item_at_pos.c", "C", 17, 0, 0, 0, 7, 5, 29
"/Users/sbukhari/Sandbox/CProgram/ASTanalysis/CodexUserStudyData/raw_data/davinci-001_05/parts/gen_list_save.c", "C", 36, 0, 0, 0, 11, 10, 57
"/Users/sbukhari/Sandbox/CProgram/ASTanalysis/CodexUserStudyData/raw_data/davinci-001_05/parts/gen_list_swap_item_positions.c", "C", 17, 0, 0, 0, 7, 5, 29
"/Users/sbukhari/Sandbox/CProgram/ASTanalysis/CodexUserStudyData/raw_data/davinci-001_05/parts/gen_list_update_item_at_pos.c", "C", 17, 0, 0, 0, 7, 5, 29
"/Users/sbukhari/Sandbox/CProgram/ASTanalysis/CodexUserStudyData/raw_data/davinci-001_05/ref_testsuite.json", "JSON", 0, 323, 0, 0, 0, 1, 324
"/Users/sbukhari/Sandbox/CProgram/ASTanalysis/CodexUserStudyData/raw_data/davinci-001_05/ref_testsuite_asan.json", "JSON", 0, 323, 0, 0, 0, 1, 324
"/Users/sbukhari/Sandbox/CProgram/ASTanalysis/CodexUserStudyData/raw_data/davinci-001_05/ref_testsuite_asan_noleak.json", "JSON", 0, 323, 0, 0, 0, 1, 324
"/Users/sbukhari/Sandbox/CProgram/ASTanalysis/CodexUserStudyData/raw_data/davinci-001_06/api_report.json", "JSON", 0, 14, 0, 0, 0, 1, 15
"/Users/sbukhari/Sandbox/CProgram/ASTanalysis/CodexUserStudyData/raw_data/davinci-001_06/list.c", "C", 308, 0, 0, 0, 53, 17, 378
"/Users/sbukhari/Sandbox/CProgram/ASTanalysis/CodexUserStudyData/raw_data/davinci-001_06/orig_testsuite.json", "JSON", 0, 92, 0, 0, 0, 1, 93
"/Users/sbukhari/Sandbox/CProgram/ASTanalysis/CodexUserStudyData/raw_data/davinci-001_06/orig_testsuite_asan.json", "JSON", 0, 92, 0, 0, 0, 1, 93
"/Users/sbukhari/Sandbox/CProgram/ASTanalysis/CodexUserStudyData/raw_data/davinci-001_06/orig_testsuite_asan_noleak.json", "JSON", 0, 92, 0, 0, 0, 1, 93
"/Users/sbukhari/Sandbox/CProgram/ASTanalysis/CodexUserStudyData/raw_data/davinci-001_06/parts/gen_list_add_item_at_pos.c", "C", 60, 0, 0, 0, 15, 5, 80
"/Users/sbukhari/Sandbox/CProgram/ASTanalysis/CodexUserStudyData/raw_data/davinci-001_06/parts/gen_list_cost_sum.c", "C", 27, 0, 0, 0, 5, 5, 37
"/Users/sbukhari/Sandbox/CProgram/ASTanalysis/CodexUserStudyData/raw_data/davinci-001_06/parts/gen_list_deduplicate.c", "C", 36, 0, 0, 0, 7, 5, 48
"/Users/sbukhari/Sandbox/CProgram/ASTanalysis/CodexUserStudyData/raw_data/davinci-001_06/parts/gen_list_find_highest_price_item_position.c", "C", 32, 0, 0, 0, 5, 5, 42
"/Users/sbukhari/Sandbox/CProgram/ASTanalysis/CodexUserStudyData/raw_data/davinci-001_06/parts/gen_list_init.c", "C", 26, 0, 0, 0, 5, 5, 36
"/Users/sbukhari/Sandbox/CProgram/ASTanalysis/CodexUserStudyData/raw_data/davinci-001_06/parts/gen_list_item_to_string.c", "C", 32, 0, 0, 0, 8, 5, 45
"/Users/sbukhari/Sandbox/CProgram/ASTanalysis/CodexUserStudyData/raw_data/davinci-001_06/parts/gen_list_load.c", "C", 44, 0, 0, 0, 9, 5, 58
"/Users/sbukhari/Sandbox/CProgram/ASTanalysis/CodexUserStudyData/raw_data/davinci-001_06/parts/gen_list_print.c", "C", 34, 0, 0, 0, 17, 5, 56
"/Users/sbukhari/Sandbox/CProgram/ASTanalysis/CodexUserStudyData/raw_data/davinci-001_06/parts/gen_list_remove_item_at_pos.c", "C", 39, 0, 0, 0, 5, 5, 49
"/Users/sbukhari/Sandbox/CProgram/ASTanalysis/CodexUserStudyData/raw_data/davinci-001_06/parts/gen_list_save.c", "C", 36, 0, 0, 0, 8, 5, 49
"/Users/sbukhari/Sandbox/CProgram/ASTanalysis/CodexUserStudyData/raw_data/davinci-001_06/parts/gen_list_swap_item_positions.c", "C", 59, 0, 0, 0, 5, 5, 69
"/Users/sbukhari/Sandbox/CProgram/ASTanalysis/CodexUserStudyData/raw_data/davinci-001_06/parts/gen_list_update_item_at_pos.c", "C", 38, 0, 0, 0, 5, 5, 48
"/Users/sbukhari/Sandbox/CProgram/ASTanalysis/CodexUserStudyData/raw_data/davinci-001_06/ref_testsuite.json", "JSON", 0, 323, 0, 0, 0, 1, 324
"/Users/sbukhari/Sandbox/CProgram/ASTanalysis/CodexUserStudyData/raw_data/davinci-001_06/ref_testsuite_asan.json", "JSON", 0, 323, 0, 0, 0, 1, 324
"/Users/sbukhari/Sandbox/CProgram/ASTanalysis/CodexUserStudyData/raw_data/davinci-001_06/ref_testsuite_asan_noleak.json", "JSON", 0, 323, 0, 0, 0, 1, 324
"/Users/sbukhari/Sandbox/CProgram/ASTanalysis/CodexUserStudyData/raw_data/davinci-001_07/api_report.json", "JSON", 0, 14, 0, 0, 0, 1, 15
"/Users/sbukhari/Sandbox/CProgram/ASTanalysis/CodexUserStudyData/raw_data/davinci-001_07/list.c", "C", 222, 0, 0, 0, 54, 72, 348
"/Users/sbukhari/Sandbox/CProgram/ASTanalysis/CodexUserStudyData/raw_data/davinci-001_07/orig_testsuite.json", "JSON", 0, 92, 0, 0, 0, 1, 93
"/Users/sbukhari/Sandbox/CProgram/ASTanalysis/CodexUserStudyData/raw_data/davinci-001_07/orig_testsuite_asan.json", "JSON", 0, 92, 0, 0, 0, 1, 93
"/Users/sbukhari/Sandbox/CProgram/ASTanalysis/CodexUserStudyData/raw_data/davinci-001_07/orig_testsuite_asan_noleak.json", "JSON", 0, 92, 0, 0, 0, 1, 93
"/Users/sbukhari/Sandbox/CProgram/ASTanalysis/CodexUserStudyData/raw_data/davinci-001_07/parts/gen_list_add_item_at_pos.c", "C", 45, 0, 0, 0, 15, 16, 76
"/Users/sbukhari/Sandbox/CProgram/ASTanalysis/CodexUserStudyData/raw_data/davinci-001_07/parts/gen_list_cost_sum.c", "C", 26, 0, 0, 0, 5, 7, 38
"/Users/sbukhari/Sandbox/CProgram/ASTanalysis/CodexUserStudyData/raw_data/davinci-001_07/parts/gen_list_deduplicate.c", "C", 34, 0, 0, 0, 7, 9, 50
"/Users/sbukhari/Sandbox/CProgram/ASTanalysis/CodexUserStudyData/raw_data/davinci-001_07/parts/gen_list_find_highest_price_item_position.c", "C", 32, 0, 0, 0, 5, 10, 47
"/Users/sbukhari/Sandbox/CProgram/ASTanalysis/CodexUserStudyData/raw_data/davinci-001_07/parts/gen_list_init.c", "C", 21, 0, 0, 0, 5, 8, 34
"/Users/sbukhari/Sandbox/CProgram/ASTanalysis/CodexUserStudyData/raw_data/davinci-001_07/parts/gen_list_item_to_string.c", "C", 25, 0, 0, 0, 8, 8, 41
"/Users/sbukhari/Sandbox/CProgram/ASTanalysis/CodexUserStudyData/raw_data/davinci-001_07/parts/gen_list_load.c", "C", 42, 0, 0, 0, 10, 12, 64
"/Users/sbukhari/Sandbox/CProgram/ASTanalysis/CodexUserStudyData/raw_data/davinci-001_07/parts/gen_list_print.c", "C", 27, 0, 0, 0, 17, 8, 52
"/Users/sbukhari/Sandbox/CProgram/ASTanalysis/CodexUserStudyData/raw_data/davinci-001_07/parts/gen_list_remove_item_at_pos.c", "C", 30, 0, 0, 0, 5, 9, 44
"/Users/sbukhari/Sandbox/CProgram/ASTanalysis/CodexUserStudyData/raw_data/davinci-001_07/parts/gen_list_save.c", "C", 28, 0, 0, 0, 8, 9, 45
"/Users/sbukhari/Sandbox/CProgram/ASTanalysis/CodexUserStudyData/raw_data/davinci-001_07/parts/gen_list_swap_item_positions.c", "C", 36, 0, 0, 0, 5, 10, 51
"/Users/sbukhari/Sandbox/CProgram/ASTanalysis/CodexUserStudyData/raw_data/davinci-001_07/parts/gen_list_update_item_at_pos.c", "C", 31, 0, 0, 0, 5, 9, 45
"/Users/sbukhari/Sandbox/CProgram/ASTanalysis/CodexUserStudyData/raw_data/davinci-001_07/ref_testsuite.json", "JSON", 0, 323, 0, 0, 0, 1, 324
"/Users/sbukhari/Sandbox/CProgram/ASTanalysis/CodexUserStudyData/raw_data/davinci-001_07/ref_testsuite_asan.json", "JSON", 0, 323, 0, 0, 0, 1, 324
"/Users/sbukhari/Sandbox/CProgram/ASTanalysis/CodexUserStudyData/raw_data/davinci-001_07/ref_testsuite_asan_noleak.json", "JSON", 0, 323, 0, 0, 0, 1, 324
"/Users/sbukhari/Sandbox/CProgram/ASTanalysis/CodexUserStudyData/raw_data/davinci-001_08/api_report.json", "JSON", 0, 14, 0, 0, 0, 1, 15
"/Users/sbukhari/Sandbox/CProgram/ASTanalysis/CodexUserStudyData/raw_data/davinci-001_08/list.c", "C", 290, 0, 0, 0, 53, 71, 414
"/Users/sbukhari/Sandbox/CProgram/ASTanalysis/CodexUserStudyData/raw_data/davinci-001_08/orig_testsuite.json", "JSON", 0, 92, 0, 0, 0, 1, 93
"/Users/sbukhari/Sandbox/CProgram/ASTanalysis/CodexUserStudyData/raw_data/davinci-001_08/orig_testsuite_asan.json", "JSON", 0, 92, 0, 0, 0, 1, 93
"/Users/sbukhari/Sandbox/CProgram/ASTanalysis/CodexUserStudyData/raw_data/davinci-001_08/orig_testsuite_asan_noleak.json", "JSON", 0, 92, 0, 0, 0, 1, 93
"/Users/sbukhari/Sandbox/CProgram/ASTanalysis/CodexUserStudyData/raw_data/davinci-001_08/parts/gen_list_add_item_at_pos.c", "C", 44, 0, 0, 0, 15, 10, 69
"/Users/sbukhari/Sandbox/CProgram/ASTanalysis/CodexUserStudyData/raw_data/davinci-001_08/parts/gen_list_cost_sum.c", "C", 24, 0, 0, 0, 5, 7, 36
"/Users/sbukhari/Sandbox/CProgram/ASTanalysis/CodexUserStudyData/raw_data/davinci-001_08/parts/gen_list_deduplicate.c", "C", 36, 0, 0, 0, 7, 9, 52
"/Users/sbukhari/Sandbox/CProgram/ASTanalysis/CodexUserStudyData/raw_data/davinci-001_08/parts/gen_list_find_highest_price_item_position.c", "C", 32, 0, 0, 0, 5, 9, 46
"/Users/sbukhari/Sandbox/CProgram/ASTanalysis/CodexUserStudyData/raw_data/davinci-001_08/parts/gen_list_init.c", "C", 18, 0, 0, 0, 5, 5, 28
"/Users/sbukhari/Sandbox/CProgram/ASTanalysis/CodexUserStudyData/raw_data/davinci-001_08/parts/gen_list_item_to_string.c", "C", 36, 0, 0, 0, 8, 9, 53
"/Users/sbukhari/Sandbox/CProgram/ASTanalysis/CodexUserStudyData/raw_data/davinci-001_08/parts/gen_list_load.c", "C", 51, 0, 0, 0, 9, 13, 73
"/Users/sbukhari/Sandbox/CProgram/ASTanalysis/CodexUserStudyData/raw_data/davinci-001_08/parts/gen_list_print.c", "C", 43, 0, 0, 0, 17, 12, 72
"/Users/sbukhari/Sandbox/CProgram/ASTanalysis/CodexUserStudyData/raw_data/davinci-001_08/parts/gen_list_remove_item_at_pos.c", "C", 32, 0, 0, 0, 5, 9, 46
"/Users/sbukhari/Sandbox/CProgram/ASTanalysis/CodexUserStudyData/raw_data/davinci-001_08/parts/gen_list_save.c", "C", 29, 0, 0, 0, 8, 9, 46
"/Users/sbukhari/Sandbox/CProgram/ASTanalysis/CodexUserStudyData/raw_data/davinci-001_08/parts/gen_list_swap_item_positions.c", "C", 63, 0, 0, 0, 5, 14, 82
"/Users/sbukhari/Sandbox/CProgram/ASTanalysis/CodexUserStudyData/raw_data/davinci-001_08/parts/gen_list_update_item_at_pos.c", "C", 37, 0, 0, 0, 5, 8, 50
"/Users/sbukhari/Sandbox/CProgram/ASTanalysis/CodexUserStudyData/raw_data/davinci-001_08/ref_testsuite.json", "JSON", 0, 323, 0, 0, 0, 1, 324
"/Users/sbukhari/Sandbox/CProgram/ASTanalysis/CodexUserStudyData/raw_data/davinci-001_08/ref_testsuite_asan.json", "JSON", 0, 323, 0, 0, 0, 1, 324
"/Users/sbukhari/Sandbox/CProgram/ASTanalysis/CodexUserStudyData/raw_data/davinci-001_08/ref_testsuite_asan_noleak.json", "JSON", 0, 323, 0, 0, 0, 1, 324
"/Users/sbukhari/Sandbox/CProgram/ASTanalysis/CodexUserStudyData/raw_data/davinci-001_09/api_report.json", "JSON", 0, 14, 0, 0, 0, 1, 15
"/Users/sbukhari/Sandbox/CProgram/ASTanalysis/CodexUserStudyData/raw_data/davinci-001_09/list.c", "C", 136, 0, 0, 0, 88, 44, 268
"/Users/sbukhari/Sandbox/CProgram/ASTanalysis/CodexUserStudyData/raw_data/davinci-001_09/orig_testsuite.json", "JSON", 0, 92, 0, 0, 0, 1, 93
"/Users/sbukhari/Sandbox/CProgram/ASTanalysis/CodexUserStudyData/raw_data/davinci-001_09/orig_testsuite_asan.json", "JSON", 0, 92, 0, 0, 0, 1, 93
"/Users/sbukhari/Sandbox/CProgram/ASTanalysis/CodexUserStudyData/raw_data/davinci-001_09/orig_testsuite_asan_noleak.json", "JSON", 0, 92, 0, 0, 0, 1, 93
"/Users/sbukhari/Sandbox/CProgram/ASTanalysis/CodexUserStudyData/raw_data/davinci-001_09/parts/gen_list_add_item_at_pos.c", "C", 17, 0, 0, 0, 17, 5, 39
"/Users/sbukhari/Sandbox/CProgram/ASTanalysis/CodexUserStudyData/raw_data/davinci-001_09/parts/gen_list_cost_sum.c", "C", 27, 0, 0, 0, 9, 9, 45
"/Users/sbukhari/Sandbox/CProgram/ASTanalysis/CodexUserStudyData/raw_data/davinci-001_09/parts/gen_list_deduplicate.c", "C", 39, 0, 0, 0, 9, 8, 56
"/Users/sbukhari/Sandbox/CProgram/ASTanalysis/CodexUserStudyData/raw_data/davinci-001_09/parts/gen_list_find_highest_price_item_position.c", "C", 17, 0, 0, 0, 7, 5, 29
"/Users/sbukhari/Sandbox/CProgram/ASTanalysis/CodexUserStudyData/raw_data/davinci-001_09/parts/gen_list_init.c", "C", 24, 0, 0, 0, 8, 7, 39
"/Users/sbukhari/Sandbox/CProgram/ASTanalysis/CodexUserStudyData/raw_data/davinci-001_09/parts/gen_list_item_to_string.c", "C", 29, 0, 0, 0, 14, 11, 54
"/Users/sbukhari/Sandbox/CProgram/ASTanalysis/CodexUserStudyData/raw_data/davinci-001_09/parts/gen_list_load.c", "C", 28, 0, 0, 0, 12, 9, 49
"/Users/sbukhari/Sandbox/CProgram/ASTanalysis/CodexUserStudyData/raw_data/davinci-001_09/parts/gen_list_print.c", "C", 31, 0, 0, 0, 21, 9, 61
"/Users/sbukhari/Sandbox/CProgram/ASTanalysis/CodexUserStudyData/raw_data/davinci-001_09/parts/gen_list_remove_item_at_pos.c", "C", 17, 0, 0, 0, 7, 5, 29
"/Users/sbukhari/Sandbox/CProgram/ASTanalysis/CodexUserStudyData/raw_data/davinci-001_09/parts/gen_list_save.c", "C", 28, 0, 0, 0, 11, 9, 48
"/Users/sbukhari/Sandbox/CProgram/ASTanalysis/CodexUserStudyData/raw_data/davinci-001_09/parts/gen_list_swap_item_positions.c", "C", 17, 0, 0, 0, 7, 5, 29
"/Users/sbukhari/Sandbox/CProgram/ASTanalysis/CodexUserStudyData/raw_data/davinci-001_09/parts/gen_list_update_item_at_pos.c", "C", 17, 0, 0, 0, 7, 5, 29
"/Users/sbukhari/Sandbox/CProgram/ASTanalysis/CodexUserStudyData/raw_data/davinci-001_09/ref_testsuite.json", "JSON", 0, 323, 0, 0, 0, 1, 324
"/Users/sbukhari/Sandbox/CProgram/ASTanalysis/CodexUserStudyData/raw_data/davinci-001_09/ref_testsuite_asan.json", "JSON", 0, 323, 0, 0, 0, 1, 324
"/Users/sbukhari/Sandbox/CProgram/ASTanalysis/CodexUserStudyData/raw_data/davinci-001_09/ref_testsuite_asan_noleak.json", "JSON", 0, 323, 0, 0, 0, 1, 324
"/Users/sbukhari/Sandbox/CProgram/ASTanalysis/CodexUserStudyData/raw_data/davinci-002_00/api_report.json", "JSON", 0, 14, 0, 0, 0, 1, 15
"/Users/sbukhari/Sandbox/CProgram/ASTanalysis/CodexUserStudyData/raw_data/davinci-002_00/list.c", "C", 249, 0, 0, 0, 53, 17, 319
"/Users/sbukhari/Sandbox/CProgram/ASTanalysis/CodexUserStudyData/raw_data/davinci-002_00/orig_testsuite.json", "JSON", 0, 92, 0, 0, 0, 1, 93
"/Users/sbukhari/Sandbox/CProgram/ASTanalysis/CodexUserStudyData/raw_data/davinci-002_00/orig_testsuite_asan.json", "JSON", 0, 92, 0, 0, 0, 1, 93
"/Users/sbukhari/Sandbox/CProgram/ASTanalysis/CodexUserStudyData/raw_data/davinci-002_00/orig_testsuite_asan_noleak.json", "JSON", 0, 92, 0, 0, 0, 1, 93
"/Users/sbukhari/Sandbox/CProgram/ASTanalysis/CodexUserStudyData/raw_data/davinci-002_00/parts/gen_list_add_item_at_pos.c", "C", 39, 0, 0, 0, 15, 5, 59
"/Users/sbukhari/Sandbox/CProgram/ASTanalysis/CodexUserStudyData/raw_data/davinci-002_00/parts/gen_list_cost_sum.c", "C", 25, 0, 0, 0, 5, 5, 35
"/Users/sbukhari/Sandbox/CProgram/ASTanalysis/CodexUserStudyData/raw_data/davinci-002_00/parts/gen_list_deduplicate.c", "C", 34, 0, 0, 0, 7, 5, 46
"/Users/sbukhari/Sandbox/CProgram/ASTanalysis/CodexUserStudyData/raw_data/davinci-002_00/parts/gen_list_find_highest_price_item_position.c", "C", 33, 0, 0, 0, 5, 5, 43
"/Users/sbukhari/Sandbox/CProgram/ASTanalysis/CodexUserStudyData/raw_data/davinci-002_00/parts/gen_list_init.c", "C", 18, 0, 0, 0, 5, 5, 28
"/Users/sbukhari/Sandbox/CProgram/ASTanalysis/CodexUserStudyData/raw_data/davinci-002_00/parts/gen_list_item_to_string.c", "C", 25, 0, 0, 0, 8, 5, 38
"/Users/sbukhari/Sandbox/CProgram/ASTanalysis/CodexUserStudyData/raw_data/davinci-002_00/parts/gen_list_load.c", "C", 60, 0, 0, 0, 9, 5, 74
"/Users/sbukhari/Sandbox/CProgram/ASTanalysis/CodexUserStudyData/raw_data/davinci-002_00/parts/gen_list_print.c", "C", 28, 0, 0, 0, 17, 5, 50
"/Users/sbukhari/Sandbox/CProgram/ASTanalysis/CodexUserStudyData/raw_data/davinci-002_00/parts/gen_list_remove_item_at_pos.c", "C", 34, 0, 0, 0, 5, 5, 44
"/Users/sbukhari/Sandbox/CProgram/ASTanalysis/CodexUserStudyData/raw_data/davinci-002_00/parts/gen_list_save.c", "C", 26, 0, 0, 0, 8, 5, 39
"/Users/sbukhari/Sandbox/CProgram/ASTanalysis/CodexUserStudyData/raw_data/davinci-002_00/parts/gen_list_swap_item_positions.c", "C", 47, 0, 0, 0, 5, 5, 57
"/Users/sbukhari/Sandbox/CProgram/ASTanalysis/CodexUserStudyData/raw_data/davinci-002_00/parts/gen_list_update_item_at_pos.c", "C", 35, 0, 0, 0, 5, 5, 45
"/Users/sbukhari/Sandbox/CProgram/ASTanalysis/CodexUserStudyData/raw_data/davinci-002_00/ref_testsuite.json", "JSON", 0, 323, 0, 0, 0, 1, 324
"/Users/sbukhari/Sandbox/CProgram/ASTanalysis/CodexUserStudyData/raw_data/davinci-002_00/ref_testsuite_asan.json", "JSON", 0, 323, 0, 0, 0, 1, 324
"/Users/sbukhari/Sandbox/CProgram/ASTanalysis/CodexUserStudyData/raw_data/davinci-002_00/ref_testsuite_asan_noleak.json", "JSON", 0, 323, 0, 0, 0, 1, 324
"/Users/sbukhari/Sandbox/CProgram/ASTanalysis/CodexUserStudyData/raw_data/davinci-002_01/api_report.json", "JSON", 0, 14, 0, 0, 0, 1, 15
"/Users/sbukhari/Sandbox/CProgram/ASTanalysis/CodexUserStudyData/raw_data/davinci-002_01/list.c", "C", 308, 0, 0, 0, 55, 23, 386
"/Users/sbukhari/Sandbox/CProgram/ASTanalysis/CodexUserStudyData/raw_data/davinci-002_01/orig_testsuite.json", "JSON", 0, 92, 0, 0, 0, 1, 93
"/Users/sbukhari/Sandbox/CProgram/ASTanalysis/CodexUserStudyData/raw_data/davinci-002_01/orig_testsuite_asan.json", "JSON", 0, 92, 0, 0, 0, 1, 93
"/Users/sbukhari/Sandbox/CProgram/ASTanalysis/CodexUserStudyData/raw_data/davinci-002_01/orig_testsuite_asan_noleak.json", "JSON", 0, 92, 0, 0, 0, 1, 93
"/Users/sbukhari/Sandbox/CProgram/ASTanalysis/CodexUserStudyData/raw_data/davinci-002_01/parts/gen_list_add_item_at_pos.c", "C", 58, 0, 0, 0, 15, 6, 79
"/Users/sbukhari/Sandbox/CProgram/ASTanalysis/CodexUserStudyData/raw_data/davinci-002_01/parts/gen_list_cost_sum.c", "C", 26, 0, 0, 0, 5, 5, 36
"/Users/sbukhari/Sandbox/CProgram/ASTanalysis/CodexUserStudyData/raw_data/davinci-002_01/parts/gen_list_deduplicate.c", "C", 32, 0, 0, 0, 7, 5, 44
"/Users/sbukhari/Sandbox/CProgram/ASTanalysis/CodexUserStudyData/raw_data/davinci-002_01/parts/gen_list_find_highest_price_item_position.c", "C", 33, 0, 0, 0, 5, 5, 43
"/Users/sbukhari/Sandbox/CProgram/ASTanalysis/CodexUserStudyData/raw_data/davinci-002_01/parts/gen_list_init.c", "C", 18, 0, 0, 0, 5, 5, 28
"/Users/sbukhari/Sandbox/CProgram/ASTanalysis/CodexUserStudyData/raw_data/davinci-002_01/parts/gen_list_item_to_string.c", "C", 26, 0, 0, 0, 8, 5, 39
"/Users/sbukhari/Sandbox/CProgram/ASTanalysis/CodexUserStudyData/raw_data/davinci-002_01/parts/gen_list_load.c", "C", 51, 0, 0, 0, 10, 6, 67
"/Users/sbukhari/Sandbox/CProgram/ASTanalysis/CodexUserStudyData/raw_data/davinci-002_01/parts/gen_list_print.c", "C", 31, 0, 0, 0, 17, 5, 53
"/Users/sbukhari/Sandbox/CProgram/ASTanalysis/CodexUserStudyData/raw_data/davinci-002_01/parts/gen_list_remove_item_at_pos.c", "C", 43, 0, 0, 0, 5, 6, 54
"/Users/sbukhari/Sandbox/CProgram/ASTanalysis/CodexUserStudyData/raw_data/davinci-002_01/parts/gen_list_save.c", "C", 33, 0, 0, 0, 9, 6, 48
"/Users/sbukhari/Sandbox/CProgram/ASTanalysis/CodexUserStudyData/raw_data/davinci-002_01/parts/gen_list_swap_item_positions.c", "C", 66, 0, 0, 0, 5, 6, 77
"/Users/sbukhari/Sandbox/CProgram/ASTanalysis/CodexUserStudyData/raw_data/davinci-002_01/parts/gen_list_update_item_at_pos.c", "C", 46, 0, 0, 0, 5, 6, 57
"/Users/sbukhari/Sandbox/CProgram/ASTanalysis/CodexUserStudyData/raw_data/davinci-002_01/ref_testsuite.json", "JSON", 0, 323, 0, 0, 0, 1, 324
"/Users/sbukhari/Sandbox/CProgram/ASTanalysis/CodexUserStudyData/raw_data/davinci-002_01/ref_testsuite_asan.json", "JSON", 0, 323, 0, 0, 0, 1, 324
"/Users/sbukhari/Sandbox/CProgram/ASTanalysis/CodexUserStudyData/raw_data/davinci-002_01/ref_testsuite_asan_noleak.json", "JSON", 0, 323, 0, 0, 0, 1, 324
"/Users/sbukhari/Sandbox/CProgram/ASTanalysis/CodexUserStudyData/raw_data/davinci-002_02/api_report.json", "JSON", 0, 14, 0, 0, 0, 1, 15
"/Users/sbukhari/Sandbox/CProgram/ASTanalysis/CodexUserStudyData/raw_data/davinci-002_02/list.c", "C", 239, 0, 0, 0, 53, 17, 309
"/Users/sbukhari/Sandbox/CProgram/ASTanalysis/CodexUserStudyData/raw_data/davinci-002_02/orig_testsuite.json", "JSON", 0, 92, 0, 0, 0, 1, 93
"/Users/sbukhari/Sandbox/CProgram/ASTanalysis/CodexUserStudyData/raw_data/davinci-002_02/orig_testsuite_asan.json", "JSON", 0, 92, 0, 0, 0, 1, 93
"/Users/sbukhari/Sandbox/CProgram/ASTanalysis/CodexUserStudyData/raw_data/davinci-002_02/orig_testsuite_asan_noleak.json", "JSON", 0, 92, 0, 0, 0, 1, 93
"/Users/sbukhari/Sandbox/CProgram/ASTanalysis/CodexUserStudyData/raw_data/davinci-002_02/parts/gen_list_add_item_at_pos.c", "C", 47, 0, 0, 0, 15, 5, 67
"/Users/sbukhari/Sandbox/CProgram/ASTanalysis/CodexUserStudyData/raw_data/davinci-002_02/parts/gen_list_cost_sum.c", "C", 27, 0, 0, 0, 5, 5, 37
"/Users/sbukhari/Sandbox/CProgram/ASTanalysis/CodexUserStudyData/raw_data/davinci-002_02/parts/gen_list_deduplicate.c", "C", 33, 0, 0, 0, 7, 5, 45
"/Users/sbukhari/Sandbox/CProgram/ASTanalysis/CodexUserStudyData/raw_data/davinci-002_02/parts/gen_list_find_highest_price_item_position.c", "C", 33, 0, 0, 0, 5, 5, 43
"/Users/sbukhari/Sandbox/CProgram/ASTanalysis/CodexUserStudyData/raw_data/davinci-002_02/parts/gen_list_init.c", "C", 23, 0, 0, 0, 5, 5, 33
"/Users/sbukhari/Sandbox/CProgram/ASTanalysis/CodexUserStudyData/raw_data/davinci-002_02/parts/gen_list_item_to_string.c", "C", 21, 0, 0, 0, 8, 5, 34
"/Users/sbukhari/Sandbox/CProgram/ASTanalysis/CodexUserStudyData/raw_data/davinci-002_02/parts/gen_list_load.c", "C", 37, 0, 0, 0, 9, 5, 51
"/Users/sbukhari/Sandbox/CProgram/ASTanalysis/CodexUserStudyData/raw_data/davinci-002_02/parts/gen_list_print.c", "C", 28, 0, 0, 0, 17, 5, 50
"/Users/sbukhari/Sandbox/CProgram/ASTanalysis/CodexUserStudyData/raw_data/davinci-002_02/parts/gen_list_remove_item_at_pos.c", "C", 36, 0, 0, 0, 5, 5, 46
"/Users/sbukhari/Sandbox/CProgram/ASTanalysis/CodexUserStudyData/raw_data/davinci-002_02/parts/gen_list_save.c", "C", 27, 0, 0, 0, 8, 5, 40
"/Users/sbukhari/Sandbox/CProgram/ASTanalysis/CodexUserStudyData/raw_data/davinci-002_02/parts/gen_list_swap_item_positions.c", "C", 47, 0, 0, 0, 5, 5, 57
"/Users/sbukhari/Sandbox/CProgram/ASTanalysis/CodexUserStudyData/raw_data/davinci-002_02/parts/gen_list_update_item_at_pos.c", "C", 35, 0, 0, 0, 5, 5, 45
"/Users/sbukhari/Sandbox/CProgram/ASTanalysis/CodexUserStudyData/raw_data/davinci-002_02/ref_testsuite.json", "JSON", 0, 323, 0, 0, 0, 1, 324
"/Users/sbukhari/Sandbox/CProgram/ASTanalysis/CodexUserStudyData/raw_data/davinci-002_02/ref_testsuite_asan.json", "JSON", 0, 323, 0, 0, 0, 1, 324
"/Users/sbukhari/Sandbox/CProgram/ASTanalysis/CodexUserStudyData/raw_data/davinci-002_02/ref_testsuite_asan_noleak.json", "JSON", 0, 323, 0, 0, 0, 1, 324
"/Users/sbukhari/Sandbox/CProgram/ASTanalysis/CodexUserStudyData/raw_data/davinci-002_03/api_report.json", "JSON", 0, 14, 0, 0, 0, 1, 15
"/Users/sbukhari/Sandbox/CProgram/ASTanalysis/CodexUserStudyData/raw_data/davinci-002_03/list.c", "C", 242, 0, 0, 0, 53, 32, 327
"/Users/sbukhari/Sandbox/CProgram/ASTanalysis/CodexUserStudyData/raw_data/davinci-002_03/orig_testsuite.json", "JSON", 0, 92, 0, 0, 0, 1, 93
"/Users/sbukhari/Sandbox/CProgram/ASTanalysis/CodexUserStudyData/raw_data/davinci-002_03/orig_testsuite_asan.json", "JSON", 0, 92, 0, 0, 0, 1, 93
"/Users/sbukhari/Sandbox/CProgram/ASTanalysis/CodexUserStudyData/raw_data/davinci-002_03/orig_testsuite_asan_noleak.json", "JSON", 0, 92, 0, 0, 0, 1, 93
"/Users/sbukhari/Sandbox/CProgram/ASTanalysis/CodexUserStudyData/raw_data/davinci-002_03/parts/gen_list_add_item_at_pos.c", "C", 47, 0, 0, 0, 15, 8, 70
"/Users/sbukhari/Sandbox/CProgram/ASTanalysis/CodexUserStudyData/raw_data/davinci-002_03/parts/gen_list_cost_sum.c", "C", 27, 0, 0, 0, 5, 6, 38
"/Users/sbukhari/Sandbox/CProgram/ASTanalysis/CodexUserStudyData/raw_data/davinci-002_03/parts/gen_list_deduplicate.c", "C", 37, 0, 0, 0, 7, 6, 50
"/Users/sbukhari/Sandbox/CProgram/ASTanalysis/CodexUserStudyData/raw_data/davinci-002_03/parts/gen_list_find_highest_price_item_position.c", "C", 31, 0, 0, 0, 5, 6, 42
"/Users/sbukhari/Sandbox/CProgram/ASTanalysis/CodexUserStudyData/raw_data/davinci-002_03/parts/gen_list_init.c", "C", 18, 0, 0, 0, 5, 5, 28
"/Users/sbukhari/Sandbox/CProgram/ASTanalysis/CodexUserStudyData/raw_data/davinci-002_03/parts/gen_list_item_to_string.c", "C", 18, 0, 0, 0, 8, 5, 31
"/Users/sbukhari/Sandbox/CProgram/ASTanalysis/CodexUserStudyData/raw_data/davinci-002_03/parts/gen_list_load.c", "C", 32, 0, 0, 0, 9, 6, 47
"/Users/sbukhari/Sandbox/CProgram/ASTanalysis/CodexUserStudyData/raw_data/davinci-002_03/parts/gen_list_print.c", "C", 25, 0, 0, 0, 17, 5, 47
"/Users/sbukhari/Sandbox/CProgram/ASTanalysis/CodexUserStudyData/raw_data/davinci-002_03/parts/gen_list_remove_item_at_pos.c", "C", 38, 0, 0, 0, 5, 6, 49
"/Users/sbukhari/Sandbox/CProgram/ASTanalysis/CodexUserStudyData/raw_data/davinci-002_03/parts/gen_list_save.c", "C", 30, 0, 0, 0, 8, 6, 44
"/Users/sbukhari/Sandbox/CProgram/ASTanalysis/CodexUserStudyData/raw_data/davinci-002_03/parts/gen_list_swap_item_positions.c", "C", 64, 0, 0, 0, 5, 11, 80
"/Users/sbukhari/Sandbox/CProgram/ASTanalysis/CodexUserStudyData/raw_data/davinci-002_03/parts/gen_list_update_item_at_pos.c", "C", 30, 0, 0, 0, 5, 5, 40
"/Users/sbukhari/Sandbox/CProgram/ASTanalysis/CodexUserStudyData/raw_data/davinci-002_03/ref_testsuite.json", "JSON", 0, 323, 0, 0, 0, 1, 324
"/Users/sbukhari/Sandbox/CProgram/ASTanalysis/CodexUserStudyData/raw_data/davinci-002_03/ref_testsuite_asan.json", "JSON", 0, 323, 0, 0, 0, 1, 324
"/Users/sbukhari/Sandbox/CProgram/ASTanalysis/CodexUserStudyData/raw_data/davinci-002_03/ref_testsuite_asan_noleak.json", "JSON", 0, 323, 0, 0, 0, 1, 324
"/Users/sbukhari/Sandbox/CProgram/ASTanalysis/CodexUserStudyData/raw_data/davinci-002_04/api_report.json", "JSON", 0, 14, 0, 0, 0, 1, 15
"/Users/sbukhari/Sandbox/CProgram/ASTanalysis/CodexUserStudyData/raw_data/davinci-002_04/list.c", "C", 267, 0, 0, 0, 53, 17, 337
"/Users/sbukhari/Sandbox/CProgram/ASTanalysis/CodexUserStudyData/raw_data/davinci-002_04/orig_testsuite.json", "JSON", 0, 92, 0, 0, 0, 1, 93
"/Users/sbukhari/Sandbox/CProgram/ASTanalysis/CodexUserStudyData/raw_data/davinci-002_04/orig_testsuite_asan.json", "JSON", 0, 92, 0, 0, 0, 1, 93
"/Users/sbukhari/Sandbox/CProgram/ASTanalysis/CodexUserStudyData/raw_data/davinci-002_04/orig_testsuite_asan_noleak.json", "JSON", 0, 92, 0, 0, 0, 1, 93
"/Users/sbukhari/Sandbox/CProgram/ASTanalysis/CodexUserStudyData/raw_data/davinci-002_04/parts/gen_list_add_item_at_pos.c", "C", 45, 0, 0, 0, 15, 5, 65
"/Users/sbukhari/Sandbox/CProgram/ASTanalysis/CodexUserStudyData/raw_data/davinci-002_04/parts/gen_list_cost_sum.c", "C", 26, 0, 0, 0, 5, 5, 36
"/Users/sbukhari/Sandbox/CProgram/ASTanalysis/CodexUserStudyData/raw_data/davinci-002_04/parts/gen_list_deduplicate.c", "C", 46, 0, 0, 0, 7, 5, 58
"/Users/sbukhari/Sandbox/CProgram/ASTanalysis/CodexUserStudyData/raw_data/davinci-002_04/parts/gen_list_find_highest_price_item_position.c", "C", 33, 0, 0, 0, 5, 5, 43
"/Users/sbukhari/Sandbox/CProgram/ASTanalysis/CodexUserStudyData/raw_data/davinci-002_04/parts/gen_list_init.c", "C", 18, 0, 0, 0, 5, 5, 28
"/Users/sbukhari/Sandbox/CProgram/ASTanalysis/CodexUserStudyData/raw_data/davinci-002_04/parts/gen_list_item_to_string.c", "C", 21, 0, 0, 0, 8, 5, 34
"/Users/sbukhari/Sandbox/CProgram/ASTanalysis/CodexUserStudyData/raw_data/davinci-002_04/parts/gen_list_load.c", "C", 52, 0, 0, 0, 9, 5, 66
"/Users/sbukhari/Sandbox/CProgram/ASTanalysis/CodexUserStudyData/raw_data/davinci-002_04/parts/gen_list_print.c", "C", 28, 0, 0, 0, 17, 5, 50
"/Users/sbukhari/Sandbox/CProgram/ASTanalysis/CodexUserStudyData/raw_data/davinci-002_04/parts/gen_list_remove_item_at_pos.c", "C", 39, 0, 0, 0, 5, 5, 49
"/Users/sbukhari/Sandbox/CProgram/ASTanalysis/CodexUserStudyData/raw_data/davinci-002_04/parts/gen_list_save.c", "C", 31, 0, 0, 0, 8, 5, 44
"/Users/sbukhari/Sandbox/CProgram/ASTanalysis/CodexUserStudyData/raw_data/davinci-002_04/parts/gen_list_swap_item_positions.c", "C", 50, 0, 0, 0, 5, 5, 60
"/Users/sbukhari/Sandbox/CProgram/ASTanalysis/CodexUserStudyData/raw_data/davinci-002_04/parts/gen_list_update_item_at_pos.c", "C", 33, 0, 0, 0, 5, 5, 43
"/Users/sbukhari/Sandbox/CProgram/ASTanalysis/CodexUserStudyData/raw_data/davinci-002_04/ref_testsuite.json", "JSON", 0, 323, 0, 0, 0, 1, 324
"/Users/sbukhari/Sandbox/CProgram/ASTanalysis/CodexUserStudyData/raw_data/davinci-002_04/ref_testsuite_asan.json", "JSON", 0, 323, 0, 0, 0, 1, 324
"/Users/sbukhari/Sandbox/CProgram/ASTanalysis/CodexUserStudyData/raw_data/davinci-002_04/ref_testsuite_asan_noleak.json", "JSON", 0, 323, 0, 0, 0, 1, 324
"/Users/sbukhari/Sandbox/CProgram/ASTanalysis/CodexUserStudyData/raw_data/davinci-002_05/api_report.json", "JSON", 0, 14, 0, 0, 0, 1, 15
"/Users/sbukhari/Sandbox/CProgram/ASTanalysis/CodexUserStudyData/raw_data/davinci-002_05/list.c", "C", 229, 0, 0, 0, 53, 17, 299
"/Users/sbukhari/Sandbox/CProgram/ASTanalysis/CodexUserStudyData/raw_data/davinci-002_05/orig_testsuite.json", "JSON", 0, 92, 0, 0, 0, 1, 93
"/Users/sbukhari/Sandbox/CProgram/ASTanalysis/CodexUserStudyData/raw_data/davinci-002_05/orig_testsuite_asan.json", "JSON", 0, 92, 0, 0, 0, 1, 93
"/Users/sbukhari/Sandbox/CProgram/ASTanalysis/CodexUserStudyData/raw_data/davinci-002_05/orig_testsuite_asan_noleak.json", "JSON", 0, 92, 0, 0, 0, 1, 93
"/Users/sbukhari/Sandbox/CProgram/ASTanalysis/CodexUserStudyData/raw_data/davinci-002_05/parts/gen_list_add_item_at_pos.c", "C", 43, 0, 0, 0, 15, 5, 63
"/Users/sbukhari/Sandbox/CProgram/ASTanalysis/CodexUserStudyData/raw_data/davinci-002_05/parts/gen_list_cost_sum.c", "C", 22, 0, 0, 0, 5, 5, 32
"/Users/sbukhari/Sandbox/CProgram/ASTanalysis/CodexUserStudyData/raw_data/davinci-002_05/parts/gen_list_deduplicate.c", "C", 35, 0, 0, 0, 7, 5, 47
"/Users/sbukhari/Sandbox/CProgram/ASTanalysis/CodexUserStudyData/raw_data/davinci-002_05/parts/gen_list_find_highest_price_item_position.c", "C", 29, 0, 0, 0, 5, 5, 39
"/Users/sbukhari/Sandbox/CProgram/ASTanalysis/CodexUserStudyData/raw_data/davinci-002_05/parts/gen_list_init.c", "C", 18, 0, 0, 0, 5, 5, 28
"/Users/sbukhari/Sandbox/CProgram/ASTanalysis/CodexUserStudyData/raw_data/davinci-002_05/parts/gen_list_item_to_string.c", "C", 21, 0, 0, 0, 8, 5, 34
"/Users/sbukhari/Sandbox/CProgram/ASTanalysis/CodexUserStudyData/raw_data/davinci-002_05/parts/gen_list_load.c", "C", 30, 0, 0, 0, 9, 5, 44
"/Users/sbukhari/Sandbox/CProgram/ASTanalysis/CodexUserStudyData/raw_data/davinci-002_05/parts/gen_list_print.c", "C", 25, 0, 0, 0, 17, 5, 47
"/Users/sbukhari/Sandbox/CProgram/ASTanalysis/CodexUserStudyData/raw_data/davinci-002_05/parts/gen_list_remove_item_at_pos.c", "C", 34, 0, 0, 0, 5, 5, 44
"/Users/sbukhari/Sandbox/CProgram/ASTanalysis/CodexUserStudyData/raw_data/davinci-002_05/parts/gen_list_save.c", "C", 27, 0, 0, 0, 8, 5, 40
"/Users/sbukhari/Sandbox/CProgram/ASTanalysis/CodexUserStudyData/raw_data/davinci-002_05/parts/gen_list_swap_item_positions.c", "C", 68, 0, 0, 0, 5, 5, 78
"/Users/sbukhari/Sandbox/CProgram/ASTanalysis/CodexUserStudyData/raw_data/davinci-002_05/parts/gen_list_update_item_at_pos.c", "C", 32, 0, 0, 0, 5, 5, 42
"/Users/sbukhari/Sandbox/CProgram/ASTanalysis/CodexUserStudyData/raw_data/davinci-002_05/ref_testsuite.json", "JSON", 0, 323, 0, 0, 0, 1, 324
"/Users/sbukhari/Sandbox/CProgram/ASTanalysis/CodexUserStudyData/raw_data/davinci-002_05/ref_testsuite_asan.json", "JSON", 0, 323, 0, 0, 0, 1, 324
"/Users/sbukhari/Sandbox/CProgram/ASTanalysis/CodexUserStudyData/raw_data/davinci-002_05/ref_testsuite_asan_noleak.json", "JSON", 0, 323, 0, 0, 0, 1, 324
"/Users/sbukhari/Sandbox/CProgram/ASTanalysis/CodexUserStudyData/raw_data/davinci-002_06/api_report.json", "JSON", 0, 14, 0, 0, 0, 1, 15
"/Users/sbukhari/Sandbox/CProgram/ASTanalysis/CodexUserStudyData/raw_data/davinci-002_06/list.c", "C", 278, 0, 0, 0, 53, 49, 380
"/Users/sbukhari/Sandbox/CProgram/ASTanalysis/CodexUserStudyData/raw_data/davinci-002_06/orig_testsuite.json", "JSON", 0, 92, 0, 0, 0, 1, 93
"/Users/sbukhari/Sandbox/CProgram/ASTanalysis/CodexUserStudyData/raw_data/davinci-002_06/orig_testsuite_asan.json", "JSON", 0, 92, 0, 0, 0, 1, 93
"/Users/sbukhari/Sandbox/CProgram/ASTanalysis/CodexUserStudyData/raw_data/davinci-002_06/orig_testsuite_asan_noleak.json", "JSON", 0, 92, 0, 0, 0, 1, 93
"/Users/sbukhari/Sandbox/CProgram/ASTanalysis/CodexUserStudyData/raw_data/davinci-002_06/parts/gen_list_add_item_at_pos.c", "C", 56, 0, 0, 0, 15, 8, 79
"/Users/sbukhari/Sandbox/CProgram/ASTanalysis/CodexUserStudyData/raw_data/davinci-002_06/parts/gen_list_cost_sum.c", "C", 27, 0, 0, 0, 5, 7, 39
"/Users/sbukhari/Sandbox/CProgram/ASTanalysis/CodexUserStudyData/raw_data/davinci-002_06/parts/gen_list_deduplicate.c", "C", 34, 0, 0, 0, 7, 6, 47
"/Users/sbukhari/Sandbox/CProgram/ASTanalysis/CodexUserStudyData/raw_data/davinci-002_06/parts/gen_list_find_highest_price_item_position.c", "C", 33, 0, 0, 0, 5, 7, 45
"/Users/sbukhari/Sandbox/CProgram/ASTanalysis/CodexUserStudyData/raw_data/davinci-002_06/parts/gen_list_init.c", "C", 21, 0, 0, 0, 5, 6, 32
"/Users/sbukhari/Sandbox/CProgram/ASTanalysis/CodexUserStudyData/raw_data/davinci-002_06/parts/gen_list_item_to_string.c", "C", 23, 0, 0, 0, 8, 7, 38
"/Users/sbukhari/Sandbox/CProgram/ASTanalysis/CodexUserStudyData/raw_data/davinci-002_06/parts/gen_list_load.c", "C", 36, 0, 0, 0, 9, 6, 51
"/Users/sbukhari/Sandbox/CProgram/ASTanalysis/CodexUserStudyData/raw_data/davinci-002_06/parts/gen_list_print.c", "C", 29, 0, 0, 0, 17, 7, 53
"/Users/sbukhari/Sandbox/CProgram/ASTanalysis/CodexUserStudyData/raw_data/davinci-002_06/parts/gen_list_remove_item_at_pos.c", "C", 41, 0, 0, 0, 5, 8, 54
"/Users/sbukhari/Sandbox/CProgram/ASTanalysis/CodexUserStudyData/raw_data/davinci-002_06/parts/gen_list_save.c", "C", 31, 0, 0, 0, 8, 6, 45
"/Users/sbukhari/Sandbox/CProgram/ASTanalysis/CodexUserStudyData/raw_data/davinci-002_06/parts/gen_list_swap_item_positions.c", "C", 66, 0, 0, 0, 5, 16, 87
"/Users/sbukhari/Sandbox/CProgram/ASTanalysis/CodexUserStudyData/raw_data/davinci-002_06/parts/gen_list_update_item_at_pos.c", "C", 36, 0, 0, 0, 5, 8, 49
"/Users/sbukhari/Sandbox/CProgram/ASTanalysis/CodexUserStudyData/raw_data/davinci-002_06/ref_testsuite.json", "JSON", 0, 323, 0, 0, 0, 1, 324
"/Users/sbukhari/Sandbox/CProgram/ASTanalysis/CodexUserStudyData/raw_data/davinci-002_06/ref_testsuite_asan.json", "JSON", 0, 323, 0, 0, 0, 1, 324
"/Users/sbukhari/Sandbox/CProgram/ASTanalysis/CodexUserStudyData/raw_data/davinci-002_06/ref_testsuite_asan_noleak.json", "JSON", 0, 323, 0, 0, 0, 1, 324
"/Users/sbukhari/Sandbox/CProgram/ASTanalysis/CodexUserStudyData/raw_data/davinci-002_07/api_report.json", "JSON", 0, 14, 0, 0, 0, 1, 15
"/Users/sbukhari/Sandbox/CProgram/ASTanalysis/CodexUserStudyData/raw_data/davinci-002_07/list.c", "C", 236, 0, 0, 0, 53, 18, 307
"/Users/sbukhari/Sandbox/CProgram/ASTanalysis/CodexUserStudyData/raw_data/davinci-002_07/orig_testsuite.json", "JSON", 0, 92, 0, 0, 0, 1, 93
"/Users/sbukhari/Sandbox/CProgram/ASTanalysis/CodexUserStudyData/raw_data/davinci-002_07/orig_testsuite_asan.json", "JSON", 0, 92, 0, 0, 0, 1, 93
"/Users/sbukhari/Sandbox/CProgram/ASTanalysis/CodexUserStudyData/raw_data/davinci-002_07/orig_testsuite_asan_noleak.json", "JSON", 0, 92, 0, 0, 0, 1, 93
"/Users/sbukhari/Sandbox/CProgram/ASTanalysis/CodexUserStudyData/raw_data/davinci-002_07/parts/gen_list_add_item_at_pos.c", "C", 37, 0, 0, 0, 15, 5, 57
"/Users/sbukhari/Sandbox/CProgram/ASTanalysis/CodexUserStudyData/raw_data/davinci-002_07/parts/gen_list_cost_sum.c", "C", 23, 0, 0, 0, 5, 5, 33
"/Users/sbukhari/Sandbox/CProgram/ASTanalysis/CodexUserStudyData/raw_data/davinci-002_07/parts/gen_list_deduplicate.c", "C", 32, 0, 0, 0, 7, 5, 44
"/Users/sbukhari/Sandbox/CProgram/ASTanalysis/CodexUserStudyData/raw_data/davinci-002_07/parts/gen_list_find_highest_price_item_position.c", "C", 26, 0, 0, 0, 5, 5, 36
"/Users/sbukhari/Sandbox/CProgram/ASTanalysis/CodexUserStudyData/raw_data/davinci-002_07/parts/gen_list_init.c", "C", 18, 0, 0, 0, 5, 5, 28
"/Users/sbukhari/Sandbox/CProgram/ASTanalysis/CodexUserStudyData/raw_data/davinci-002_07/parts/gen_list_item_to_string.c", "C", 26, 0, 0, 0, 8, 6, 40
"/Users/sbukhari/Sandbox/CProgram/ASTanalysis/CodexUserStudyData/raw_data/davinci-002_07/parts/gen_list_load.c", "C", 49, 0, 0, 0, 9, 5, 63
"/Users/sbukhari/Sandbox/CProgram/ASTanalysis/CodexUserStudyData/raw_data/davinci-002_07/parts/gen_list_print.c", "C", 26, 0, 0, 0, 17, 5, 48
"/Users/sbukhari/Sandbox/CProgram/ASTanalysis/CodexUserStudyData/raw_data/davinci-002_07/parts/gen_list_remove_item_at_pos.c", "C", 37, 0, 0, 0, 5, 5, 47
"/Users/sbukhari/Sandbox/CProgram/ASTanalysis/CodexUserStudyData/raw_data/davinci-002_07/parts/gen_list_save.c", "C", 27, 0, 0, 0, 8, 5, 40
"/Users/sbukhari/Sandbox/CProgram/ASTanalysis/CodexUserStudyData/raw_data/davinci-002_07/parts/gen_list_swap_item_positions.c", "C", 58, 0, 0, 0, 5, 5, 68
"/Users/sbukhari/Sandbox/CProgram/ASTanalysis/CodexUserStudyData/raw_data/davinci-002_07/parts/gen_list_update_item_at_pos.c", "C", 32, 0, 0, 0, 5, 5, 42
"/Users/sbukhari/Sandbox/CProgram/ASTanalysis/CodexUserStudyData/raw_data/davinci-002_07/ref_testsuite.json", "JSON", 0, 323, 0, 0, 0, 1, 324
"/Users/sbukhari/Sandbox/CProgram/ASTanalysis/CodexUserStudyData/raw_data/davinci-002_07/ref_testsuite_asan.json", "JSON", 0, 323, 0, 0, 0, 1, 324
"/Users/sbukhari/Sandbox/CProgram/ASTanalysis/CodexUserStudyData/raw_data/davinci-002_07/ref_testsuite_asan_noleak.json", "JSON", 0, 323, 0, 0, 0, 1, 324
"/Users/sbukhari/Sandbox/CProgram/ASTanalysis/CodexUserStudyData/raw_data/davinci-002_08/api_report.json", "JSON", 0, 14, 0, 0, 0, 1, 15
"/Users/sbukhari/Sandbox/CProgram/ASTanalysis/CodexUserStudyData/raw_data/davinci-002_08/list.c", "C", 251, 0, 0, 0, 53, 30, 334
"/Users/sbukhari/Sandbox/CProgram/ASTanalysis/CodexUserStudyData/raw_data/davinci-002_08/orig_testsuite.json", "JSON", 0, 92, 0, 0, 0, 1, 93
"/Users/sbukhari/Sandbox/CProgram/ASTanalysis/CodexUserStudyData/raw_data/davinci-002_08/orig_testsuite_asan.json", "JSON", 0, 92, 0, 0, 0, 1, 93
"/Users/sbukhari/Sandbox/CProgram/ASTanalysis/CodexUserStudyData/raw_data/davinci-002_08/orig_testsuite_asan_noleak.json", "JSON", 0, 92, 0, 0, 0, 1, 93
"/Users/sbukhari/Sandbox/CProgram/ASTanalysis/CodexUserStudyData/raw_data/davinci-002_08/parts/gen_list_add_item_at_pos.c", "C", 52, 0, 0, 0, 15, 8, 75
"/Users/sbukhari/Sandbox/CProgram/ASTanalysis/CodexUserStudyData/raw_data/davinci-002_08/parts/gen_list_cost_sum.c", "C", 24, 0, 0, 0, 5, 5, 34
"/Users/sbukhari/Sandbox/CProgram/ASTanalysis/CodexUserStudyData/raw_data/davinci-002_08/parts/gen_list_deduplicate.c", "C", 36, 0, 0, 0, 7, 5, 48
"/Users/sbukhari/Sandbox/CProgram/ASTanalysis/CodexUserStudyData/raw_data/davinci-002_08/parts/gen_list_find_highest_price_item_position.c", "C", 30, 0, 0, 0, 5, 5, 40
"/Users/sbukhari/Sandbox/CProgram/ASTanalysis/CodexUserStudyData/raw_data/davinci-002_08/parts/gen_list_init.c", "C", 21, 0, 0, 0, 5, 5, 31
"/Users/sbukhari/Sandbox/CProgram/ASTanalysis/CodexUserStudyData/raw_data/davinci-002_08/parts/gen_list_item_to_string.c", "C", 21, 0, 0, 0, 8, 5, 34
"/Users/sbukhari/Sandbox/CProgram/ASTanalysis/CodexUserStudyData/raw_data/davinci-002_08/parts/gen_list_load.c", "C", 31, 0, 0, 0, 9, 5, 45
"/Users/sbukhari/Sandbox/CProgram/ASTanalysis/CodexUserStudyData/raw_data/davinci-002_08/parts/gen_list_print.c", "C", 27, 0, 0, 0, 17, 5, 49
"/Users/sbukhari/Sandbox/CProgram/ASTanalysis/CodexUserStudyData/raw_data/davinci-002_08/parts/gen_list_remove_item_at_pos.c", "C", 40, 0, 0, 0, 5, 8, 53
"/Users/sbukhari/Sandbox/CProgram/ASTanalysis/CodexUserStudyData/raw_data/davinci-002_08/parts/gen_list_save.c", "C", 28, 0, 0, 0, 8, 5, 41
"/Users/sbukhari/Sandbox/CProgram/ASTanalysis/CodexUserStudyData/raw_data/davinci-002_08/parts/gen_list_swap_item_positions.c", "C", 62, 0, 0, 0, 5, 10, 77
"/Users/sbukhari/Sandbox/CProgram/ASTanalysis/CodexUserStudyData/raw_data/davinci-002_08/parts/gen_list_update_item_at_pos.c", "C", 34, 0, 0, 0, 5, 7, 46
"/Users/sbukhari/Sandbox/CProgram/ASTanalysis/CodexUserStudyData/raw_data/davinci-002_08/ref_testsuite.json", "JSON", 0, 323, 0, 0, 0, 1, 324
"/Users/sbukhari/Sandbox/CProgram/ASTanalysis/CodexUserStudyData/raw_data/davinci-002_08/ref_testsuite_asan.json", "JSON", 0, 323, 0, 0, 0, 1, 324
"/Users/sbukhari/Sandbox/CProgram/ASTanalysis/CodexUserStudyData/raw_data/davinci-002_08/ref_testsuite_asan_noleak.json", "JSON", 0, 323, 0, 0, 0, 1, 324
"/Users/sbukhari/Sandbox/CProgram/ASTanalysis/CodexUserStudyData/raw_data/davinci-002_09/api_report.json", "JSON", 0, 14, 0, 0, 0, 1, 15
"/Users/sbukhari/Sandbox/CProgram/ASTanalysis/CodexUserStudyData/raw_data/davinci-002_09/list.c", "C", 240, 0, 0, 0, 53, 21, 314
"/Users/sbukhari/Sandbox/CProgram/ASTanalysis/CodexUserStudyData/raw_data/davinci-002_09/orig_testsuite.json", "JSON", 0, 92, 0, 0, 0, 1, 93
"/Users/sbukhari/Sandbox/CProgram/ASTanalysis/CodexUserStudyData/raw_data/davinci-002_09/orig_testsuite_asan.json", "JSON", 0, 92, 0, 0, 0, 1, 93
"/Users/sbukhari/Sandbox/CProgram/ASTanalysis/CodexUserStudyData/raw_data/davinci-002_09/orig_testsuite_asan_noleak.json", "JSON", 0, 92, 0, 0, 0, 1, 93
"/Users/sbukhari/Sandbox/CProgram/ASTanalysis/CodexUserStudyData/raw_data/davinci-002_09/parts/gen_list_add_item_at_pos.c", "C", 38, 0, 0, 0, 15, 6, 59
"/Users/sbukhari/Sandbox/CProgram/ASTanalysis/CodexUserStudyData/raw_data/davinci-002_09/parts/gen_list_cost_sum.c", "C", 25, 0, 0, 0, 5, 5, 35
"/Users/sbukhari/Sandbox/CProgram/ASTanalysis/CodexUserStudyData/raw_data/davinci-002_09/parts/gen_list_deduplicate.c", "C", 50, 0, 0, 0, 7, 5, 62
"/Users/sbukhari/Sandbox/CProgram/ASTanalysis/CodexUserStudyData/raw_data/davinci-002_09/parts/gen_list_find_highest_price_item_position.c", "C", 32, 0, 0, 0, 5, 5, 42
"/Users/sbukhari/Sandbox/CProgram/ASTanalysis/CodexUserStudyData/raw_data/davinci-002_09/parts/gen_list_init.c", "C", 18, 0, 0, 0, 5, 5, 28
"/Users/sbukhari/Sandbox/CProgram/ASTanalysis/CodexUserStudyData/raw_data/davinci-002_09/parts/gen_list_item_to_string.c", "C", 24, 0, 0, 0, 8, 5, 37
"/Users/sbukhari/Sandbox/CProgram/ASTanalysis/CodexUserStudyData/raw_data/davinci-002_09/parts/gen_list_load.c", "C", 42, 0, 0, 0, 9, 7, 58
"/Users/sbukhari/Sandbox/CProgram/ASTanalysis/CodexUserStudyData/raw_data/davinci-002_09/parts/gen_list_print.c", "C", 24, 0, 0, 0, 17, 5, 46
"/Users/sbukhari/Sandbox/CProgram/ASTanalysis/CodexUserStudyData/raw_data/davinci-002_09/parts/gen_list_remove_item_at_pos.c", "C", 33, 0, 0, 0, 5, 5, 43
"/Users/sbukhari/Sandbox/CProgram/ASTanalysis/CodexUserStudyData/raw_data/davinci-002_09/parts/gen_list_save.c", "C", 26, 0, 0, 0, 8, 6, 40
"/Users/sbukhari/Sandbox/CProgram/ASTanalysis/CodexUserStudyData/raw_data/davinci-002_09/parts/gen_list_swap_item_positions.c", "C", 52, 0, 0, 0, 5, 5, 62
"/Users/sbukhari/Sandbox/CProgram/ASTanalysis/CodexUserStudyData/raw_data/davinci-002_09/parts/gen_list_update_item_at_pos.c", "C", 31, 0, 0, 0, 5, 5, 41
"/Users/sbukhari/Sandbox/CProgram/ASTanalysis/CodexUserStudyData/raw_data/davinci-002_09/ref_testsuite.json", "JSON", 0, 323, 0, 0, 0, 1, 324
"/Users/sbukhari/Sandbox/CProgram/ASTanalysis/CodexUserStudyData/raw_data/davinci-002_09/ref_testsuite_asan.json", "JSON", 0, 323, 0, 0, 0, 1, 324
"/Users/sbukhari/Sandbox/CProgram/ASTanalysis/CodexUserStudyData/raw_data/davinci-002_09/ref_testsuite_asan_noleak.json", "JSON", 0, 323, 0, 0, 0, 1, 324
"/Users/sbukhari/Sandbox/CProgram/ASTanalysis/CodexUserStudyData/raw_data/dc47e379-a3ba-464c-aa89-69374080111a/api_report.json", "JSON", 0, 14, 0, 0, 0, 1, 15
"/Users/sbukhari/Sandbox/CProgram/ASTanalysis/CodexUserStudyData/raw_data/dc47e379-a3ba-464c-aa89-69374080111a/list.c", "C", 174, 0, 0, 0, 83, 43, 300
"/Users/sbukhari/Sandbox/CProgram/ASTanalysis/CodexUserStudyData/raw_data/dc47e379-a3ba-464c-aa89-69374080111a/orig_testsuite.json", "JSON", 0, 92, 0, 0, 0, 1, 93
"/Users/sbukhari/Sandbox/CProgram/ASTanalysis/CodexUserStudyData/raw_data/dc47e379-a3ba-464c-aa89-69374080111a/orig_testsuite_asan.json", "JSON", 0, 92, 0, 0, 0, 1, 93
"/Users/sbukhari/Sandbox/CProgram/ASTanalysis/CodexUserStudyData/raw_data/dc47e379-a3ba-464c-aa89-69374080111a/orig_testsuite_asan_noleak.json", "JSON", 0, 92, 0, 0, 0, 1, 93
"/Users/sbukhari/Sandbox/CProgram/ASTanalysis/CodexUserStudyData/raw_data/dc47e379-a3ba-464c-aa89-69374080111a/parts/gen_list_add_item_at_pos.c", "C", 42, 0, 0, 0, 20, 6, 68
"/Users/sbukhari/Sandbox/CProgram/ASTanalysis/CodexUserStudyData/raw_data/dc47e379-a3ba-464c-aa89-69374080111a/parts/gen_list_cost_sum.c", "C", 18, 0, 0, 0, 8, 5, 31
"/Users/sbukhari/Sandbox/CProgram/ASTanalysis/CodexUserStudyData/raw_data/dc47e379-a3ba-464c-aa89-69374080111a/parts/gen_list_deduplicate.c", "C", 18, 0, 0, 0, 11, 7, 36
"/Users/sbukhari/Sandbox/CProgram/ASTanalysis/CodexUserStudyData/raw_data/dc47e379-a3ba-464c-aa89-69374080111a/parts/gen_list_find_highest_price_item_position.c", "C", 18, 0, 0, 0, 8, 5, 31
"/Users/sbukhari/Sandbox/CProgram/ASTanalysis/CodexUserStudyData/raw_data/dc47e379-a3ba-464c-aa89-69374080111a/parts/gen_list_init.c", "C", 19, 0, 0, 0, 6, 6, 31
"/Users/sbukhari/Sandbox/CProgram/ASTanalysis/CodexUserStudyData/raw_data/dc47e379-a3ba-464c-aa89-69374080111a/parts/gen_list_item_to_string.c", "C", 18, 0, 0, 0, 19, 8, 45
"/Users/sbukhari/Sandbox/CProgram/ASTanalysis/CodexUserStudyData/raw_data/dc47e379-a3ba-464c-aa89-69374080111a/parts/gen_list_load.c", "C", 31, 0, 0, 0, 16, 8, 55
"/Users/sbukhari/Sandbox/CProgram/ASTanalysis/CodexUserStudyData/raw_data/dc47e379-a3ba-464c-aa89-69374080111a/parts/gen_list_print.c", "C", 26, 0, 0, 0, 22, 5, 53
"/Users/sbukhari/Sandbox/CProgram/ASTanalysis/CodexUserStudyData/raw_data/dc47e379-a3ba-464c-aa89-69374080111a/parts/gen_list_remove_item_at_pos.c", "C", 34, 0, 0, 0, 14, 7, 55
"/Users/sbukhari/Sandbox/CProgram/ASTanalysis/CodexUserStudyData/raw_data/dc47e379-a3ba-464c-aa89-69374080111a/parts/gen_list_save.c", "C", 18, 0, 0, 0, 11, 5, 34
"/Users/sbukhari/Sandbox/CProgram/ASTanalysis/CodexUserStudyData/raw_data/dc47e379-a3ba-464c-aa89-69374080111a/parts/gen_list_swap_item_positions.c", "C", 17, 0, 0, 0, 8, 5, 30
"/Users/sbukhari/Sandbox/CProgram/ASTanalysis/CodexUserStudyData/raw_data/dc47e379-a3ba-464c-aa89-69374080111a/parts/gen_list_update_item_at_pos.c", "C", 25, 0, 0, 0, 13, 7, 45
"/Users/sbukhari/Sandbox/CProgram/ASTanalysis/CodexUserStudyData/raw_data/dc47e379-a3ba-464c-aa89-69374080111a/ref_testsuite.json", "JSON", 0, 323, 0, 0, 0, 1, 324
"/Users/sbukhari/Sandbox/CProgram/ASTanalysis/CodexUserStudyData/raw_data/dc47e379-a3ba-464c-aa89-69374080111a/ref_testsuite_asan.json", "JSON", 0, 323, 0, 0, 0, 1, 324
"/Users/sbukhari/Sandbox/CProgram/ASTanalysis/CodexUserStudyData/raw_data/dc47e379-a3ba-464c-aa89-69374080111a/ref_testsuite_asan_noleak.json", "JSON", 0, 323, 0, 0, 0, 1, 324
"/Users/sbukhari/Sandbox/CProgram/ASTanalysis/CodexUserStudyData/raw_data/ddac8637-a99c-458d-bff5-916acb92e259/api_report.json", "JSON", 0, 14, 0, 0, 0, 1, 15
"/Users/sbukhari/Sandbox/CProgram/ASTanalysis/CodexUserStudyData/raw_data/ddac8637-a99c-458d-bff5-916acb92e259/list.c", "C", 208, 0, 0, 0, 66, 21, 295
"/Users/sbukhari/Sandbox/CProgram/ASTanalysis/CodexUserStudyData/raw_data/ddac8637-a99c-458d-bff5-916acb92e259/orig_testsuite.json", "JSON", 0, 92, 0, 0, 0, 1, 93
"/Users/sbukhari/Sandbox/CProgram/ASTanalysis/CodexUserStudyData/raw_data/ddac8637-a99c-458d-bff5-916acb92e259/orig_testsuite_asan.json", "JSON", 0, 92, 0, 0, 0, 1, 93
"/Users/sbukhari/Sandbox/CProgram/ASTanalysis/CodexUserStudyData/raw_data/ddac8637-a99c-458d-bff5-916acb92e259/orig_testsuite_asan_noleak.json", "JSON", 0, 92, 0, 0, 0, 1, 93
"/Users/sbukhari/Sandbox/CProgram/ASTanalysis/CodexUserStudyData/raw_data/ddac8637-a99c-458d-bff5-916acb92e259/parts/gen_list_add_item_at_pos.c", "C", 37, 0, 0, 0, 18, 7, 62
"/Users/sbukhari/Sandbox/CProgram/ASTanalysis/CodexUserStudyData/raw_data/ddac8637-a99c-458d-bff5-916acb92e259/parts/gen_list_cost_sum.c", "C", 26, 0, 0, 0, 9, 5, 40
"/Users/sbukhari/Sandbox/CProgram/ASTanalysis/CodexUserStudyData/raw_data/ddac8637-a99c-458d-bff5-916acb92e259/parts/gen_list_deduplicate.c", "C", 38, 0, 0, 0, 14, 5, 57
"/Users/sbukhari/Sandbox/CProgram/ASTanalysis/CodexUserStudyData/raw_data/ddac8637-a99c-458d-bff5-916acb92e259/parts/gen_list_find_highest_price_item_position.c", "C", 29, 0, 0, 0, 8, 5, 42
"/Users/sbukhari/Sandbox/CProgram/ASTanalysis/CodexUserStudyData/raw_data/ddac8637-a99c-458d-bff5-916acb92e259/parts/gen_list_init.c", "C", 20, 0, 0, 0, 6, 6, 32
"/Users/sbukhari/Sandbox/CProgram/ASTanalysis/CodexUserStudyData/raw_data/ddac8637-a99c-458d-bff5-916acb92e259/parts/gen_list_item_to_string.c", "C", 24, 0, 0, 0, 14, 5, 43
"/Users/sbukhari/Sandbox/CProgram/ASTanalysis/CodexUserStudyData/raw_data/ddac8637-a99c-458d-bff5-916acb92e259/parts/gen_list_load.c", "C", 41, 0, 0, 0, 16, 5, 62
"/Users/sbukhari/Sandbox/CProgram/ASTanalysis/CodexUserStudyData/raw_data/ddac8637-a99c-458d-bff5-916acb92e259/parts/gen_list_print.c", "C", 27, 0, 0, 0, 20, 5, 52
"/Users/sbukhari/Sandbox/CProgram/ASTanalysis/CodexUserStudyData/raw_data/ddac8637-a99c-458d-bff5-916acb92e259/parts/gen_list_remove_item_at_pos.c", "C", 33, 0, 0, 0, 10, 5, 48
"/Users/sbukhari/Sandbox/CProgram/ASTanalysis/CodexUserStudyData/raw_data/ddac8637-a99c-458d-bff5-916acb92e259/parts/gen_list_save.c", "C", 28, 0, 0, 0, 14, 6, 48
"/Users/sbukhari/Sandbox/CProgram/ASTanalysis/CodexUserStudyData/raw_data/ddac8637-a99c-458d-bff5-916acb92e259/parts/gen_list_swap_item_positions.c", "C", 39, 0, 0, 0, 12, 6, 57
"/Users/sbukhari/Sandbox/CProgram/ASTanalysis/CodexUserStudyData/raw_data/ddac8637-a99c-458d-bff5-916acb92e259/parts/gen_list_update_item_at_pos.c", "C", 32, 0, 0, 0, 10, 5, 47
"/Users/sbukhari/Sandbox/CProgram/ASTanalysis/CodexUserStudyData/raw_data/ddac8637-a99c-458d-bff5-916acb92e259/ref_testsuite.json", "JSON", 0, 323, 0, 0, 0, 1, 324
"/Users/sbukhari/Sandbox/CProgram/ASTanalysis/CodexUserStudyData/raw_data/ddac8637-a99c-458d-bff5-916acb92e259/ref_testsuite_asan.json", "JSON", 0, 323, 0, 0, 0, 1, 324
"/Users/sbukhari/Sandbox/CProgram/ASTanalysis/CodexUserStudyData/raw_data/ddac8637-a99c-458d-bff5-916acb92e259/ref_testsuite_asan_noleak.json", "JSON", 0, 323, 0, 0, 0, 1, 324
"/Users/sbukhari/Sandbox/CProgram/ASTanalysis/CodexUserStudyData/raw_data/e04ce3f6-46eb-465e-9828-5e768febf9be/api_report.json", "JSON", 0, 14, 0, 0, 0, 1, 15
"/Users/sbukhari/Sandbox/CProgram/ASTanalysis/CodexUserStudyData/raw_data/e04ce3f6-46eb-465e-9828-5e768febf9be/list.c", "C", 264, 0, 0, 0, 55, 55, 374
"/Users/sbukhari/Sandbox/CProgram/ASTanalysis/CodexUserStudyData/raw_data/e04ce3f6-46eb-465e-9828-5e768febf9be/orig_testsuite.json", "JSON", 0, 92, 0, 0, 0, 1, 93
"/Users/sbukhari/Sandbox/CProgram/ASTanalysis/CodexUserStudyData/raw_data/e04ce3f6-46eb-465e-9828-5e768febf9be/orig_testsuite_asan.json", "JSON", 0, 92, 0, 0, 0, 1, 93
"/Users/sbukhari/Sandbox/CProgram/ASTanalysis/CodexUserStudyData/raw_data/e04ce3f6-46eb-465e-9828-5e768febf9be/orig_testsuite_asan_noleak.json", "JSON", 0, 92, 0, 0, 0, 1, 93
"/Users/sbukhari/Sandbox/CProgram/ASTanalysis/CodexUserStudyData/raw_data/e04ce3f6-46eb-465e-9828-5e768febf9be/parts/gen_list_add_item_at_pos.c", "C", 41, 0, 0, 0, 17, 10, 68
"/Users/sbukhari/Sandbox/CProgram/ASTanalysis/CodexUserStudyData/raw_data/e04ce3f6-46eb-465e-9828-5e768febf9be/parts/gen_list_cost_sum.c", "C", 27, 0, 0, 0, 7, 8, 42
"/Users/sbukhari/Sandbox/CProgram/ASTanalysis/CodexUserStudyData/raw_data/e04ce3f6-46eb-465e-9828-5e768febf9be/parts/gen_list_deduplicate.c", "C", 59, 0, 0, 0, 13, 12, 84
"/Users/sbukhari/Sandbox/CProgram/ASTanalysis/CodexUserStudyData/raw_data/e04ce3f6-46eb-465e-9828-5e768febf9be/parts/gen_list_find_highest_price_item_position.c", "C", 32, 0, 0, 0, 7, 6, 45
"/Users/sbukhari/Sandbox/CProgram/ASTanalysis/CodexUserStudyData/raw_data/e04ce3f6-46eb-465e-9828-5e768febf9be/parts/gen_list_init.c", "C", 19, 0, 0, 0, 6, 6, 31
"/Users/sbukhari/Sandbox/CProgram/ASTanalysis/CodexUserStudyData/raw_data/e04ce3f6-46eb-465e-9828-5e768febf9be/parts/gen_list_item_to_string.c", "C", 21, 0, 0, 0, 13, 5, 39
"/Users/sbukhari/Sandbox/CProgram/ASTanalysis/CodexUserStudyData/raw_data/e04ce3f6-46eb-465e-9828-5e768febf9be/parts/gen_list_load.c", "C", 45, 0, 0, 0, 14, 12, 71
"/Users/sbukhari/Sandbox/CProgram/ASTanalysis/CodexUserStudyData/raw_data/e04ce3f6-46eb-465e-9828-5e768febf9be/parts/gen_list_print.c", "C", 28, 0, 0, 0, 20, 5, 53
"/Users/sbukhari/Sandbox/CProgram/ASTanalysis/CodexUserStudyData/raw_data/e04ce3f6-46eb-465e-9828-5e768febf9be/parts/gen_list_remove_item_at_pos.c", "C", 43, 0, 0, 0, 10, 8, 61
"/Users/sbukhari/Sandbox/CProgram/ASTanalysis/CodexUserStudyData/raw_data/e04ce3f6-46eb-465e-9828-5e768febf9be/parts/gen_list_save.c", "C", 30, 0, 0, 0, 12, 9, 51
"/Users/sbukhari/Sandbox/CProgram/ASTanalysis/CodexUserStudyData/raw_data/e04ce3f6-46eb-465e-9828-5e768febf9be/parts/gen_list_swap_item_positions.c", "C", 43, 0, 0, 0, 7, 9, 59
"/Users/sbukhari/Sandbox/CProgram/ASTanalysis/CodexUserStudyData/raw_data/e04ce3f6-46eb-465e-9828-5e768febf9be/parts/gen_list_update_item_at_pos.c", "C", 34, 0, 0, 0, 9, 8, 51
"/Users/sbukhari/Sandbox/CProgram/ASTanalysis/CodexUserStudyData/raw_data/e04ce3f6-46eb-465e-9828-5e768febf9be/ref_testsuite.json", "JSON", 0, 323, 0, 0, 0, 1, 324
"/Users/sbukhari/Sandbox/CProgram/ASTanalysis/CodexUserStudyData/raw_data/e04ce3f6-46eb-465e-9828-5e768febf9be/ref_testsuite_asan.json", "JSON", 0, 323, 0, 0, 0, 1, 324
"/Users/sbukhari/Sandbox/CProgram/ASTanalysis/CodexUserStudyData/raw_data/e04ce3f6-46eb-465e-9828-5e768febf9be/ref_testsuite_asan_noleak.json", "JSON", 0, 323, 0, 0, 0, 1, 324
"/Users/sbukhari/Sandbox/CProgram/ASTanalysis/CodexUserStudyData/raw_data/e5d2269a-cb40-4643-8134-13bc23ce41a7/api_report.json", "JSON", 0, 14, 0, 0, 0, 1, 15
"/Users/sbukhari/Sandbox/CProgram/ASTanalysis/CodexUserStudyData/raw_data/e5d2269a-cb40-4643-8134-13bc23ce41a7/list.c", "C", 228, 0, 0, 0, 77, 41, 346
"/Users/sbukhari/Sandbox/CProgram/ASTanalysis/CodexUserStudyData/raw_data/e5d2269a-cb40-4643-8134-13bc23ce41a7/orig_testsuite.json", "JSON", 0, 92, 0, 0, 0, 1, 93
"/Users/sbukhari/Sandbox/CProgram/ASTanalysis/CodexUserStudyData/raw_data/e5d2269a-cb40-4643-8134-13bc23ce41a7/orig_testsuite_asan.json", "JSON", 0, 92, 0, 0, 0, 1, 93
"/Users/sbukhari/Sandbox/CProgram/ASTanalysis/CodexUserStudyData/raw_data/e5d2269a-cb40-4643-8134-13bc23ce41a7/orig_testsuite_asan_noleak.json", "JSON", 0, 92, 0, 0, 0, 1, 93
"/Users/sbukhari/Sandbox/CProgram/ASTanalysis/CodexUserStudyData/raw_data/e5d2269a-cb40-4643-8134-13bc23ce41a7/parts/gen_list_add_item_at_pos.c", "C", 38, 0, 0, 0, 19, 10, 67
"/Users/sbukhari/Sandbox/CProgram/ASTanalysis/CodexUserStudyData/raw_data/e5d2269a-cb40-4643-8134-13bc23ce41a7/parts/gen_list_cost_sum.c", "C", 24, 0, 0, 0, 9, 5, 38
"/Users/sbukhari/Sandbox/CProgram/ASTanalysis/CodexUserStudyData/raw_data/e5d2269a-cb40-4643-8134-13bc23ce41a7/parts/gen_list_deduplicate.c", "C", 40, 0, 0, 0, 13, 5, 58
"/Users/sbukhari/Sandbox/CProgram/ASTanalysis/CodexUserStudyData/raw_data/e5d2269a-cb40-4643-8134-13bc23ce41a7/parts/gen_list_find_highest_price_item_position.c", "C", 30, 0, 0, 0, 10, 5, 45
"/Users/sbukhari/Sandbox/CProgram/ASTanalysis/CodexUserStudyData/raw_data/e5d2269a-cb40-4643-8134-13bc23ce41a7/parts/gen_list_init.c", "C", 19, 0, 0, 0, 6, 6, 31
"/Users/sbukhari/Sandbox/CProgram/ASTanalysis/CodexUserStudyData/raw_data/e5d2269a-cb40-4643-8134-13bc23ce41a7/parts/gen_list_item_to_string.c", "C", 21, 0, 0, 0, 17, 5, 43
"/Users/sbukhari/Sandbox/CProgram/ASTanalysis/CodexUserStudyData/raw_data/e5d2269a-cb40-4643-8134-13bc23ce41a7/parts/gen_list_load.c", "C", 47, 0, 0, 0, 15, 11, 73
"/Users/sbukhari/Sandbox/CProgram/ASTanalysis/CodexUserStudyData/raw_data/e5d2269a-cb40-4643-8134-13bc23ce41a7/parts/gen_list_print.c", "C", 25, 0, 0, 0, 22, 5, 52
"/Users/sbukhari/Sandbox/CProgram/ASTanalysis/CodexUserStudyData/raw_data/e5d2269a-cb40-4643-8134-13bc23ce41a7/parts/gen_list_remove_item_at_pos.c", "C", 34, 0, 0, 0, 13, 8, 55
"/Users/sbukhari/Sandbox/CProgram/ASTanalysis/CodexUserStudyData/raw_data/e5d2269a-cb40-4643-8134-13bc23ce41a7/parts/gen_list_save.c", "C", 32, 0, 0, 0, 14, 8, 54
"/Users/sbukhari/Sandbox/CProgram/ASTanalysis/CodexUserStudyData/raw_data/e5d2269a-cb40-4643-8134-13bc23ce41a7/parts/gen_list_swap_item_positions.c", "C", 44, 0, 0, 0, 12, 9, 65
"/Users/sbukhari/Sandbox/CProgram/ASTanalysis/CodexUserStudyData/raw_data/e5d2269a-cb40-4643-8134-13bc23ce41a7/parts/gen_list_update_item_at_pos.c", "C", 29, 0, 0, 0, 11, 7, 47
"/Users/sbukhari/Sandbox/CProgram/ASTanalysis/CodexUserStudyData/raw_data/e5d2269a-cb40-4643-8134-13bc23ce41a7/ref_testsuite.json", "JSON", 0, 323, 0, 0, 0, 1, 324
"/Users/sbukhari/Sandbox/CProgram/ASTanalysis/CodexUserStudyData/raw_data/e5d2269a-cb40-4643-8134-13bc23ce41a7/ref_testsuite_asan.json", "JSON", 0, 323, 0, 0, 0, 1, 324
"/Users/sbukhari/Sandbox/CProgram/ASTanalysis/CodexUserStudyData/raw_data/e5d2269a-cb40-4643-8134-13bc23ce41a7/ref_testsuite_asan_noleak.json", "JSON", 0, 323, 0, 0, 0, 1, 324
"/Users/sbukhari/Sandbox/CProgram/ASTanalysis/CodexUserStudyData/raw_data/e603de64-bbb4-43fd-9506-ec25df81b660/api_report.json", "JSON", 0, 14, 0, 0, 0, 1, 15
"/Users/sbukhari/Sandbox/CProgram/ASTanalysis/CodexUserStudyData/raw_data/e603de64-bbb4-43fd-9506-ec25df81b660/list.c", "C", 67, 0, 0, 0, 74, 17, 158
"/Users/sbukhari/Sandbox/CProgram/ASTanalysis/CodexUserStudyData/raw_data/e603de64-bbb4-43fd-9506-ec25df81b660/orig_testsuite.json", "JSON", 0, 92, 0, 0, 0, 1, 93
"/Users/sbukhari/Sandbox/CProgram/ASTanalysis/CodexUserStudyData/raw_data/e603de64-bbb4-43fd-9506-ec25df81b660/orig_testsuite_asan.json", "JSON", 0, 92, 0, 0, 0, 1, 93
"/Users/sbukhari/Sandbox/CProgram/ASTanalysis/CodexUserStudyData/raw_data/e603de64-bbb4-43fd-9506-ec25df81b660/orig_testsuite_asan_noleak.json", "JSON", 0, 92, 0, 0, 0, 1, 93
"/Users/sbukhari/Sandbox/CProgram/ASTanalysis/CodexUserStudyData/raw_data/e603de64-bbb4-43fd-9506-ec25df81b660/parts/gen_list_add_item_at_pos.c", "C", 18, 0, 0, 0, 18, 5, 41
"/Users/sbukhari/Sandbox/CProgram/ASTanalysis/CodexUserStudyData/raw_data/e603de64-bbb4-43fd-9506-ec25df81b660/parts/gen_list_cost_sum.c", "C", 18, 0, 0, 0, 8, 5, 31
"/Users/sbukhari/Sandbox/CProgram/ASTanalysis/CodexUserStudyData/raw_data/e603de64-bbb4-43fd-9506-ec25df81b660/parts/gen_list_deduplicate.c", "C", 18, 0, 0, 0, 10, 5, 33
"/Users/sbukhari/Sandbox/CProgram/ASTanalysis/CodexUserStudyData/raw_data/e603de64-bbb4-43fd-9506-ec25df81b660/parts/gen_list_find_highest_price_item_position.c", "C", 18, 0, 0, 0, 8, 5, 31
"/Users/sbukhari/Sandbox/CProgram/ASTanalysis/CodexUserStudyData/raw_data/e603de64-bbb4-43fd-9506-ec25df81b660/parts/gen_list_init.c", "C", 19, 0, 0, 0, 6, 6, 31
"/Users/sbukhari/Sandbox/CProgram/ASTanalysis/CodexUserStudyData/raw_data/e603de64-bbb4-43fd-9506-ec25df81b660/parts/gen_list_item_to_string.c", "C", 17, 0, 0, 0, 11, 5, 33
"/Users/sbukhari/Sandbox/CProgram/ASTanalysis/CodexUserStudyData/raw_data/e603de64-bbb4-43fd-9506-ec25df81b660/parts/gen_list_load.c", "C", 18, 0, 0, 0, 12, 5, 35
"/Users/sbukhari/Sandbox/CProgram/ASTanalysis/CodexUserStudyData/raw_data/e603de64-bbb4-43fd-9506-ec25df81b660/parts/gen_list_print.c", "C", 17, 0, 0, 0, 20, 5, 42
"/Users/sbukhari/Sandbox/CProgram/ASTanalysis/CodexUserStudyData/raw_data/e603de64-bbb4-43fd-9506-ec25df81b660/parts/gen_list_remove_item_at_pos.c", "C", 18, 0, 0, 0, 8, 5, 31
"/Users/sbukhari/Sandbox/CProgram/ASTanalysis/CodexUserStudyData/raw_data/e603de64-bbb4-43fd-9506-ec25df81b660/parts/gen_list_save.c", "C", 18, 0, 0, 0, 11, 5, 34
"/Users/sbukhari/Sandbox/CProgram/ASTanalysis/CodexUserStudyData/raw_data/e603de64-bbb4-43fd-9506-ec25df81b660/parts/gen_list_swap_item_positions.c", "C", 17, 0, 0, 0, 8, 5, 30
"/Users/sbukhari/Sandbox/CProgram/ASTanalysis/CodexUserStudyData/raw_data/e603de64-bbb4-43fd-9506-ec25df81b660/parts/gen_list_update_item_at_pos.c", "C", 17, 0, 0, 0, 8, 5, 30
"/Users/sbukhari/Sandbox/CProgram/ASTanalysis/CodexUserStudyData/raw_data/e603de64-bbb4-43fd-9506-ec25df81b660/ref_testsuite.json", "JSON", 0, 323, 0, 0, 0, 1, 324
"/Users/sbukhari/Sandbox/CProgram/ASTanalysis/CodexUserStudyData/raw_data/e603de64-bbb4-43fd-9506-ec25df81b660/ref_testsuite_asan.json", "JSON", 0, 323, 0, 0, 0, 1, 324
"/Users/sbukhari/Sandbox/CProgram/ASTanalysis/CodexUserStudyData/raw_data/e603de64-bbb4-43fd-9506-ec25df81b660/ref_testsuite_asan_noleak.json", "JSON", 0, 323, 0, 0, 0, 1, 324
"/Users/sbukhari/Sandbox/CProgram/ASTanalysis/CodexUserStudyData/raw_data/e71766a5-b1da-462f-8ea5-a7e12f82f58e/api_report.json", "JSON", 0, 14, 0, 0, 0, 1, 15
"/Users/sbukhari/Sandbox/CProgram/ASTanalysis/CodexUserStudyData/raw_data/e71766a5-b1da-462f-8ea5-a7e12f82f58e/list.c", "C", 216, 0, 0, 0, 94, 22, 332
"/Users/sbukhari/Sandbox/CProgram/ASTanalysis/CodexUserStudyData/raw_data/e71766a5-b1da-462f-8ea5-a7e12f82f58e/orig_testsuite.json", "JSON", 0, 92, 0, 0, 0, 1, 93
"/Users/sbukhari/Sandbox/CProgram/ASTanalysis/CodexUserStudyData/raw_data/e71766a5-b1da-462f-8ea5-a7e12f82f58e/orig_testsuite_asan.json", "JSON", 0, 92, 0, 0, 0, 1, 93
"/Users/sbukhari/Sandbox/CProgram/ASTanalysis/CodexUserStudyData/raw_data/e71766a5-b1da-462f-8ea5-a7e12f82f58e/orig_testsuite_asan_noleak.json", "JSON", 0, 92, 0, 0, 0, 1, 93
"/Users/sbukhari/Sandbox/CProgram/ASTanalysis/CodexUserStudyData/raw_data/e71766a5-b1da-462f-8ea5-a7e12f82f58e/parts/gen_list_add_item_at_pos.c", "C", 19, 0, 0, 0, 18, 5, 42
"/Users/sbukhari/Sandbox/CProgram/ASTanalysis/CodexUserStudyData/raw_data/e71766a5-b1da-462f-8ea5-a7e12f82f58e/parts/gen_list_cost_sum.c", "C", 26, 0, 0, 0, 9, 5, 40
"/Users/sbukhari/Sandbox/CProgram/ASTanalysis/CodexUserStudyData/raw_data/e71766a5-b1da-462f-8ea5-a7e12f82f58e/parts/gen_list_deduplicate.c", "C", 19, 0, 0, 0, 10, 5, 34
"/Users/sbukhari/Sandbox/CProgram/ASTanalysis/CodexUserStudyData/raw_data/e71766a5-b1da-462f-8ea5-a7e12f82f58e/parts/gen_list_find_highest_price_item_position.c", "C", 30, 0, 0, 0, 9, 6, 45
"/Users/sbukhari/Sandbox/CProgram/ASTanalysis/CodexUserStudyData/raw_data/e71766a5-b1da-462f-8ea5-a7e12f82f58e/parts/gen_list_init.c", "C", 20, 0, 0, 0, 6, 6, 32
"/Users/sbukhari/Sandbox/CProgram/ASTanalysis/CodexUserStudyData/raw_data/e71766a5-b1da-462f-8ea5-a7e12f82f58e/parts/gen_list_item_to_string.c", "C", 18, 0, 0, 0, 11, 5, 34
"/Users/sbukhari/Sandbox/CProgram/ASTanalysis/CodexUserStudyData/raw_data/e71766a5-b1da-462f-8ea5-a7e12f82f58e/parts/gen_list_load.c", "C", 19, 0, 0, 0, 12, 5, 36
"/Users/sbukhari/Sandbox/CProgram/ASTanalysis/CodexUserStudyData/raw_data/e71766a5-b1da-462f-8ea5-a7e12f82f58e/parts/gen_list_print.c", "C", 30, 0, 0, 0, 22, 5, 57
"/Users/sbukhari/Sandbox/CProgram/ASTanalysis/CodexUserStudyData/raw_data/e71766a5-b1da-462f-8ea5-a7e12f82f58e/parts/gen_list_remove_item_at_pos.c", "C", 25, 0, 0, 0, 14, 5, 44
"/Users/sbukhari/Sandbox/CProgram/ASTanalysis/CodexUserStudyData/raw_data/e71766a5-b1da-462f-8ea5-a7e12f82f58e/parts/gen_list_save.c", "C", 19, 0, 0, 0, 11, 5, 35
"/Users/sbukhari/Sandbox/CProgram/ASTanalysis/CodexUserStudyData/raw_data/e71766a5-b1da-462f-8ea5-a7e12f82f58e/parts/gen_list_swap_item_positions.c", "C", 18, 0, 0, 0, 8, 5, 31
"/Users/sbukhari/Sandbox/CProgram/ASTanalysis/CodexUserStudyData/raw_data/e71766a5-b1da-462f-8ea5-a7e12f82f58e/parts/gen_list_update_item_at_pos.c", "C", 18, 0, 0, 0, 8, 5, 31
"/Users/sbukhari/Sandbox/CProgram/ASTanalysis/CodexUserStudyData/raw_data/e71766a5-b1da-462f-8ea5-a7e12f82f58e/ref_testsuite.json", "JSON", 0, 323, 0, 0, 0, 1, 324
"/Users/sbukhari/Sandbox/CProgram/ASTanalysis/CodexUserStudyData/raw_data/e71766a5-b1da-462f-8ea5-a7e12f82f58e/ref_testsuite_asan.json", "JSON", 0, 323, 0, 0, 0, 1, 324
"/Users/sbukhari/Sandbox/CProgram/ASTanalysis/CodexUserStudyData/raw_data/e71766a5-b1da-462f-8ea5-a7e12f82f58e/ref_testsuite_asan_noleak.json", "JSON", 0, 323, 0, 0, 0, 1, 324
"/Users/sbukhari/Sandbox/CProgram/ASTanalysis/CodexUserStudyData/raw_data/ec83a892-5cfa-46bf-aab8-673aee747cb8/api_report.json", "JSON", 0, 14, 0, 0, 0, 1, 15
"/Users/sbukhari/Sandbox/CProgram/ASTanalysis/CodexUserStudyData/raw_data/ec83a892-5cfa-46bf-aab8-673aee747cb8/list.c", "C", 243, 0, 0, 0, 53, 18, 314
"/Users/sbukhari/Sandbox/CProgram/ASTanalysis/CodexUserStudyData/raw_data/ec83a892-5cfa-46bf-aab8-673aee747cb8/orig_testsuite.json", "JSON", 0, 92, 0, 0, 0, 1, 93
"/Users/sbukhari/Sandbox/CProgram/ASTanalysis/CodexUserStudyData/raw_data/ec83a892-5cfa-46bf-aab8-673aee747cb8/orig_testsuite_asan.json", "JSON", 0, 92, 0, 0, 0, 1, 93
"/Users/sbukhari/Sandbox/CProgram/ASTanalysis/CodexUserStudyData/raw_data/ec83a892-5cfa-46bf-aab8-673aee747cb8/orig_testsuite_asan_noleak.json", "JSON", 0, 92, 0, 0, 0, 1, 93
"/Users/sbukhari/Sandbox/CProgram/ASTanalysis/CodexUserStudyData/raw_data/ec83a892-5cfa-46bf-aab8-673aee747cb8/parts/gen_list_add_item_at_pos.c", "C", 37, 0, 0, 0, 16, 5, 58
"/Users/sbukhari/Sandbox/CProgram/ASTanalysis/CodexUserStudyData/raw_data/ec83a892-5cfa-46bf-aab8-673aee747cb8/parts/gen_list_cost_sum.c", "C", 27, 0, 0, 0, 7, 5, 39
"/Users/sbukhari/Sandbox/CProgram/ASTanalysis/CodexUserStudyData/raw_data/ec83a892-5cfa-46bf-aab8-673aee747cb8/parts/gen_list_deduplicate.c", "C", 36, 0, 0, 0, 12, 6, 54
"/Users/sbukhari/Sandbox/CProgram/ASTanalysis/CodexUserStudyData/raw_data/ec83a892-5cfa-46bf-aab8-673aee747cb8/parts/gen_list_find_highest_price_item_position.c", "C", 33, 0, 0, 0, 6, 5, 44
"/Users/sbukhari/Sandbox/CProgram/ASTanalysis/CodexUserStudyData/raw_data/ec83a892-5cfa-46bf-aab8-673aee747cb8/parts/gen_list_init.c", "C", 19, 0, 0, 0, 6, 6, 31
"/Users/sbukhari/Sandbox/CProgram/ASTanalysis/CodexUserStudyData/raw_data/ec83a892-5cfa-46bf-aab8-673aee747cb8/parts/gen_list_item_to_string.c", "C", 21, 0, 0, 0, 11, 5, 37
"/Users/sbukhari/Sandbox/CProgram/ASTanalysis/CodexUserStudyData/raw_data/ec83a892-5cfa-46bf-aab8-673aee747cb8/parts/gen_list_load.c", "C", 42, 0, 0, 0, 13, 5, 60
"/Users/sbukhari/Sandbox/CProgram/ASTanalysis/CodexUserStudyData/raw_data/ec83a892-5cfa-46bf-aab8-673aee747cb8/parts/gen_list_print.c", "C", 31, 0, 0, 0, 18, 5, 54
"/Users/sbukhari/Sandbox/CProgram/ASTanalysis/CodexUserStudyData/raw_data/ec83a892-5cfa-46bf-aab8-673aee747cb8/parts/gen_list_remove_item_at_pos.c", "C", 36, 0, 0, 0, 10, 5, 51
"/Users/sbukhari/Sandbox/CProgram/ASTanalysis/CodexUserStudyData/raw_data/ec83a892-5cfa-46bf-aab8-673aee747cb8/parts/gen_list_save.c", "C", 30, 0, 0, 0, 13, 5, 48
"/Users/sbukhari/Sandbox/CProgram/ASTanalysis/CodexUserStudyData/raw_data/ec83a892-5cfa-46bf-aab8-673aee747cb8/parts/gen_list_swap_item_positions.c", "C", 54, 0, 0, 0, 6, 5, 65
"/Users/sbukhari/Sandbox/CProgram/ASTanalysis/CodexUserStudyData/raw_data/ec83a892-5cfa-46bf-aab8-673aee747cb8/parts/gen_list_update_item_at_pos.c", "C", 32, 0, 0, 0, 8, 5, 45
"/Users/sbukhari/Sandbox/CProgram/ASTanalysis/CodexUserStudyData/raw_data/ec83a892-5cfa-46bf-aab8-673aee747cb8/ref_testsuite.json", "JSON", 0, 323, 0, 0, 0, 1, 324
"/Users/sbukhari/Sandbox/CProgram/ASTanalysis/CodexUserStudyData/raw_data/ec83a892-5cfa-46bf-aab8-673aee747cb8/ref_testsuite_asan.json", "JSON", 0, 323, 0, 0, 0, 1, 324
"/Users/sbukhari/Sandbox/CProgram/ASTanalysis/CodexUserStudyData/raw_data/ec83a892-5cfa-46bf-aab8-673aee747cb8/ref_testsuite_asan_noleak.json", "JSON", 0, 323, 0, 0, 0, 1, 324
"/Users/sbukhari/Sandbox/CProgram/ASTanalysis/CodexUserStudyData/raw_data/f0e25db0-7a42-4c33-a22c-17b79e580330/api_report.json", "JSON", 0, 14, 0, 0, 0, 1, 15
"/Users/sbukhari/Sandbox/CProgram/ASTanalysis/CodexUserStudyData/raw_data/f0e25db0-7a42-4c33-a22c-17b79e580330/list.c", "C", 66, 0, 0, 0, 70, 17, 153
"/Users/sbukhari/Sandbox/CProgram/ASTanalysis/CodexUserStudyData/raw_data/f0e25db0-7a42-4c33-a22c-17b79e580330/orig_testsuite.json", "JSON", 0, 92, 0, 0, 0, 1, 93
"/Users/sbukhari/Sandbox/CProgram/ASTanalysis/CodexUserStudyData/raw_data/f0e25db0-7a42-4c33-a22c-17b79e580330/orig_testsuite_asan.json", "JSON", 0, 92, 0, 0, 0, 1, 93
"/Users/sbukhari/Sandbox/CProgram/ASTanalysis/CodexUserStudyData/raw_data/f0e25db0-7a42-4c33-a22c-17b79e580330/orig_testsuite_asan_noleak.json", "JSON", 0, 92, 0, 0, 0, 1, 93
"/Users/sbukhari/Sandbox/CProgram/ASTanalysis/CodexUserStudyData/raw_data/f0e25db0-7a42-4c33-a22c-17b79e580330/parts/gen_list_add_item_at_pos.c", "C", 18, 0, 0, 0, 18, 5, 41
"/Users/sbukhari/Sandbox/CProgram/ASTanalysis/CodexUserStudyData/raw_data/f0e25db0-7a42-4c33-a22c-17b79e580330/parts/gen_list_cost_sum.c", "C", 18, 0, 0, 0, 8, 5, 31
"/Users/sbukhari/Sandbox/CProgram/ASTanalysis/CodexUserStudyData/raw_data/f0e25db0-7a42-4c33-a22c-17b79e580330/parts/gen_list_deduplicate.c", "C", 18, 0, 0, 0, 10, 5, 33
"/Users/sbukhari/Sandbox/CProgram/ASTanalysis/CodexUserStudyData/raw_data/f0e25db0-7a42-4c33-a22c-17b79e580330/parts/gen_list_find_highest_price_item_position.c", "C", 18, 0, 0, 0, 8, 5, 31
"/Users/sbukhari/Sandbox/CProgram/ASTanalysis/CodexUserStudyData/raw_data/f0e25db0-7a42-4c33-a22c-17b79e580330/parts/gen_list_init.c", "C", 19, 0, 0, 0, 6, 6, 31
"/Users/sbukhari/Sandbox/CProgram/ASTanalysis/CodexUserStudyData/raw_data/f0e25db0-7a42-4c33-a22c-17b79e580330/parts/gen_list_item_to_string.c", "C", 18, 0, 0, 0, 14, 5, 37
"/Users/sbukhari/Sandbox/CProgram/ASTanalysis/CodexUserStudyData/raw_data/f0e25db0-7a42-4c33-a22c-17b79e580330/parts/gen_list_load.c", "C", 18, 0, 0, 0, 12, 5, 35
"/Users/sbukhari/Sandbox/CProgram/ASTanalysis/CodexUserStudyData/raw_data/f0e25db0-7a42-4c33-a22c-17b79e580330/parts/gen_list_print.c", "C", 24, 0, 0, 0, 19, 5, 48
"/Users/sbukhari/Sandbox/CProgram/ASTanalysis/CodexUserStudyData/raw_data/f0e25db0-7a42-4c33-a22c-17b79e580330/parts/gen_list_remove_item_at_pos.c", "C", 18, 0, 0, 0, 8, 5, 31
"/Users/sbukhari/Sandbox/CProgram/ASTanalysis/CodexUserStudyData/raw_data/f0e25db0-7a42-4c33-a22c-17b79e580330/parts/gen_list_save.c", "C", 18, 0, 0, 0, 11, 5, 34
"/Users/sbukhari/Sandbox/CProgram/ASTanalysis/CodexUserStudyData/raw_data/f0e25db0-7a42-4c33-a22c-17b79e580330/parts/gen_list_swap_item_positions.c", "C", 17, 0, 0, 0, 8, 5, 30
"/Users/sbukhari/Sandbox/CProgram/ASTanalysis/CodexUserStudyData/raw_data/f0e25db0-7a42-4c33-a22c-17b79e580330/parts/gen_list_update_item_at_pos.c", "C", 17, 0, 0, 0, 8, 5, 30
"/Users/sbukhari/Sandbox/CProgram/ASTanalysis/CodexUserStudyData/raw_data/f0e25db0-7a42-4c33-a22c-17b79e580330/ref_testsuite.json", "JSON", 0, 323, 0, 0, 0, 1, 324
"/Users/sbukhari/Sandbox/CProgram/ASTanalysis/CodexUserStudyData/raw_data/f0e25db0-7a42-4c33-a22c-17b79e580330/ref_testsuite_asan.json", "JSON", 0, 323, 0, 0, 0, 1, 324
"/Users/sbukhari/Sandbox/CProgram/ASTanalysis/CodexUserStudyData/raw_data/f0e25db0-7a42-4c33-a22c-17b79e580330/ref_testsuite_asan_noleak.json", "JSON", 0, 323, 0, 0, 0, 1, 324
"/Users/sbukhari/Sandbox/CProgram/ASTanalysis/CodexUserStudyData/raw_data/f928b19b-6a98-4ed9-9c09-bfdf78073fd2/api_report.json", "JSON", 0, 14, 0, 0, 0, 1, 15
"/Users/sbukhari/Sandbox/CProgram/ASTanalysis/CodexUserStudyData/raw_data/f928b19b-6a98-4ed9-9c09-bfdf78073fd2/list.c", "C", 85, 0, 0, 0, 74, 21, 180
"/Users/sbukhari/Sandbox/CProgram/ASTanalysis/CodexUserStudyData/raw_data/f928b19b-6a98-4ed9-9c09-bfdf78073fd2/orig_testsuite.json", "JSON", 0, 92, 0, 0, 0, 1, 93
"/Users/sbukhari/Sandbox/CProgram/ASTanalysis/CodexUserStudyData/raw_data/f928b19b-6a98-4ed9-9c09-bfdf78073fd2/orig_testsuite_asan.json", "JSON", 0, 92, 0, 0, 0, 1, 93
"/Users/sbukhari/Sandbox/CProgram/ASTanalysis/CodexUserStudyData/raw_data/f928b19b-6a98-4ed9-9c09-bfdf78073fd2/orig_testsuite_asan_noleak.json", "JSON", 0, 92, 0, 0, 0, 1, 93
"/Users/sbukhari/Sandbox/CProgram/ASTanalysis/CodexUserStudyData/raw_data/f928b19b-6a98-4ed9-9c09-bfdf78073fd2/parts/gen_list_add_item_at_pos.c", "C", 35, 0, 0, 0, 20, 7, 62
"/Users/sbukhari/Sandbox/CProgram/ASTanalysis/CodexUserStudyData/raw_data/f928b19b-6a98-4ed9-9c09-bfdf78073fd2/parts/gen_list_cost_sum.c", "C", 18, 0, 0, 0, 8, 5, 31
"/Users/sbukhari/Sandbox/CProgram/ASTanalysis/CodexUserStudyData/raw_data/f928b19b-6a98-4ed9-9c09-bfdf78073fd2/parts/gen_list_deduplicate.c", "C", 18, 0, 0, 0, 10, 5, 33
"/Users/sbukhari/Sandbox/CProgram/ASTanalysis/CodexUserStudyData/raw_data/f928b19b-6a98-4ed9-9c09-bfdf78073fd2/parts/gen_list_find_highest_price_item_position.c", "C", 18, 0, 0, 0, 8, 5, 31
"/Users/sbukhari/Sandbox/CProgram/ASTanalysis/CodexUserStudyData/raw_data/f928b19b-6a98-4ed9-9c09-bfdf78073fd2/parts/gen_list_init.c", "C", 19, 0, 0, 0, 6, 6, 31
"/Users/sbukhari/Sandbox/CProgram/ASTanalysis/CodexUserStudyData/raw_data/f928b19b-6a98-4ed9-9c09-bfdf78073fd2/parts/gen_list_item_to_string.c", "C", 19, 0, 0, 0, 15, 5, 39
"/Users/sbukhari/Sandbox/CProgram/ASTanalysis/CodexUserStudyData/raw_data/f928b19b-6a98-4ed9-9c09-bfdf78073fd2/parts/gen_list_load.c", "C", 18, 0, 0, 0, 12, 5, 35
"/Users/sbukhari/Sandbox/CProgram/ASTanalysis/CodexUserStudyData/raw_data/f928b19b-6a98-4ed9-9c09-bfdf78073fd2/parts/gen_list_print.c", "C", 25, 0, 0, 0, 22, 7, 54
"/Users/sbukhari/Sandbox/CProgram/ASTanalysis/CodexUserStudyData/raw_data/f928b19b-6a98-4ed9-9c09-bfdf78073fd2/parts/gen_list_remove_item_at_pos.c", "C", 18, 0, 0, 0, 8, 5, 31
"/Users/sbukhari/Sandbox/CProgram/ASTanalysis/CodexUserStudyData/raw_data/f928b19b-6a98-4ed9-9c09-bfdf78073fd2/parts/gen_list_save.c", "C", 18, 0, 0, 0, 11, 5, 34
"/Users/sbukhari/Sandbox/CProgram/ASTanalysis/CodexUserStudyData/raw_data/f928b19b-6a98-4ed9-9c09-bfdf78073fd2/parts/gen_list_swap_item_positions.c", "C", 17, 0, 0, 0, 8, 5, 30
"/Users/sbukhari/Sandbox/CProgram/ASTanalysis/CodexUserStudyData/raw_data/f928b19b-6a98-4ed9-9c09-bfdf78073fd2/parts/gen_list_update_item_at_pos.c", "C", 17, 0, 0, 0, 8, 5, 30
"/Users/sbukhari/Sandbox/CProgram/ASTanalysis/CodexUserStudyData/raw_data/f928b19b-6a98-4ed9-9c09-bfdf78073fd2/ref_testsuite.json", "JSON", 0, 323, 0, 0, 0, 1, 324
"/Users/sbukhari/Sandbox/CProgram/ASTanalysis/CodexUserStudyData/raw_data/f928b19b-6a98-4ed9-9c09-bfdf78073fd2/ref_testsuite_asan.json", "JSON", 0, 323, 0, 0, 0, 1, 324
"/Users/sbukhari/Sandbox/CProgram/ASTanalysis/CodexUserStudyData/raw_data/f928b19b-6a98-4ed9-9c09-bfdf78073fd2/ref_testsuite_asan_noleak.json", "JSON", 0, 323, 0, 0, 0, 1, 324
"/Users/sbukhari/Sandbox/CProgram/ASTanalysis/CodexUserStudyData/raw_data/fbf1986f-db73-4988-af05-0d3cb48dd0c9/api_report.json", "JSON", 0, 14, 0, 0, 0, 1, 15
"/Users/sbukhari/Sandbox/CProgram/ASTanalysis/CodexUserStudyData/raw_data/fbf1986f-db73-4988-af05-0d3cb48dd0c9/list.c", "C", 86, 0, 0, 0, 75, 21, 182
"/Users/sbukhari/Sandbox/CProgram/ASTanalysis/CodexUserStudyData/raw_data/fbf1986f-db73-4988-af05-0d3cb48dd0c9/orig_testsuite.json", "JSON", 0, 92, 0, 0, 0, 1, 93
"/Users/sbukhari/Sandbox/CProgram/ASTanalysis/CodexUserStudyData/raw_data/fbf1986f-db73-4988-af05-0d3cb48dd0c9/orig_testsuite_asan.json", "JSON", 0, 92, 0, 0, 0, 1, 93
"/Users/sbukhari/Sandbox/CProgram/ASTanalysis/CodexUserStudyData/raw_data/fbf1986f-db73-4988-af05-0d3cb48dd0c9/orig_testsuite_asan_noleak.json", "JSON", 0, 92, 0, 0, 0, 1, 93
"/Users/sbukhari/Sandbox/CProgram/ASTanalysis/CodexUserStudyData/raw_data/fbf1986f-db73-4988-af05-0d3cb48dd0c9/parts/gen_list_add_item_at_pos.c", "C", 36, 0, 0, 0, 23, 9, 68
"/Users/sbukhari/Sandbox/CProgram/ASTanalysis/CodexUserStudyData/raw_data/fbf1986f-db73-4988-af05-0d3cb48dd0c9/parts/gen_list_cost_sum.c", "C", 18, 0, 0, 0, 8, 5, 31
"/Users/sbukhari/Sandbox/CProgram/ASTanalysis/CodexUserStudyData/raw_data/fbf1986f-db73-4988-af05-0d3cb48dd0c9/parts/gen_list_deduplicate.c", "C", 18, 0, 0, 0, 10, 5, 33
"/Users/sbukhari/Sandbox/CProgram/ASTanalysis/CodexUserStudyData/raw_data/fbf1986f-db73-4988-af05-0d3cb48dd0c9/parts/gen_list_find_highest_price_item_position.c", "C", 18, 0, 0, 0, 8, 5, 31
"/Users/sbukhari/Sandbox/CProgram/ASTanalysis/CodexUserStudyData/raw_data/fbf1986f-db73-4988-af05-0d3cb48dd0c9/parts/gen_list_init.c", "C", 19, 0, 0, 0, 6, 6, 31
"/Users/sbukhari/Sandbox/CProgram/ASTanalysis/CodexUserStudyData/raw_data/fbf1986f-db73-4988-af05-0d3cb48dd0c9/parts/gen_list_item_to_string.c", "C", 19, 0, 0, 0, 15, 5, 39
"/Users/sbukhari/Sandbox/CProgram/ASTanalysis/CodexUserStudyData/raw_data/fbf1986f-db73-4988-af05-0d3cb48dd0c9/parts/gen_list_load.c", "C", 18, 0, 0, 0, 12, 5, 35
"/Users/sbukhari/Sandbox/CProgram/ASTanalysis/CodexUserStudyData/raw_data/fbf1986f-db73-4988-af05-0d3cb48dd0c9/parts/gen_list_print.c", "C", 25, 0, 0, 0, 21, 5, 51
"/Users/sbukhari/Sandbox/CProgram/ASTanalysis/CodexUserStudyData/raw_data/fbf1986f-db73-4988-af05-0d3cb48dd0c9/parts/gen_list_remove_item_at_pos.c", "C", 18, 0, 0, 0, 8, 5, 31
"/Users/sbukhari/Sandbox/CProgram/ASTanalysis/CodexUserStudyData/raw_data/fbf1986f-db73-4988-af05-0d3cb48dd0c9/parts/gen_list_save.c", "C", 18, 0, 0, 0, 11, 5, 34
"/Users/sbukhari/Sandbox/CProgram/ASTanalysis/CodexUserStudyData/raw_data/fbf1986f-db73-4988-af05-0d3cb48dd0c9/parts/gen_list_swap_item_positions.c", "C", 17, 0, 0, 0, 8, 5, 30
"/Users/sbukhari/Sandbox/CProgram/ASTanalysis/CodexUserStudyData/raw_data/fbf1986f-db73-4988-af05-0d3cb48dd0c9/parts/gen_list_update_item_at_pos.c", "C", 17, 0, 0, 0, 8, 5, 30
"/Users/sbukhari/Sandbox/CProgram/ASTanalysis/CodexUserStudyData/raw_data/fbf1986f-db73-4988-af05-0d3cb48dd0c9/ref_testsuite.json", "JSON", 0, 323, 0, 0, 0, 1, 324
"/Users/sbukhari/Sandbox/CProgram/ASTanalysis/CodexUserStudyData/raw_data/fbf1986f-db73-4988-af05-0d3cb48dd0c9/ref_testsuite_asan.json", "JSON", 0, 323, 0, 0, 0, 1, 324
"/Users/sbukhari/Sandbox/CProgram/ASTanalysis/CodexUserStudyData/raw_data/fbf1986f-db73-4988-af05-0d3cb48dd0c9/ref_testsuite_asan_noleak.json", "JSON", 0, 323, 0, 0, 0, 1, 324
"/Users/sbukhari/Sandbox/CProgram/ASTanalysis/CodexUserStudyData/raw_data/fd621e01-4962-4699-b49a-012c08563cb5/api_report.json", "JSON", 0, 14, 0, 0, 0, 1, 15
"/Users/sbukhari/Sandbox/CProgram/ASTanalysis/CodexUserStudyData/raw_data/fd621e01-4962-4699-b49a-012c08563cb5/list.c", "C", 90, 0, 0, 0, 89, 18, 197
"/Users/sbukhari/Sandbox/CProgram/ASTanalysis/CodexUserStudyData/raw_data/fd621e01-4962-4699-b49a-012c08563cb5/orig_testsuite.json", "JSON", 0, 92, 0, 0, 0, 1, 93
"/Users/sbukhari/Sandbox/CProgram/ASTanalysis/CodexUserStudyData/raw_data/fd621e01-4962-4699-b49a-012c08563cb5/orig_testsuite_asan.json", "JSON", 0, 92, 0, 0, 0, 1, 93
"/Users/sbukhari/Sandbox/CProgram/ASTanalysis/CodexUserStudyData/raw_data/fd621e01-4962-4699-b49a-012c08563cb5/orig_testsuite_asan_noleak.json", "JSON", 0, 92, 0, 0, 0, 1, 93
"/Users/sbukhari/Sandbox/CProgram/ASTanalysis/CodexUserStudyData/raw_data/fd621e01-4962-4699-b49a-012c08563cb5/parts/gen_list_add_item_at_pos.c", "C", 36, 0, 0, 0, 20, 5, 61
"/Users/sbukhari/Sandbox/CProgram/ASTanalysis/CodexUserStudyData/raw_data/fd621e01-4962-4699-b49a-012c08563cb5/parts/gen_list_cost_sum.c", "C", 18, 0, 0, 0, 8, 5, 31
"/Users/sbukhari/Sandbox/CProgram/ASTanalysis/CodexUserStudyData/raw_data/fd621e01-4962-4699-b49a-012c08563cb5/parts/gen_list_deduplicate.c", "C", 18, 0, 0, 0, 10, 5, 33
"/Users/sbukhari/Sandbox/CProgram/ASTanalysis/CodexUserStudyData/raw_data/fd621e01-4962-4699-b49a-012c08563cb5/parts/gen_list_find_highest_price_item_position.c", "C", 18, 0, 0, 0, 8, 5, 31
"/Users/sbukhari/Sandbox/CProgram/ASTanalysis/CodexUserStudyData/raw_data/fd621e01-4962-4699-b49a-012c08563cb5/parts/gen_list_init.c", "C", 19, 0, 0, 0, 6, 6, 31
"/Users/sbukhari/Sandbox/CProgram/ASTanalysis/CodexUserStudyData/raw_data/fd621e01-4962-4699-b49a-012c08563cb5/parts/gen_list_item_to_string.c", "C", 18, 0, 0, 0, 15, 5, 38
"/Users/sbukhari/Sandbox/CProgram/ASTanalysis/CodexUserStudyData/raw_data/fd621e01-4962-4699-b49a-012c08563cb5/parts/gen_list_load.c", "C", 18, 0, 0, 0, 12, 5, 35
"/Users/sbukhari/Sandbox/CProgram/ASTanalysis/CodexUserStudyData/raw_data/fd621e01-4962-4699-b49a-012c08563cb5/parts/gen_list_print.c", "C", 27, 0, 0, 0, 22, 5, 54
"/Users/sbukhari/Sandbox/CProgram/ASTanalysis/CodexUserStudyData/raw_data/fd621e01-4962-4699-b49a-012c08563cb5/parts/gen_list_remove_item_at_pos.c", "C", 18, 0, 0, 0, 8, 5, 31
"/Users/sbukhari/Sandbox/CProgram/ASTanalysis/CodexUserStudyData/raw_data/fd621e01-4962-4699-b49a-012c08563cb5/parts/gen_list_save.c", "C", 18, 0, 0, 0, 11, 5, 34
"/Users/sbukhari/Sandbox/CProgram/ASTanalysis/CodexUserStudyData/raw_data/fd621e01-4962-4699-b49a-012c08563cb5/parts/gen_list_swap_item_positions.c", "C", 17, 0, 0, 0, 8, 5, 30
"/Users/sbukhari/Sandbox/CProgram/ASTanalysis/CodexUserStudyData/raw_data/fd621e01-4962-4699-b49a-012c08563cb5/parts/gen_list_update_item_at_pos.c", "C", 16, 0, 0, 0, 21, 5, 42
"/Users/sbukhari/Sandbox/CProgram/ASTanalysis/CodexUserStudyData/raw_data/fd621e01-4962-4699-b49a-012c08563cb5/ref_testsuite.json", "JSON", 0, 323, 0, 0, 0, 1, 324
"/Users/sbukhari/Sandbox/CProgram/ASTanalysis/CodexUserStudyData/raw_data/fd621e01-4962-4699-b49a-012c08563cb5/ref_testsuite_asan.json", "JSON", 0, 323, 0, 0, 0, 1, 324
"/Users/sbukhari/Sandbox/CProgram/ASTanalysis/CodexUserStudyData/raw_data/fd621e01-4962-4699-b49a-012c08563cb5/ref_testsuite_asan_noleak.json", "JSON", 0, 323, 0, 0, 0, 1, 324
"/Users/sbukhari/Sandbox/CProgram/ASTanalysis/CodexUserStudyData/raw_data/ff36e2ef-af58-426f-97ae-dc8ba80ff4a0/api_report.json", "JSON", 0, 14, 0, 0, 0, 1, 15
"/Users/sbukhari/Sandbox/CProgram/ASTanalysis/CodexUserStudyData/raw_data/ff36e2ef-af58-426f-97ae-dc8ba80ff4a0/list.c", "C", 232, 0, 0, 0, 67, 47, 346
"/Users/sbukhari/Sandbox/CProgram/ASTanalysis/CodexUserStudyData/raw_data/ff36e2ef-af58-426f-97ae-dc8ba80ff4a0/orig_testsuite.json", "JSON", 0, 92, 0, 0, 0, 1, 93
"/Users/sbukhari/Sandbox/CProgram/ASTanalysis/CodexUserStudyData/raw_data/ff36e2ef-af58-426f-97ae-dc8ba80ff4a0/orig_testsuite_asan.json", "JSON", 0, 92, 0, 0, 0, 1, 93
"/Users/sbukhari/Sandbox/CProgram/ASTanalysis/CodexUserStudyData/raw_data/ff36e2ef-af58-426f-97ae-dc8ba80ff4a0/orig_testsuite_asan_noleak.json", "JSON", 0, 92, 0, 0, 0, 1, 93
"/Users/sbukhari/Sandbox/CProgram/ASTanalysis/CodexUserStudyData/raw_data/ff36e2ef-af58-426f-97ae-dc8ba80ff4a0/parts/gen_list_add_item_at_pos.c", "C", 18, 0, 0, 0, 18, 6, 42
"/Users/sbukhari/Sandbox/CProgram/ASTanalysis/CodexUserStudyData/raw_data/ff36e2ef-af58-426f-97ae-dc8ba80ff4a0/parts/gen_list_cost_sum.c", "C", 18, 0, 0, 0, 8, 6, 32
"/Users/sbukhari/Sandbox/CProgram/ASTanalysis/CodexUserStudyData/raw_data/ff36e2ef-af58-426f-97ae-dc8ba80ff4a0/parts/gen_list_deduplicate.c", "C", 18, 0, 0, 0, 10, 6, 34
"/Users/sbukhari/Sandbox/CProgram/ASTanalysis/CodexUserStudyData/raw_data/ff36e2ef-af58-426f-97ae-dc8ba80ff4a0/parts/gen_list_find_highest_price_item_position.c", "C", 24, 0, 0, 0, 10, 6, 40
"/Users/sbukhari/Sandbox/CProgram/ASTanalysis/CodexUserStudyData/raw_data/ff36e2ef-af58-426f-97ae-dc8ba80ff4a0/parts/gen_list_init.c", "C", 19, 0, 0, 0, 6, 7, 32
"/Users/sbukhari/Sandbox/CProgram/ASTanalysis/CodexUserStudyData/raw_data/ff36e2ef-af58-426f-97ae-dc8ba80ff4a0/parts/gen_list_item_to_string.c", "C", 25, 0, 0, 0, 14, 7, 46
"/Users/sbukhari/Sandbox/CProgram/ASTanalysis/CodexUserStudyData/raw_data/ff36e2ef-af58-426f-97ae-dc8ba80ff4a0/parts/gen_list_load.c", "C", 18, 0, 0, 0, 12, 6, 36
"/Users/sbukhari/Sandbox/CProgram/ASTanalysis/CodexUserStudyData/raw_data/ff36e2ef-af58-426f-97ae-dc8ba80ff4a0/parts/gen_list_print.c", "C", 27, 0, 0, 0, 20, 8, 55
"/Users/sbukhari/Sandbox/CProgram/ASTanalysis/CodexUserStudyData/raw_data/ff36e2ef-af58-426f-97ae-dc8ba80ff4a0/parts/gen_list_remove_item_at_pos.c", "C", 18, 0, 0, 0, 8, 6, 32
"/Users/sbukhari/Sandbox/CProgram/ASTanalysis/CodexUserStudyData/raw_data/ff36e2ef-af58-426f-97ae-dc8ba80ff4a0/parts/gen_list_save.c", "C", 31, 0, 0, 0, 14, 9, 54
"/Users/sbukhari/Sandbox/CProgram/ASTanalysis/CodexUserStudyData/raw_data/ff36e2ef-af58-426f-97ae-dc8ba80ff4a0/parts/gen_list_swap_item_positions.c", "C", 31, 0, 0, 0, 9, 6, 46
"/Users/sbukhari/Sandbox/CProgram/ASTanalysis/CodexUserStudyData/raw_data/ff36e2ef-af58-426f-97ae-dc8ba80ff4a0/parts/gen_list_update_item_at_pos.c", "C", 17, 0, 0, 0, 8, 6, 31
"/Users/sbukhari/Sandbox/CProgram/ASTanalysis/CodexUserStudyData/raw_data/ff36e2ef-af58-426f-97ae-dc8ba80ff4a0/ref_testsuite.json", "JSON", 0, 323, 0, 0, 0, 1, 324
"/Users/sbukhari/Sandbox/CProgram/ASTanalysis/CodexUserStudyData/raw_data/ff36e2ef-af58-426f-97ae-dc8ba80ff4a0/ref_testsuite_asan.json", "JSON", 0, 323, 0, 0, 0, 1, 324
"/Users/sbukhari/Sandbox/CProgram/ASTanalysis/CodexUserStudyData/raw_data/ff36e2ef-af58-426f-97ae-dc8ba80ff4a0/ref_testsuite_asan_noleak.json", "JSON", 0, 323, 0, 0, 0, 1, 324
"/Users/sbukhari/Sandbox/CProgram/ASTanalysis/CodexUserStudyData/raw_data/gold_standard/api_report.json", "JSON", 0, 14, 0, 0, 0, 1, 15
"/Users/sbukhari/Sandbox/CProgram/ASTanalysis/CodexUserStudyData/raw_data/gold_standard/list.c", "C", 318, 0, 0, 0, 64, 30, 412
"/Users/sbukhari/Sandbox/CProgram/ASTanalysis/CodexUserStudyData/raw_data/gold_standard/orig_testsuite.json", "JSON", 0, 92, 0, 0, 0, 1, 93
"/Users/sbukhari/Sandbox/CProgram/ASTanalysis/CodexUserStudyData/raw_data/gold_standard/orig_testsuite_asan.json", "JSON", 0, 92, 0, 0, 0, 1, 93
"/Users/sbukhari/Sandbox/CProgram/ASTanalysis/CodexUserStudyData/raw_data/gold_standard/orig_testsuite_asan_noleak.json", "JSON", 0, 92, 0, 0, 0, 1, 93
"/Users/sbukhari/Sandbox/CProgram/ASTanalysis/CodexUserStudyData/raw_data/gold_standard/parts/gen_list_add_item_at_pos.c", "C", 45, 0, 0, 0, 17, 8, 70
"/Users/sbukhari/Sandbox/CProgram/ASTanalysis/CodexUserStudyData/raw_data/gold_standard/parts/gen_list_cost_sum.c", "C", 28, 0, 0, 0, 6, 5, 39
"/Users/sbukhari/Sandbox/CProgram/ASTanalysis/CodexUserStudyData/raw_data/gold_standard/parts/gen_list_deduplicate.c", "C", 72, 0, 0, 0, 14, 21, 107
"/Users/sbukhari/Sandbox/CProgram/ASTanalysis/CodexUserStudyData/raw_data/gold_standard/parts/gen_list_find_highest_price_item_position.c", "C", 32, 0, 0, 0, 6, 5, 43
"/Users/sbukhari/Sandbox/CProgram/ASTanalysis/CodexUserStudyData/raw_data/gold_standard/parts/gen_list_init.c", "C", 23, 0, 0, 0, 6, 6, 35
"/Users/sbukhari/Sandbox/CProgram/ASTanalysis/CodexUserStudyData/raw_data/gold_standard/parts/gen_list_item_to_string.c", "C", 24, 0, 0, 0, 9, 5, 38
"/Users/sbukhari/Sandbox/CProgram/ASTanalysis/CodexUserStudyData/raw_data/gold_standard/parts/gen_list_load.c", "C", 57, 0, 0, 0, 11, 8, 76
"/Users/sbukhari/Sandbox/CProgram/ASTanalysis/CodexUserStudyData/raw_data/gold_standard/parts/gen_list_print.c", "C", 32, 0, 0, 0, 18, 5, 55
"/Users/sbukhari/Sandbox/CProgram/ASTanalysis/CodexUserStudyData/raw_data/gold_standard/parts/gen_list_remove_item_at_pos.c", "C", 52, 0, 0, 0, 8, 5, 65
"/Users/sbukhari/Sandbox/CProgram/ASTanalysis/CodexUserStudyData/raw_data/gold_standard/parts/gen_list_save.c", "C", 34, 0, 0, 0, 9, 5, 48
"/Users/sbukhari/Sandbox/CProgram/ASTanalysis/CodexUserStudyData/raw_data/gold_standard/parts/gen_list_swap_item_positions.c", "C", 63, 0, 0, 0, 10, 8, 81
"/Users/sbukhari/Sandbox/CProgram/ASTanalysis/CodexUserStudyData/raw_data/gold_standard/parts/gen_list_update_item_at_pos.c", "C", 49, 0, 0, 0, 8, 5, 62
"/Users/sbukhari/Sandbox/CProgram/ASTanalysis/CodexUserStudyData/raw_data/gold_standard/ref_testsuite.json", "JSON", 0, 323, 0, 0, 0, 1, 324
"/Users/sbukhari/Sandbox/CProgram/ASTanalysis/CodexUserStudyData/raw_data/gold_standard/ref_testsuite_asan.json", "JSON", 0, 323, 0, 0, 0, 1, 324
"/Users/sbukhari/Sandbox/CProgram/ASTanalysis/CodexUserStudyData/raw_data/gold_standard/ref_testsuite_asan_noleak.json", "JSON", 0, 323, 0, 0, 0, 1, 324
"/Users/sbukhari/Sandbox/CProgram/ASTanalysis/CodexUserStudyData/raw_data/unmodified/api_report.json", "JSON", 0, 14, 0, 0, 0, 1, 15
"/Users/sbukhari/Sandbox/CProgram/ASTanalysis/CodexUserStudyData/raw_data/unmodified/list.c", "C", 58, 0, 0, 0, 74, 17, 149
"/Users/sbukhari/Sandbox/CProgram/ASTanalysis/CodexUserStudyData/raw_data/unmodified/orig_testsuite.json", "JSON", 0, 92, 0, 0, 0, 1, 93
"/Users/sbukhari/Sandbox/CProgram/ASTanalysis/CodexUserStudyData/raw_data/unmodified/orig_testsuite_asan.json", "JSON", 0, 92, 0, 0, 0, 1, 93
"/Users/sbukhari/Sandbox/CProgram/ASTanalysis/CodexUserStudyData/raw_data/unmodified/orig_testsuite_asan_noleak.json", "JSON", 0, 92, 0, 0, 0, 1, 93
"/Users/sbukhari/Sandbox/CProgram/ASTanalysis/CodexUserStudyData/raw_data/unmodified/parts/gen_list_add_item_at_pos.c", "C", 18, 0, 0, 0, 18, 5, 41
"/Users/sbukhari/Sandbox/CProgram/ASTanalysis/CodexUserStudyData/raw_data/unmodified/parts/gen_list_cost_sum.c", "C", 18, 0, 0, 0, 8, 5, 31
"/Users/sbukhari/Sandbox/CProgram/ASTanalysis/CodexUserStudyData/raw_data/unmodified/parts/gen_list_deduplicate.c", "C", 18, 0, 0, 0, 10, 5, 33
"/Users/sbukhari/Sandbox/CProgram/ASTanalysis/CodexUserStudyData/raw_data/unmodified/parts/gen_list_find_highest_price_item_position.c", "C", 18, 0, 0, 0, 8, 5, 31
"/Users/sbukhari/Sandbox/CProgram/ASTanalysis/CodexUserStudyData/raw_data/unmodified/parts/gen_list_init.c", "C", 19, 0, 0, 0, 6, 6, 31
"/Users/sbukhari/Sandbox/CProgram/ASTanalysis/CodexUserStudyData/raw_data/unmodified/parts/gen_list_item_to_string.c", "C", 17, 0, 0, 0, 11, 5, 33
"/Users/sbukhari/Sandbox/CProgram/ASTanalysis/CodexUserStudyData/raw_data/unmodified/parts/gen_list_load.c", "C", 18, 0, 0, 0, 12, 5, 35
"/Users/sbukhari/Sandbox/CProgram/ASTanalysis/CodexUserStudyData/raw_data/unmodified/parts/gen_list_print.c", "C", 17, 0, 0, 0, 20, 5, 42
"/Users/sbukhari/Sandbox/CProgram/ASTanalysis/CodexUserStudyData/raw_data/unmodified/parts/gen_list_remove_item_at_pos.c", "C", 18, 0, 0, 0, 8, 5, 31
"/Users/sbukhari/Sandbox/CProgram/ASTanalysis/CodexUserStudyData/raw_data/unmodified/parts/gen_list_save.c", "C", 18, 0, 0, 0, 11, 5, 34
"/Users/sbukhari/Sandbox/CProgram/ASTanalysis/CodexUserStudyData/raw_data/unmodified/parts/gen_list_swap_item_positions.c", "C", 17, 0, 0, 0, 8, 5, 30
"/Users/sbukhari/Sandbox/CProgram/ASTanalysis/CodexUserStudyData/raw_data/unmodified/parts/gen_list_update_item_at_pos.c", "C", 17, 0, 0, 0, 8, 5, 30
"/Users/sbukhari/Sandbox/CProgram/ASTanalysis/CodexUserStudyData/raw_data/unmodified/ref_testsuite.json", "JSON", 0, 323, 0, 0, 0, 1, 324
"/Users/sbukhari/Sandbox/CProgram/ASTanalysis/CodexUserStudyData/raw_data/unmodified/ref_testsuite_asan.json", "JSON", 0, 323, 0, 0, 0, 1, 324
"/Users/sbukhari/Sandbox/CProgram/ASTanalysis/CodexUserStudyData/raw_data/unmodified/ref_testsuite_asan_noleak.json", "JSON", 0, 323, 0, 0, 0, 1, 324
"/Users/sbukhari/Sandbox/CProgram/ASTanalysis/CreateNodeTypeSet.py", "Python", 0, 0, 73, 0, 40, 70, 183
"/Users/sbukhari/Sandbox/CProgram/ASTanalysis/Dataset/Autopilot/Machine1/addItem_Machine1.c", "C", 28, 0, 0, 0, 5, 0, 33
"/Users/sbukhari/Sandbox/CProgram/ASTanalysis/Dataset/Autopilot/Machine1/costSum_Machine1.c", "C", 17, 0, 0, 0, 3, 0, 20
"/Users/sbukhari/Sandbox/CProgram/ASTanalysis/Dataset/Autopilot/Machine1/highestPrice_Machine1.c", "C", 22, 0, 0, 0, 3, 0, 25
"/Users/sbukhari/Sandbox/CProgram/ASTanalysis/Dataset/Autopilot/Machine1/itemToString_Machine1.c", "C", 11, 0, 0, 0, 1, 0, 12
"/Users/sbukhari/Sandbox/CProgram/ASTanalysis/Dataset/Autopilot/Machine1/listInitialization_Machine1.c", "C", 4, 0, 0, 0, 0, 0, 4
"/Users/sbukhari/Sandbox/CProgram/ASTanalysis/Dataset/Autopilot/Machine1/printList_Machine1.c", "C", 18, 0, 0, 0, 0, 0, 18
"/Users/sbukhari/Sandbox/CProgram/ASTanalysis/Dataset/Autopilot/Machine1/removeItem_Machine1.c", "C", 27, 0, 0, 0, 4, 0, 31
"/Users/sbukhari/Sandbox/CProgram/ASTanalysis/Dataset/Autopilot/Machine1/save_Machine1.c", "C", 19, 0, 0, 0, 5, 0, 24
"/Users/sbukhari/Sandbox/CProgram/ASTanalysis/Dataset/Autopilot/Machine1/swapItem_Machine1.c", "C", 39, 0, 0, 0, 4, 0, 43
"/Users/sbukhari/Sandbox/CProgram/ASTanalysis/Dataset/Autopilot/Machine1/updateItem_Machine1.c", "C", 25, 0, 0, 0, 4, 0, 29
"/Users/sbukhari/Sandbox/CProgram/ASTanalysis/Dataset/Autopilot/Machine10/addItem_Machine10.c", "C", 46, 0, 0, 0, 0, 0, 46
"/Users/sbukhari/Sandbox/CProgram/ASTanalysis/Dataset/Autopilot/Machine10/costSum_Machine10.c", "C", 13, 0, 0, 0, 0, 0, 13
"/Users/sbukhari/Sandbox/CProgram/ASTanalysis/Dataset/Autopilot/Machine10/deduplicate_Machine10.c", "C", 22, 0, 0, 0, 0, 0, 22
"/Users/sbukhari/Sandbox/CProgram/ASTanalysis/Dataset/Autopilot/Machine10/highestPrice_Machine10.c", "C", 18, 0, 0, 0, 0, 0, 18
"/Users/sbukhari/Sandbox/CProgram/ASTanalysis/Dataset/Autopilot/Machine10/itemToString_Machine10.c", "C", 18, 0, 0, 0, 0, 0, 18
"/Users/sbukhari/Sandbox/CProgram/ASTanalysis/Dataset/Autopilot/Machine10/listInitialization_Machine10.c", "C", 12, 0, 0, 0, 0, 0, 12
"/Users/sbukhari/Sandbox/CProgram/ASTanalysis/Dataset/Autopilot/Machine10/load_Machine10.c", "C", 30, 0, 0, 0, 0, 0, 30
"/Users/sbukhari/Sandbox/CProgram/ASTanalysis/Dataset/Autopilot/Machine10/printList_Machine10.c", "C", 20, 0, 0, 0, 0, 0, 20
"/Users/sbukhari/Sandbox/CProgram/ASTanalysis/Dataset/Autopilot/Machine10/removeItem_Machine10.c", "C", 25, 0, 0, 0, 0, 0, 25
"/Users/sbukhari/Sandbox/CProgram/ASTanalysis/Dataset/Autopilot/Machine10/save_Machine10.c", "C", 22, 0, 0, 0, 0, 0, 22
"/Users/sbukhari/Sandbox/CProgram/ASTanalysis/Dataset/Autopilot/Machine10/swapItem_Machine10.c", "C", 45, 0, 0, 0, 0, 0, 45
"/Users/sbukhari/Sandbox/CProgram/ASTanalysis/Dataset/Autopilot/Machine10/updateItem_Machine10.c", "C", 24, 0, 0, 0, 0, 0, 24
"/Users/sbukhari/Sandbox/CProgram/ASTanalysis/Dataset/Autopilot/Machine11/addItem_Machine11.c", "C", 33, 0, 0, 0, 0, 3, 36
"/Users/sbukhari/Sandbox/CProgram/ASTanalysis/Dataset/Autopilot/Machine11/costSum_Machine11.c", "C", 13, 0, 0, 0, 0, 1, 14
"/Users/sbukhari/Sandbox/CProgram/ASTanalysis/Dataset/Autopilot/Machine11/deduplicate_Machine11.c", "C", 23, 0, 0, 0, 0, 1, 24
"/Users/sbukhari/Sandbox/CProgram/ASTanalysis/Dataset/Autopilot/Machine11/highestPrice_Machine11.c", "C", 17, 0, 0, 0, 0, 1, 18
"/Users/sbukhari/Sandbox/CProgram/ASTanalysis/Dataset/Autopilot/Machine11/itemToString_Machine11.c", "C", 4, 0, 0, 0, 0, 0, 4
"/Users/sbukhari/Sandbox/CProgram/ASTanalysis/Dataset/Autopilot/Machine11/listInitialization_Machine11.c", "C", 4, 0, 0, 0, 0, 0, 4
"/Users/sbukhari/Sandbox/CProgram/ASTanalysis/Dataset/Autopilot/Machine11/load_Machine11.c", "C", 18, 0, 0, 0, 0, 1, 19
"/Users/sbukhari/Sandbox/CProgram/ASTanalysis/Dataset/Autopilot/Machine11/printList_Machine11.c", "C", 11, 0, 0, 0, 0, 0, 11
"/Users/sbukhari/Sandbox/CProgram/ASTanalysis/Dataset/Autopilot/Machine11/removeItem_Machine11.c", "C", 24, 0, 0, 0, 0, 1, 25
"/Users/sbukhari/Sandbox/CProgram/ASTanalysis/Dataset/Autopilot/Machine11/save_Machine11.c", "C", 16, 0, 0, 0, 0, 1, 17
"/Users/sbukhari/Sandbox/CProgram/ASTanalysis/Dataset/Autopilot/Machine11/swapItem_Machine11.c", "C", 50, 0, 0, 0, 0, 6, 56
"/Users/sbukhari/Sandbox/CProgram/ASTanalysis/Dataset/Autopilot/Machine11/updateItem_Machine11.c", "C", 16, 0, 0, 0, 0, 0, 16
"/Users/sbukhari/Sandbox/CProgram/ASTanalysis/Dataset/Autopilot/Machine12/addItem_Machine12.c", "C", 31, 0, 0, 0, 0, 0, 31
"/Users/sbukhari/Sandbox/CProgram/ASTanalysis/Dataset/Autopilot/Machine12/costSum_Machine12.c", "C", 12, 0, 0, 0, 0, 0, 12
"/Users/sbukhari/Sandbox/CProgram/ASTanalysis/Dataset/Autopilot/Machine12/deduplicate_Machine12.c", "C", 32, 0, 0, 0, 0, 0, 32
"/Users/sbukhari/Sandbox/CProgram/ASTanalysis/Dataset/Autopilot/Machine12/highestPrice_Machine12.c", "C", 19, 0, 0, 0, 0, 0, 19
"/Users/sbukhari/Sandbox/CProgram/ASTanalysis/Dataset/Autopilot/Machine12/itemToString_Machine12.c", "C", 7, 0, 0, 0, 0, 0, 7
"/Users/sbukhari/Sandbox/CProgram/ASTanalysis/Dataset/Autopilot/Machine12/listInitialization_Machine12.c", "C", 4, 0, 0, 0, 0, 0, 4
"/Users/sbukhari/Sandbox/CProgram/ASTanalysis/Dataset/Autopilot/Machine12/load_Machine12.c", "C", 38, 0, 0, 0, 0, 0, 38
"/Users/sbukhari/Sandbox/CProgram/ASTanalysis/Dataset/Autopilot/Machine12/printList_Machine12.c", "C", 14, 0, 0, 0, 0, 0, 14
"/Users/sbukhari/Sandbox/CProgram/ASTanalysis/Dataset/Autopilot/Machine12/removeItem_Machine12.c", "C", 25, 0, 0, 0, 0, 0, 25
"/Users/sbukhari/Sandbox/CProgram/ASTanalysis/Dataset/Autopilot/Machine12/save_Machine12.c", "C", 17, 0, 0, 0, 0, 0, 17
"/Users/sbukhari/Sandbox/CProgram/ASTanalysis/Dataset/Autopilot/Machine12/swapItem_Machine12.c", "C", 36, 0, 0, 0, 0, 0, 36
"/Users/sbukhari/Sandbox/CProgram/ASTanalysis/Dataset/Autopilot/Machine12/updateItem_Machine12.c", "C", 19, 0, 0, 0, 0, 0, 19
"/Users/sbukhari/Sandbox/CProgram/ASTanalysis/Dataset/Autopilot/Machine13/addItem_Machine13.c", "C", 29, 0, 0, 0, 0, 0, 29
"/Users/sbukhari/Sandbox/CProgram/ASTanalysis/Dataset/Autopilot/Machine13/costSum_Machine13.c", "C", 8, 0, 0, 0, 0, 0, 8
"/Users/sbukhari/Sandbox/CProgram/ASTanalysis/Dataset/Autopilot/Machine13/deduplicate_Machine13.c", "C", 21, 0, 0, 0, 0, 0, 21
"/Users/sbukhari/Sandbox/CProgram/ASTanalysis/Dataset/Autopilot/Machine13/highestPrice_Machine13.c", "C", 15, 0, 0, 0, 0, 0, 15
"/Users/sbukhari/Sandbox/CProgram/ASTanalysis/Dataset/Autopilot/Machine13/itemToString_Machine13.c", "C", 7, 0, 0, 0, 0, 0, 7
"/Users/sbukhari/Sandbox/CProgram/ASTanalysis/Dataset/Autopilot/Machine13/listInitialization_Machine13.c", "C", 4, 0, 0, 0, 0, 0, 4
"/Users/sbukhari/Sandbox/CProgram/ASTanalysis/Dataset/Autopilot/Machine13/load_Machine13.c", "C", 16, 0, 0, 0, 0, 0, 16
"/Users/sbukhari/Sandbox/CProgram/ASTanalysis/Dataset/Autopilot/Machine13/printList_Machine13.c", "C", 11, 0, 0, 0, 0, 0, 11
"/Users/sbukhari/Sandbox/CProgram/ASTanalysis/Dataset/Autopilot/Machine13/removeItem_Machine13.c", "C", 20, 0, 0, 0, 0, 0, 20
"/Users/sbukhari/Sandbox/CProgram/ASTanalysis/Dataset/Autopilot/Machine13/save_Machine13.c", "C", 13, 0, 0, 0, 0, 0, 13
"/Users/sbukhari/Sandbox/CProgram/ASTanalysis/Dataset/Autopilot/Machine13/swapItem_Machine13.c", "C", 54, 0, 0, 0, 0, 0, 54
"/Users/sbukhari/Sandbox/CProgram/ASTanalysis/Dataset/Autopilot/Machine13/updateItem_Machine13.c", "C", 18, 0, 0, 0, 0, 0, 18
"/Users/sbukhari/Sandbox/CProgram/ASTanalysis/Dataset/Autopilot/Machine14/addItem_Machine14.c", "C", 33, 0, 0, 0, 0, 0, 33
"/Users/sbukhari/Sandbox/CProgram/ASTanalysis/Dataset/Autopilot/Machine14/costSum_Machine14.c", "C", 13, 0, 0, 0, 0, 0, 13
"/Users/sbukhari/Sandbox/CProgram/ASTanalysis/Dataset/Autopilot/Machine14/deduplicate_Machine14.c", "C", 19, 0, 0, 0, 0, 0, 19
"/Users/sbukhari/Sandbox/CProgram/ASTanalysis/Dataset/Autopilot/Machine14/highestPrice_Machine14.c", "C", 19, 0, 0, 0, 0, 0, 19
"/Users/sbukhari/Sandbox/CProgram/ASTanalysis/Dataset/Autopilot/Machine14/itemToString_Machine14.c", "C", 7, 0, 0, 0, 0, 0, 7
"/Users/sbukhari/Sandbox/CProgram/ASTanalysis/Dataset/Autopilot/Machine14/listInitialization_Machine14.c", "C", 9, 0, 0, 0, 0, 0, 9
"/Users/sbukhari/Sandbox/CProgram/ASTanalysis/Dataset/Autopilot/Machine14/load_Machine14.c", "C", 23, 0, 0, 0, 0, 0, 23
"/Users/sbukhari/Sandbox/CProgram/ASTanalysis/Dataset/Autopilot/Machine14/printList_Machine14.c", "C", 14, 0, 0, 0, 0, 0, 14
"/Users/sbukhari/Sandbox/CProgram/ASTanalysis/Dataset/Autopilot/Machine14/removeItem_Machine14.c", "C", 22, 0, 0, 0, 0, 0, 22
"/Users/sbukhari/Sandbox/CProgram/ASTanalysis/Dataset/Autopilot/Machine14/save_Machine14.c", "C", 13, 0, 0, 0, 0, 0, 13
"/Users/sbukhari/Sandbox/CProgram/ASTanalysis/Dataset/Autopilot/Machine14/swapItem_Machine14.c", "C", 33, 0, 0, 0, 0, 0, 33
"/Users/sbukhari/Sandbox/CProgram/ASTanalysis/Dataset/Autopilot/Machine14/updateItem_Machine14.c", "C", 21, 0, 0, 0, 0, 0, 21
"/Users/sbukhari/Sandbox/CProgram/ASTanalysis/Dataset/Autopilot/Machine15/addItem_Machine15.c", "C", 34, 0, 0, 0, 3, 6, 43
"/Users/sbukhari/Sandbox/CProgram/ASTanalysis/Dataset/Autopilot/Machine15/costSum_Machine15.c", "C", 13, 0, 0, 0, 2, 4, 19
"/Users/sbukhari/Sandbox/CProgram/ASTanalysis/Dataset/Autopilot/Machine15/deduplicate_Machine15.c", "C", 3, 0, 0, 0, 2, 0, 5
"/Users/sbukhari/Sandbox/CProgram/ASTanalysis/Dataset/Autopilot/Machine15/highestPrice_Machine15.c", "C", 16, 0, 0, 0, 2, 4, 22
"/Users/sbukhari/Sandbox/CProgram/ASTanalysis/Dataset/Autopilot/Machine15/itemToString_Machine15.c", "C", 18, 0, 0, 0, 3, 8, 29
"/Users/sbukhari/Sandbox/CProgram/ASTanalysis/Dataset/Autopilot/Machine15/listInitialization_Machine15.c", "C", 4, 0, 0, 0, 0, 0, 4
"/Users/sbukhari/Sandbox/CProgram/ASTanalysis/Dataset/Autopilot/Machine15/printList_Machine15.c", "C", 12, 0, 0, 0, 0, 1, 13
"/Users/sbukhari/Sandbox/CProgram/ASTanalysis/Dataset/Autopilot/Machine15/removeItem_Machine15.c", "C", 21, 0, 0, 0, 3, 6, 30
"/Users/sbukhari/Sandbox/CProgram/ASTanalysis/Dataset/Autopilot/Machine15/save_Machine15.c", "C", 15, 0, 0, 0, 3, 5, 23
"/Users/sbukhari/Sandbox/CProgram/ASTanalysis/Dataset/Autopilot/Machine15/swapItem_Machine15.c", "C", 26, 0, 0, 0, 3, 8, 37
"/Users/sbukhari/Sandbox/CProgram/ASTanalysis/Dataset/Autopilot/Machine15/updateItem_Machine15.c", "C", 15, 0, 0, 0, 2, 5, 22
"/Users/sbukhari/Sandbox/CProgram/ASTanalysis/Dataset/Autopilot/Machine16/addItem_Machine16.c", "C", 31, 0, 0, 0, 5, 5, 41
"/Users/sbukhari/Sandbox/CProgram/ASTanalysis/Dataset/Autopilot/Machine16/itemToString_Machine16.c", "C", 18, 0, 0, 0, 3, 3, 24
"/Users/sbukhari/Sandbox/CProgram/ASTanalysis/Dataset/Autopilot/Machine16/listInitialization_Machine16.c", "C", 4, 0, 0, 0, 0, 0, 4
"/Users/sbukhari/Sandbox/CProgram/ASTanalysis/Dataset/Autopilot/Machine16/printList_Machine16.c", "C", 18, 0, 0, 0, 3, 3, 24
"/Users/sbukhari/Sandbox/CProgram/ASTanalysis/Dataset/Autopilot/Machine16/removeItem_Machine16.c", "C", 25, 0, 0, 0, 4, 3, 32
"/Users/sbukhari/Sandbox/CProgram/ASTanalysis/Dataset/Autopilot/Machine16/updateItem_Machine16.c", "C", 23, 0, 0, 0, 4, 3, 30
"/Users/sbukhari/Sandbox/CProgram/ASTanalysis/Dataset/Autopilot/Machine17/addItem_Machine17.c", "C", 33, 0, 0, 0, 0, 0, 33
"/Users/sbukhari/Sandbox/CProgram/ASTanalysis/Dataset/Autopilot/Machine17/costSum_Machine17.c", "C", 13, 0, 0, 0, 0, 0, 13
"/Users/sbukhari/Sandbox/CProgram/ASTanalysis/Dataset/Autopilot/Machine17/deduplicate_Machine17.c", "C", 26, 0, 0, 0, 0, 0, 26
"/Users/sbukhari/Sandbox/CProgram/ASTanalysis/Dataset/Autopilot/Machine17/highestPrice_Machine17.c", "C", 17, 0, 0, 0, 0, 0, 17
"/Users/sbukhari/Sandbox/CProgram/ASTanalysis/Dataset/Autopilot/Machine17/itemToString_Machine17.c", "C", 11, 0, 0, 0, 0, 0, 11
"/Users/sbukhari/Sandbox/CProgram/ASTanalysis/Dataset/Autopilot/Machine17/listInitialization_Machine17.c", "C", 13, 0, 0, 0, 0, 0, 13
"/Users/sbukhari/Sandbox/CProgram/ASTanalysis/Dataset/Autopilot/Machine17/load_Machine17.c", "C", 24, 0, 0, 0, 0, 0, 24
"/Users/sbukhari/Sandbox/CProgram/ASTanalysis/Dataset/Autopilot/Machine17/printList_Machine17.c", "C", 15, 0, 0, 0, 0, 0, 15
"/Users/sbukhari/Sandbox/CProgram/ASTanalysis/Dataset/Autopilot/Machine17/removeItem_Machine17.c", "C", 25, 0, 0, 0, 0, 0, 25
"/Users/sbukhari/Sandbox/CProgram/ASTanalysis/Dataset/Autopilot/Machine17/save_Machine17.c", "C", 14, 0, 0, 0, 0, 0, 14
"/Users/sbukhari/Sandbox/CProgram/ASTanalysis/Dataset/Autopilot/Machine17/swapItem_Machine17.c", "C", 39, 0, 0, 0, 0, 0, 39
"/Users/sbukhari/Sandbox/CProgram/ASTanalysis/Dataset/Autopilot/Machine17/updateItem_Machine17.c", "C", 19, 0, 0, 0, 0, 0, 19
"/Users/sbukhari/Sandbox/CProgram/ASTanalysis/Dataset/Autopilot/Machine18/addItem_Machine18.c", "C", 20, 0, 0, 0, 0, 0, 20
"/Users/sbukhari/Sandbox/CProgram/ASTanalysis/Dataset/Autopilot/Machine18/costSum_Machine18.c", "C", 14, 0, 0, 0, 0, 0, 14
"/Users/sbukhari/Sandbox/CProgram/ASTanalysis/Dataset/Autopilot/Machine18/deduplicate_Machine18.c", "C", 22, 0, 0, 0, 0, 0, 22
"/Users/sbukhari/Sandbox/CProgram/ASTanalysis/Dataset/Autopilot/Machine18/highestPrice_Machine18.c", "C", 18, 0, 0, 0, 0, 0, 18
"/Users/sbukhari/Sandbox/CProgram/ASTanalysis/Dataset/Autopilot/Machine18/itemToString_Machine18.c", "C", 8, 0, 0, 0, 0, 0, 8
"/Users/sbukhari/Sandbox/CProgram/ASTanalysis/Dataset/Autopilot/Machine18/listInitialization_Machine18.c", "C", 4, 0, 0, 0, 0, 0, 4
"/Users/sbukhari/Sandbox/CProgram/ASTanalysis/Dataset/Autopilot/Machine18/printList_Machine18.c", "C", 15, 0, 0, 0, 0, 0, 15
"/Users/sbukhari/Sandbox/CProgram/ASTanalysis/Dataset/Autopilot/Machine18/removeItem_Machine18.c", "C", 23, 0, 0, 0, 0, 0, 23
"/Users/sbukhari/Sandbox/CProgram/ASTanalysis/Dataset/Autopilot/Machine18/save_Machine18.c", "C", 19, 0, 0, 0, 0, 0, 19
"/Users/sbukhari/Sandbox/CProgram/ASTanalysis/Dataset/Autopilot/Machine18/swapItem_Machine18.c", "C", 28, 0, 0, 0, 0, 0, 28
"/Users/sbukhari/Sandbox/CProgram/ASTanalysis/Dataset/Autopilot/Machine18/updateItem_Machine18.c", "C", 20, 0, 0, 0, 0, 0, 20
"/Users/sbukhari/Sandbox/CProgram/ASTanalysis/Dataset/Autopilot/Machine19/addItem_Machine19.c", "C", 45, 0, 0, 0, 1, 8, 54
"/Users/sbukhari/Sandbox/CProgram/ASTanalysis/Dataset/Autopilot/Machine19/costSum_Machine19.c", "C", 13, 0, 0, 0, 0, 2, 15
"/Users/sbukhari/Sandbox/CProgram/ASTanalysis/Dataset/Autopilot/Machine19/deduplicate_Machine19.c", "C", 27, 0, 0, 0, 0, 4, 31
"/Users/sbukhari/Sandbox/CProgram/ASTanalysis/Dataset/Autopilot/Machine19/highestPrice_Machine19.c", "C", 17, 0, 0, 0, 0, 2, 19
"/Users/sbukhari/Sandbox/CProgram/ASTanalysis/Dataset/Autopilot/Machine19/itemToString_Machine19.c", "C", 15, 0, 0, 0, 0, 1, 16
"/Users/sbukhari/Sandbox/CProgram/ASTanalysis/Dataset/Autopilot/Machine19/listInitialization_Machine19.c", "C", 7, 0, 0, 0, 0, 1, 8
"/Users/sbukhari/Sandbox/CProgram/ASTanalysis/Dataset/Autopilot/Machine19/printList_Machine19.c", "C", 15, 0, 0, 0, 0, 2, 17
"/Users/sbukhari/Sandbox/CProgram/ASTanalysis/Dataset/Autopilot/Machine19/removeItem_Machine19.c", "C", 40, 0, 0, 0, 0, 4, 44
"/Users/sbukhari/Sandbox/CProgram/ASTanalysis/Dataset/Autopilot/Machine19/save_Machine19.c", "C", 16, 0, 0, 0, 0, 3, 19
"/Users/sbukhari/Sandbox/CProgram/ASTanalysis/Dataset/Autopilot/Machine19/swapItem_Machine19.c", "C", 33, 0, 0, 0, 0, 4, 37
"/Users/sbukhari/Sandbox/CProgram/ASTanalysis/Dataset/Autopilot/Machine19/updateItem_Machine19.c", "C", 31, 0, 0, 0, 0, 3, 34
"/Users/sbukhari/Sandbox/CProgram/ASTanalysis/Dataset/Autopilot/Machine2/addItem_Machine2.c", "C", 34, 0, 0, 0, 9, 8, 51
"/Users/sbukhari/Sandbox/CProgram/ASTanalysis/Dataset/Autopilot/Machine2/costSum_Machine2.c", "C", 15, 0, 0, 0, 5, 4, 24
"/Users/sbukhari/Sandbox/CProgram/ASTanalysis/Dataset/Autopilot/Machine2/deduplicate_Machine2.c", "C", 18, 0, 0, 0, 4, 4, 26
"/Users/sbukhari/Sandbox/CProgram/ASTanalysis/Dataset/Autopilot/Machine2/highestPrice_Machine2.c", "C", 17, 0, 0, 0, 4, 3, 24
"/Users/sbukhari/Sandbox/CProgram/ASTanalysis/Dataset/Autopilot/Machine2/itemToString_Machine2.c", "C", 16, 0, 0, 0, 6, 5, 27
"/Users/sbukhari/Sandbox/CProgram/ASTanalysis/Dataset/Autopilot/Machine2/listInitialization_Machine2.c", "C", 14, 0, 0, 0, 5, 4, 23
"/Users/sbukhari/Sandbox/CProgram/ASTanalysis/Dataset/Autopilot/Machine2/printList_Machine2.c", "C", 20, 0, 0, 0, 8, 6, 34
"/Users/sbukhari/Sandbox/CProgram/ASTanalysis/Dataset/Autopilot/Machine2/removeItem_Machine2.c", "C", 30, 0, 0, 0, 7, 7, 44
"/Users/sbukhari/Sandbox/CProgram/ASTanalysis/Dataset/Autopilot/Machine2/save_Machine2.c", "C", 16, 0, 0, 0, 7, 6, 29
"/Users/sbukhari/Sandbox/CProgram/ASTanalysis/Dataset/Autopilot/Machine2/swapItem_Machine2.c", "C", 27, 0, 0, 0, 7, 6, 40
"/Users/sbukhari/Sandbox/CProgram/ASTanalysis/Dataset/Autopilot/Machine2/updateItem_Machine2.c", "C", 29, 0, 0, 0, 9, 8, 46
"/Users/sbukhari/Sandbox/CProgram/ASTanalysis/Dataset/Autopilot/Machine20/addItem_Machine20.c", "C", 28, 0, 0, 0, 0, 0, 28
"/Users/sbukhari/Sandbox/CProgram/ASTanalysis/Dataset/Autopilot/Machine20/costSum_Machine20.c", "C", 14, 0, 0, 0, 0, 0, 14
"/Users/sbukhari/Sandbox/CProgram/ASTanalysis/Dataset/Autopilot/Machine20/deduplicate_Machine20.c", "C", 25, 0, 0, 0, 0, 0, 25
"/Users/sbukhari/Sandbox/CProgram/ASTanalysis/Dataset/Autopilot/Machine20/highestPrice_Machine20.c", "C", 20, 0, 0, 0, 0, 0, 20
"/Users/sbukhari/Sandbox/CProgram/ASTanalysis/Dataset/Autopilot/Machine20/itemToString_Machine20.c", "C", 8, 0, 0, 0, 0, 0, 8
"/Users/sbukhari/Sandbox/CProgram/ASTanalysis/Dataset/Autopilot/Machine20/listInitialization_Machine20.c", "C", 13, 0, 0, 0, 0, 0, 13
"/Users/sbukhari/Sandbox/CProgram/ASTanalysis/Dataset/Autopilot/Machine20/printList_Machine20.c", "C", 16, 0, 0, 0, 0, 0, 16
"/Users/sbukhari/Sandbox/CProgram/ASTanalysis/Dataset/Autopilot/Machine20/removeItem_Machine20.c", "C", 23, 0, 0, 0, 0, 0, 23
"/Users/sbukhari/Sandbox/CProgram/ASTanalysis/Dataset/Autopilot/Machine20/save_Machine20.c", "C", 16, 0, 0, 0, 0, 0, 16
"/Users/sbukhari/Sandbox/CProgram/ASTanalysis/Dataset/Autopilot/Machine20/swapItem_Machine20.c", "C", 41, 0, 0, 0, 0, 0, 41
"/Users/sbukhari/Sandbox/CProgram/ASTanalysis/Dataset/Autopilot/Machine20/updateItem_Machine20.c", "C", 16, 0, 0, 0, 0, 0, 16
"/Users/sbukhari/Sandbox/CProgram/ASTanalysis/Dataset/Autopilot/Machine21/addItem_Machine21.c", "C", 24, 0, 0, 0, 0, 0, 24
"/Users/sbukhari/Sandbox/CProgram/ASTanalysis/Dataset/Autopilot/Machine21/costSum_Machine21.c", "C", 10, 0, 0, 0, 0, 0, 10
"/Users/sbukhari/Sandbox/CProgram/ASTanalysis/Dataset/Autopilot/Machine21/deduplicate_Machine21.c", "C", 16, 0, 0, 0, 1, 0, 17
"/Users/sbukhari/Sandbox/CProgram/ASTanalysis/Dataset/Autopilot/Machine21/highestPrice_Machine21.c", "C", 16, 0, 0, 0, 0, 0, 16
"/Users/sbukhari/Sandbox/CProgram/ASTanalysis/Dataset/Autopilot/Machine21/itemToString_Machine21.c", "C", 14, 0, 0, 0, 0, 1, 15
"/Users/sbukhari/Sandbox/CProgram/ASTanalysis/Dataset/Autopilot/Machine21/listInitialization_Machine21.c", "C", 4, 0, 0, 0, 0, 0, 4
"/Users/sbukhari/Sandbox/CProgram/ASTanalysis/Dataset/Autopilot/Machine21/load_Machine21.c", "C", 43, 0, 0, 0, 0, 0, 43
"/Users/sbukhari/Sandbox/CProgram/ASTanalysis/Dataset/Autopilot/Machine21/printList_Machine21.c", "C", 10, 0, 0, 0, 0, 0, 10
"/Users/sbukhari/Sandbox/CProgram/ASTanalysis/Dataset/Autopilot/Machine21/removeItem_Machine21.c", "C", 21, 0, 0, 0, 0, 0, 21
"/Users/sbukhari/Sandbox/CProgram/ASTanalysis/Dataset/Autopilot/Machine21/save_Machine21.c", "C", 13, 0, 0, 0, 0, 0, 13
"/Users/sbukhari/Sandbox/CProgram/ASTanalysis/Dataset/Autopilot/Machine21/swapItem_Machine21.c", "C", 35, 0, 0, 0, 0, 0, 35
"/Users/sbukhari/Sandbox/CProgram/ASTanalysis/Dataset/Autopilot/Machine21/updateItem_Machine21.c", "C", 15, 0, 0, 0, 0, 0, 15
"/Users/sbukhari/Sandbox/CProgram/ASTanalysis/Dataset/Autopilot/Machine22/addItem_Machine22.c", "C", 21, 0, 0, 0, 0, 2, 23
"/Users/sbukhari/Sandbox/CProgram/ASTanalysis/Dataset/Autopilot/Machine22/costSum_Machine22.c", "C", 13, 0, 0, 0, 0, 0, 13
"/Users/sbukhari/Sandbox/CProgram/ASTanalysis/Dataset/Autopilot/Machine22/deduplicate_Machine22.c", "C", 25, 0, 0, 0, 0, 0, 25
"/Users/sbukhari/Sandbox/CProgram/ASTanalysis/Dataset/Autopilot/Machine22/highestPrice_Machine22.c", "C", 19, 0, 0, 0, 0, 0, 19
"/Users/sbukhari/Sandbox/CProgram/ASTanalysis/Dataset/Autopilot/Machine22/itemToString_Machine22.c", "C", 14, 0, 0, 0, 0, 1, 15
"/Users/sbukhari/Sandbox/CProgram/ASTanalysis/Dataset/Autopilot/Machine22/listInitialization_Machine22.c", "C", 8, 0, 0, 0, 0, 0, 8
"/Users/sbukhari/Sandbox/CProgram/ASTanalysis/Dataset/Autopilot/Machine22/load_Machine22.c", "C", 26, 0, 0, 0, 0, 0, 26
"/Users/sbukhari/Sandbox/CProgram/ASTanalysis/Dataset/Autopilot/Machine22/printList_Machine22.c", "C", 16, 0, 0, 0, 0, 0, 16
"/Users/sbukhari/Sandbox/CProgram/ASTanalysis/Dataset/Autopilot/Machine22/removeItem_Machine22.c", "C", 18, 0, 0, 0, 0, 2, 20
"/Users/sbukhari/Sandbox/CProgram/ASTanalysis/Dataset/Autopilot/Machine22/save_Machine22.c", "C", 16, 0, 0, 0, 0, 0, 16
"/Users/sbukhari/Sandbox/CProgram/ASTanalysis/Dataset/Autopilot/Machine22/swapItem_Machine22.c", "C", 29, 0, 0, 0, 0, 4, 33
"/Users/sbukhari/Sandbox/CProgram/ASTanalysis/Dataset/Autopilot/Machine22/updateItem_Machine22.c", "C", 18, 0, 0, 0, 0, 2, 20
"/Users/sbukhari/Sandbox/CProgram/ASTanalysis/Dataset/Autopilot/Machine23/costSum_Machine23.c", "C", 18, 0, 0, 0, 3, 4, 25
"/Users/sbukhari/Sandbox/CProgram/ASTanalysis/Dataset/Autopilot/Machine23/deduplicate_Machine23.c", "C", 24, 0, 0, 0, 2, 2, 28
"/Users/sbukhari/Sandbox/CProgram/ASTanalysis/Dataset/Autopilot/Machine23/itemToString_Machine23.c", "C", 34, 0, 0, 0, 10, 10, 54
"/Users/sbukhari/Sandbox/CProgram/ASTanalysis/Dataset/Autopilot/Machine23/listInitialization_Machine23.c", "C", 12, 0, 0, 0, 2, 2, 16
"/Users/sbukhari/Sandbox/CProgram/ASTanalysis/Dataset/Autopilot/Machine23/load_Machine23.c", "C", 32, 0, 0, 0, 4, 4, 40
"/Users/sbukhari/Sandbox/CProgram/ASTanalysis/Dataset/Autopilot/Machine23/printList_Machine23.c", "C", 16, 0, 0, 0, 2, 3, 21
"/Users/sbukhari/Sandbox/CProgram/ASTanalysis/Dataset/Autopilot/Machine23/save_Machine23.c", "C", 22, 0, 0, 0, 3, 5, 30
"/Users/sbukhari/Sandbox/CProgram/ASTanalysis/Dataset/Autopilot/Machine24/itemToString_Machine24.c", "C", 13, 0, 0, 0, 3, 3, 19
"/Users/sbukhari/Sandbox/CProgram/ASTanalysis/Dataset/Autopilot/Machine24/listInitialization_Machine24.c", "C", 8, 0, 0, 0, 1, 1, 10
"/Users/sbukhari/Sandbox/CProgram/ASTanalysis/Dataset/Autopilot/Machine24/load_Machine24.c", "C", 35, 0, 0, 0, 6, 5, 46
"/Users/sbukhari/Sandbox/CProgram/ASTanalysis/Dataset/Autopilot/Machine24/printList_Machine24.c", "C", 16, 0, 0, 0, 2, 2, 20
"/Users/sbukhari/Sandbox/CProgram/ASTanalysis/Dataset/Autopilot/Machine24/save_Machine24.c", "C", 16, 0, 0, 0, 1, 3, 20
"/Users/sbukhari/Sandbox/CProgram/ASTanalysis/Dataset/Autopilot/Machine25/addItem_Machine25.c", "C", 23, 0, 0, 0, 0, 0, 23
"/Users/sbukhari/Sandbox/CProgram/ASTanalysis/Dataset/Autopilot/Machine25/costSum_Machine25.c", "C", 9, 0, 0, 0, 0, 0, 9
"/Users/sbukhari/Sandbox/CProgram/ASTanalysis/Dataset/Autopilot/Machine25/deduplicate_Machine25.c", "C", 18, 0, 0, 0, 0, 0, 18
"/Users/sbukhari/Sandbox/CProgram/ASTanalysis/Dataset/Autopilot/Machine25/highestPrice_Machine25.c", "C", 12, 0, 0, 0, 0, 0, 12
"/Users/sbukhari/Sandbox/CProgram/ASTanalysis/Dataset/Autopilot/Machine25/itemToString_Machine25.c", "C", 12, 0, 0, 0, 0, 1, 13
"/Users/sbukhari/Sandbox/CProgram/ASTanalysis/Dataset/Autopilot/Machine25/listInitialization_Machine25.c", "C", 4, 0, 0, 0, 0, 0, 4
"/Users/sbukhari/Sandbox/CProgram/ASTanalysis/Dataset/Autopilot/Machine25/load_Machine25.c", "C", 35, 0, 0, 0, 0, 0, 35
"/Users/sbukhari/Sandbox/CProgram/ASTanalysis/Dataset/Autopilot/Machine25/printList_Machine25.c", "C", 12, 0, 0, 0, 0, 0, 12
"/Users/sbukhari/Sandbox/CProgram/ASTanalysis/Dataset/Autopilot/Machine25/removeItem_Machine25.c", "C", 23, 0, 0, 0, 0, 0, 23
"/Users/sbukhari/Sandbox/CProgram/ASTanalysis/Dataset/Autopilot/Machine25/save_Machine25.c", "C", 13, 0, 0, 0, 0, 0, 13
"/Users/sbukhari/Sandbox/CProgram/ASTanalysis/Dataset/Autopilot/Machine25/swapItem_Machine25.c", "C", 44, 0, 0, 0, 0, 0, 44
"/Users/sbukhari/Sandbox/CProgram/ASTanalysis/Dataset/Autopilot/Machine25/updateItem_Machine25.c", "C", 18, 0, 0, 0, 0, 0, 18
"/Users/sbukhari/Sandbox/CProgram/ASTanalysis/Dataset/Autopilot/Machine26/addItem_Machine26.c", "C", 25, 0, 0, 0, 0, 0, 25
"/Users/sbukhari/Sandbox/CProgram/ASTanalysis/Dataset/Autopilot/Machine26/costSum_Machine26.c", "C", 11, 0, 0, 0, 0, 0, 11
"/Users/sbukhari/Sandbox/CProgram/ASTanalysis/Dataset/Autopilot/Machine26/deduplicate_Machine26.c", "C", 20, 0, 0, 0, 0, 0, 20
"/Users/sbukhari/Sandbox/CProgram/ASTanalysis/Dataset/Autopilot/Machine26/highestPrice_Machine26.c", "C", 19, 0, 0, 0, 0, 0, 19
"/Users/sbukhari/Sandbox/CProgram/ASTanalysis/Dataset/Autopilot/Machine26/itemToString_Machine26.c", "C", 11, 0, 0, 0, 0, 0, 11
"/Users/sbukhari/Sandbox/CProgram/ASTanalysis/Dataset/Autopilot/Machine26/listInitialization_Machine26.c", "C", 4, 0, 0, 0, 0, 0, 4
"/Users/sbukhari/Sandbox/CProgram/ASTanalysis/Dataset/Autopilot/Machine26/load_Machine26.c", "C", 46, 0, 0, 0, 0, 0, 46
"/Users/sbukhari/Sandbox/CProgram/ASTanalysis/Dataset/Autopilot/Machine26/printList_Machine26.c", "C", 14, 0, 0, 0, 0, 0, 14
"/Users/sbukhari/Sandbox/CProgram/ASTanalysis/Dataset/Autopilot/Machine26/removeItem_Machine26.c", "C", 20, 0, 0, 0, 0, 0, 20
"/Users/sbukhari/Sandbox/CProgram/ASTanalysis/Dataset/Autopilot/Machine26/save_Machine26.c", "C", 12, 0, 0, 0, 0, 0, 12
"/Users/sbukhari/Sandbox/CProgram/ASTanalysis/Dataset/Autopilot/Machine26/swapItem_Machine26.c", "C", 33, 0, 0, 0, 0, 0, 33
"/Users/sbukhari/Sandbox/CProgram/ASTanalysis/Dataset/Autopilot/Machine26/updateItem_Machine26.c", "C", 21, 0, 0, 0, 0, 0, 21
"/Users/sbukhari/Sandbox/CProgram/ASTanalysis/Dataset/Autopilot/Machine27/addItem_Machine27.c", "C", 24, 0, 0, 0, 0, 1, 25
"/Users/sbukhari/Sandbox/CProgram/ASTanalysis/Dataset/Autopilot/Machine27/costSum_Machine27.c", "C", 11, 0, 0, 0, 0, 0, 11
"/Users/sbukhari/Sandbox/CProgram/ASTanalysis/Dataset/Autopilot/Machine27/deduplicate_Machine27.c", "C", 36, 0, 0, 0, 0, 0, 36
"/Users/sbukhari/Sandbox/CProgram/ASTanalysis/Dataset/Autopilot/Machine27/highestPrice_Machine27.c", "C", 18, 0, 0, 0, 0, 0, 18
"/Users/sbukhari/Sandbox/CProgram/ASTanalysis/Dataset/Autopilot/Machine27/itemToString_Machine27.c", "C", 10, 0, 0, 0, 0, 0, 10
"/Users/sbukhari/Sandbox/CProgram/ASTanalysis/Dataset/Autopilot/Machine27/listInitialization_Machine27.c", "C", 4, 0, 0, 0, 0, 0, 4
"/Users/sbukhari/Sandbox/CProgram/ASTanalysis/Dataset/Autopilot/Machine27/load_Machine27.c", "C", 28, 0, 0, 0, 0, 2, 30
"/Users/sbukhari/Sandbox/CProgram/ASTanalysis/Dataset/Autopilot/Machine27/printList_Machine27.c", "C", 10, 0, 0, 0, 0, 0, 10
"/Users/sbukhari/Sandbox/CProgram/ASTanalysis/Dataset/Autopilot/Machine27/removeItem_Machine27.c", "C", 19, 0, 0, 0, 0, 0, 19
"/Users/sbukhari/Sandbox/CProgram/ASTanalysis/Dataset/Autopilot/Machine27/save_Machine27.c", "C", 12, 0, 0, 0, 0, 1, 13
"/Users/sbukhari/Sandbox/CProgram/ASTanalysis/Dataset/Autopilot/Machine27/swapItem_Machine27.c", "C", 38, 0, 0, 0, 0, 0, 38
"/Users/sbukhari/Sandbox/CProgram/ASTanalysis/Dataset/Autopilot/Machine27/updateItem_Machine27.c", "C", 17, 0, 0, 0, 0, 0, 17
"/Users/sbukhari/Sandbox/CProgram/ASTanalysis/Dataset/Autopilot/Machine28/addItem_Machine28.c", "C", 38, 0, 0, 0, 0, 3, 41
"/Users/sbukhari/Sandbox/CProgram/ASTanalysis/Dataset/Autopilot/Machine28/costSum_Machine28.c", "C", 10, 0, 0, 0, 0, 0, 10
"/Users/sbukhari/Sandbox/CProgram/ASTanalysis/Dataset/Autopilot/Machine28/deduplicate_Machine28.c", "C", 22, 0, 0, 0, 0, 0, 22
"/Users/sbukhari/Sandbox/CProgram/ASTanalysis/Dataset/Autopilot/Machine28/highestPrice_Machine28.c", "C", 16, 0, 0, 0, 0, 0, 16
"/Users/sbukhari/Sandbox/CProgram/ASTanalysis/Dataset/Autopilot/Machine28/itemToString_Machine28.c", "C", 7, 0, 0, 0, 0, 0, 7
"/Users/sbukhari/Sandbox/CProgram/ASTanalysis/Dataset/Autopilot/Machine28/listInitialization_Machine28.c", "C", 7, 0, 0, 0, 0, 0, 7
"/Users/sbukhari/Sandbox/CProgram/ASTanalysis/Dataset/Autopilot/Machine28/load_Machine28.c", "C", 17, 0, 0, 0, 0, 0, 17
"/Users/sbukhari/Sandbox/CProgram/ASTanalysis/Dataset/Autopilot/Machine28/printList_Machine28.c", "C", 13, 0, 0, 0, 0, 0, 13
"/Users/sbukhari/Sandbox/CProgram/ASTanalysis/Dataset/Autopilot/Machine28/removeItem_Machine28.c", "C", 26, 0, 0, 0, 0, 3, 29
"/Users/sbukhari/Sandbox/CProgram/ASTanalysis/Dataset/Autopilot/Machine28/save_Machine28.c", "C", 14, 0, 0, 0, 0, 0, 14
"/Users/sbukhari/Sandbox/CProgram/ASTanalysis/Dataset/Autopilot/Machine28/swapItem_Machine28.c", "C", 48, 0, 0, 0, 0, 5, 53
"/Users/sbukhari/Sandbox/CProgram/ASTanalysis/Dataset/Autopilot/Machine28/updateItem_Machine28.c", "C", 20, 0, 0, 0, 0, 2, 22
"/Users/sbukhari/Sandbox/CProgram/ASTanalysis/Dataset/Autopilot/Machine29/addItem_Machine29.c", "C", 44, 0, 0, 0, 0, 1, 45
"/Users/sbukhari/Sandbox/CProgram/ASTanalysis/Dataset/Autopilot/Machine29/costSum_Machine29.c", "C", 12, 0, 0, 0, 0, 0, 12
"/Users/sbukhari/Sandbox/CProgram/ASTanalysis/Dataset/Autopilot/Machine29/deduplicate_Machine29.c", "C", 18, 0, 0, 0, 0, 0, 18
"/Users/sbukhari/Sandbox/CProgram/ASTanalysis/Dataset/Autopilot/Machine29/highestPrice_Machine29.c", "C", 19, 0, 0, 0, 0, 0, 19
"/Users/sbukhari/Sandbox/CProgram/ASTanalysis/Dataset/Autopilot/Machine29/itemToString_Machine29.c", "C", 12, 0, 0, 0, 0, 0, 12
"/Users/sbukhari/Sandbox/CProgram/ASTanalysis/Dataset/Autopilot/Machine29/listInitialization_Machine29.c", "C", 4, 0, 0, 0, 0, 0, 4
"/Users/sbukhari/Sandbox/CProgram/ASTanalysis/Dataset/Autopilot/Machine29/load_Machine29.c", "C", 37, 0, 0, 0, 1, 1, 39
"/Users/sbukhari/Sandbox/CProgram/ASTanalysis/Dataset/Autopilot/Machine29/printList_Machine29.c", "C", 17, 0, 0, 0, 0, 0, 17
"/Users/sbukhari/Sandbox/CProgram/ASTanalysis/Dataset/Autopilot/Machine29/removeItem_Machine29.c", "C", 29, 0, 0, 0, 0, 1, 30
"/Users/sbukhari/Sandbox/CProgram/ASTanalysis/Dataset/Autopilot/Machine29/save_Machine29.c", "C", 19, 0, 0, 0, 1, 1, 21
"/Users/sbukhari/Sandbox/CProgram/ASTanalysis/Dataset/Autopilot/Machine29/swapItem_Machine29.c", "C", 52, 0, 0, 0, 0, 1, 53
"/Users/sbukhari/Sandbox/CProgram/ASTanalysis/Dataset/Autopilot/Machine29/updateItem_Machine29.c", "C", 32, 0, 0, 0, 0, 1, 33
"/Users/sbukhari/Sandbox/CProgram/ASTanalysis/Dataset/Autopilot/Machine3/addItem_Machine3.c", "C", 40, 0, 0, 0, 2, 0, 42
"/Users/sbukhari/Sandbox/CProgram/ASTanalysis/Dataset/Autopilot/Machine3/costSum_Machine3.c", "C", 14, 0, 0, 0, 0, 0, 14
"/Users/sbukhari/Sandbox/CProgram/ASTanalysis/Dataset/Autopilot/Machine3/deduplicate_Machine3.c", "C", 20, 0, 0, 0, 0, 0, 20
"/Users/sbukhari/Sandbox/CProgram/ASTanalysis/Dataset/Autopilot/Machine3/highestPrice_Machine3.c", "C", 21, 0, 0, 0, 0, 0, 21
"/Users/sbukhari/Sandbox/CProgram/ASTanalysis/Dataset/Autopilot/Machine3/itemToString_Machine3.c", "C", 8, 0, 0, 0, 0, 0, 8
"/Users/sbukhari/Sandbox/CProgram/ASTanalysis/Dataset/Autopilot/Machine3/listInitialization_Machine3.c", "C", 12, 0, 0, 0, 0, 0, 12
"/Users/sbukhari/Sandbox/CProgram/ASTanalysis/Dataset/Autopilot/Machine3/printList_Machine3.c", "C", 14, 0, 0, 0, 0, 0, 14
"/Users/sbukhari/Sandbox/CProgram/ASTanalysis/Dataset/Autopilot/Machine3/removeItem_Machine3.c", "C", 20, 0, 0, 0, 0, 0, 20
"/Users/sbukhari/Sandbox/CProgram/ASTanalysis/Dataset/Autopilot/Machine3/save_Machine3.c", "C", 18, 0, 0, 0, 0, 0, 18
"/Users/sbukhari/Sandbox/CProgram/ASTanalysis/Dataset/Autopilot/Machine3/swapItem_Machine3.c", "C", 25, 0, 0, 0, 0, 0, 25
"/Users/sbukhari/Sandbox/CProgram/ASTanalysis/Dataset/Autopilot/Machine3/updateItem_Machine3.c", "C", 20, 0, 0, 0, 0, 0, 20
"/Users/sbukhari/Sandbox/CProgram/ASTanalysis/Dataset/Autopilot/Machine30/addItem_Machine30.c", "C", 42, 0, 0, 0, 0, 3, 45
"/Users/sbukhari/Sandbox/CProgram/ASTanalysis/Dataset/Autopilot/Machine30/costSum_Machine30.c", "C", 13, 0, 0, 0, 0, 2, 15
"/Users/sbukhari/Sandbox/CProgram/ASTanalysis/Dataset/Autopilot/Machine30/deduplicate_Machine30.c", "C", 20, 0, 0, 0, 0, 1, 21
"/Users/sbukhari/Sandbox/CProgram/ASTanalysis/Dataset/Autopilot/Machine30/highestPrice_Machine30.c", "C", 19, 0, 0, 0, 0, 2, 21
"/Users/sbukhari/Sandbox/CProgram/ASTanalysis/Dataset/Autopilot/Machine30/itemToString_Machine30.c", "C", 9, 0, 0, 0, 0, 2, 11
"/Users/sbukhari/Sandbox/CProgram/ASTanalysis/Dataset/Autopilot/Machine30/listInitialization_Machine30.c", "C", 7, 0, 0, 0, 0, 1, 8
"/Users/sbukhari/Sandbox/CProgram/ASTanalysis/Dataset/Autopilot/Machine30/load_Machine30.c", "C", 22, 0, 0, 0, 0, 1, 23
"/Users/sbukhari/Sandbox/CProgram/ASTanalysis/Dataset/Autopilot/Machine30/printList_Machine30.c", "C", 15, 0, 0, 0, 0, 2, 17
"/Users/sbukhari/Sandbox/CProgram/ASTanalysis/Dataset/Autopilot/Machine30/removeItem_Machine30.c", "C", 27, 0, 0, 0, 0, 3, 30
"/Users/sbukhari/Sandbox/CProgram/ASTanalysis/Dataset/Autopilot/Machine30/save_Machine30.c", "C", 17, 0, 0, 0, 0, 1, 18
"/Users/sbukhari/Sandbox/CProgram/ASTanalysis/Dataset/Autopilot/Machine30/swapItem_Machine30.c", "C", 52, 0, 0, 0, 0, 11, 63
"/Users/sbukhari/Sandbox/CProgram/ASTanalysis/Dataset/Autopilot/Machine30/updateItem_Machine30.c", "C", 22, 0, 0, 0, 0, 3, 25
"/Users/sbukhari/Sandbox/CProgram/ASTanalysis/Dataset/Autopilot/Machine4/addItem_Machine4.c", "C", 22, 0, 0, 0, 5, 1, 28
"/Users/sbukhari/Sandbox/CProgram/ASTanalysis/Dataset/Autopilot/Machine4/costSum_Machine4.c", "C", 22, 0, 0, 0, 8, 0, 30
"/Users/sbukhari/Sandbox/CProgram/ASTanalysis/Dataset/Autopilot/Machine4/highestPrice_Machine4.c", "C", 40, 0, 0, 0, 13, 0, 53
"/Users/sbukhari/Sandbox/CProgram/ASTanalysis/Dataset/Autopilot/Machine4/itemToString_Machine4.c", "C", 19, 0, 0, 0, 6, 3, 28
"/Users/sbukhari/Sandbox/CProgram/ASTanalysis/Dataset/Autopilot/Machine4/listInitialization_Machine4.c", "C", 4, 0, 0, 0, 0, 0, 4
"/Users/sbukhari/Sandbox/CProgram/ASTanalysis/Dataset/Autopilot/Machine4/printList_Machine4.c", "C", 26, 0, 0, 0, 7, 3, 36
"/Users/sbukhari/Sandbox/CProgram/ASTanalysis/Dataset/Autopilot/Machine4/removeItem_Machine4.c", "C", 18, 0, 0, 0, 5, 1, 24
"/Users/sbukhari/Sandbox/CProgram/ASTanalysis/Dataset/Autopilot/Machine4/save_Machine4.c", "C", 34, 0, 0, 0, 8, 0, 42
"/Users/sbukhari/Sandbox/CProgram/ASTanalysis/Dataset/Autopilot/Machine4/swapItem_Machine4.c", "C", 29, 0, 0, 0, 12, 2, 43
"/Users/sbukhari/Sandbox/CProgram/ASTanalysis/Dataset/Autopilot/Machine4/updateItem_Machine4.c", "C", 18, 0, 0, 0, 5, 1, 24
"/Users/sbukhari/Sandbox/CProgram/ASTanalysis/Dataset/Autopilot/Machine5/addItem_Machine5.c", "C", 31, 0, 0, 0, 0, 11, 42
"/Users/sbukhari/Sandbox/CProgram/ASTanalysis/Dataset/Autopilot/Machine5/costSum_Machine5.c", "C", 12, 0, 0, 0, 0, 2, 14
"/Users/sbukhari/Sandbox/CProgram/ASTanalysis/Dataset/Autopilot/Machine5/deduplicate_Machine5.c", "C", 20, 0, 0, 0, 0, 4, 24
"/Users/sbukhari/Sandbox/CProgram/ASTanalysis/Dataset/Autopilot/Machine5/highestPrice_Machine5.c", "C", 18, 0, 0, 0, 0, 5, 23
"/Users/sbukhari/Sandbox/CProgram/ASTanalysis/Dataset/Autopilot/Machine5/itemToString_Machine5.c", "C", 11, 0, 0, 0, 0, 3, 14
"/Users/sbukhari/Sandbox/CProgram/ASTanalysis/Dataset/Autopilot/Machine5/listInitialization_Machine5.c", "C", 7, 0, 0, 0, 0, 3, 10
"/Users/sbukhari/Sandbox/CProgram/ASTanalysis/Dataset/Autopilot/Machine5/load_Machine5.c", "C", 28, 0, 0, 0, 1, 7, 36
"/Users/sbukhari/Sandbox/CProgram/ASTanalysis/Dataset/Autopilot/Machine5/printList_Machine5.c", "C", 13, 0, 0, 0, 0, 3, 16
"/Users/sbukhari/Sandbox/CProgram/ASTanalysis/Dataset/Autopilot/Machine5/removeItem_Machine5.c", "C", 16, 0, 0, 0, 0, 4, 20
"/Users/sbukhari/Sandbox/CProgram/ASTanalysis/Dataset/Autopilot/Machine5/save_Machine5.c", "C", 14, 0, 0, 0, 0, 4, 18
"/Users/sbukhari/Sandbox/CProgram/ASTanalysis/Dataset/Autopilot/Machine5/swapItem_Machine5.c", "C", 22, 0, 0, 0, 0, 5, 27
"/Users/sbukhari/Sandbox/CProgram/ASTanalysis/Dataset/Autopilot/Machine5/updateItem_Machine5.c", "C", 17, 0, 0, 0, 0, 4, 21
"/Users/sbukhari/Sandbox/CProgram/ASTanalysis/Dataset/Autopilot/Machine6/addItem_Machine6.c", "C", 30, 0, 0, 0, 0, 0, 30
"/Users/sbukhari/Sandbox/CProgram/ASTanalysis/Dataset/Autopilot/Machine6/costSum_Machine6.c", "C", 14, 0, 0, 0, 0, 0, 14
"/Users/sbukhari/Sandbox/CProgram/ASTanalysis/Dataset/Autopilot/Machine6/deduplicate_Machine6.c", "C", 26, 0, 0, 0, 0, 1, 27
"/Users/sbukhari/Sandbox/CProgram/ASTanalysis/Dataset/Autopilot/Machine6/highestPrice_Machine6.c", "C", 18, 0, 0, 0, 0, 0, 18
"/Users/sbukhari/Sandbox/CProgram/ASTanalysis/Dataset/Autopilot/Machine6/itemToString_Machine6.c", "C", 40, 0, 0, 0, 0, 0, 40
"/Users/sbukhari/Sandbox/CProgram/ASTanalysis/Dataset/Autopilot/Machine6/listInitialization_Machine6.c", "C", 8, 0, 0, 0, 0, 0, 8
"/Users/sbukhari/Sandbox/CProgram/ASTanalysis/Dataset/Autopilot/Machine6/load_Machine6.c", "C", 46, 0, 0, 0, 0, 0, 46
"/Users/sbukhari/Sandbox/CProgram/ASTanalysis/Dataset/Autopilot/Machine6/printList_Machine6.c", "C", 43, 0, 0, 0, 0, 0, 43
"/Users/sbukhari/Sandbox/CProgram/ASTanalysis/Dataset/Autopilot/Machine6/removeItem_Machine6.c", "C", 19, 0, 0, 0, 0, 0, 19
"/Users/sbukhari/Sandbox/CProgram/ASTanalysis/Dataset/Autopilot/Machine6/save_Machine6.c", "C", 24, 0, 0, 0, 0, 0, 24
"/Users/sbukhari/Sandbox/CProgram/ASTanalysis/Dataset/Autopilot/Machine6/swapItem_Machine6.c", "C", 33, 0, 0, 0, 0, 0, 33
"/Users/sbukhari/Sandbox/CProgram/ASTanalysis/Dataset/Autopilot/Machine6/updateItem_Machine6.c", "C", 20, 0, 0, 0, 0, 0, 20
"/Users/sbukhari/Sandbox/CProgram/ASTanalysis/Dataset/Autopilot/Machine7/costSum_Machine7.c", "C", 13, 0, 0, 0, 4, 4, 21
"/Users/sbukhari/Sandbox/CProgram/ASTanalysis/Dataset/Autopilot/Machine7/deduplicate_Machine7.c", "C", 25, 0, 0, 0, 2, 3, 30
"/Users/sbukhari/Sandbox/CProgram/ASTanalysis/Dataset/Autopilot/Machine7/itemToString_Machine7.c", "C", 15, 0, 0, 0, 6, 6, 27
"/Users/sbukhari/Sandbox/CProgram/ASTanalysis/Dataset/Autopilot/Machine7/listInitialization_Machine7.c", "C", 10, 0, 0, 0, 3, 2, 15
"/Users/sbukhari/Sandbox/CProgram/ASTanalysis/Dataset/Autopilot/Machine7/load_Machine7.c", "C", 14, 0, 0, 0, 3, 4, 21
"/Users/sbukhari/Sandbox/CProgram/ASTanalysis/Dataset/Autopilot/Machine7/printList_Machine7.c", "C", 17, 0, 0, 0, 4, 4, 25
"/Users/sbukhari/Sandbox/CProgram/ASTanalysis/Dataset/Autopilot/Machine7/save_Machine7.c", "C", 14, 0, 0, 0, 3, 4, 21
"/Users/sbukhari/Sandbox/CProgram/ASTanalysis/Dataset/Autopilot/Machine8/addItem_Machine8.c", "C", 30, 0, 0, 0, 0, 5, 35
"/Users/sbukhari/Sandbox/CProgram/ASTanalysis/Dataset/Autopilot/Machine8/costSum_Machine8.c", "C", 10, 0, 0, 0, 0, 2, 12
"/Users/sbukhari/Sandbox/CProgram/ASTanalysis/Dataset/Autopilot/Machine8/deduplicate_Machine8.c", "C", 22, 0, 0, 0, 0, 4, 26
"/Users/sbukhari/Sandbox/CProgram/ASTanalysis/Dataset/Autopilot/Machine8/highestPrice_Machine8.c", "C", 18, 0, 0, 0, 0, 4, 22
"/Users/sbukhari/Sandbox/CProgram/ASTanalysis/Dataset/Autopilot/Machine8/itemToString_Machine8.c", "C", 22, 0, 0, 0, 0, 4, 26
"/Users/sbukhari/Sandbox/CProgram/ASTanalysis/Dataset/Autopilot/Machine8/listInitialization_Machine8.c", "C", 4, 0, 0, 0, 0, 0, 4
"/Users/sbukhari/Sandbox/CProgram/ASTanalysis/Dataset/Autopilot/Machine8/load_Machine8.c", "C", 37, 0, 0, 0, 0, 8, 45
"/Users/sbukhari/Sandbox/CProgram/ASTanalysis/Dataset/Autopilot/Machine8/printList_Machine8.c", "C", 29, 0, 0, 0, 0, 7, 36
"/Users/sbukhari/Sandbox/CProgram/ASTanalysis/Dataset/Autopilot/Machine8/removeItem_Machine8.c", "C", 18, 0, 0, 0, 0, 4, 22
"/Users/sbukhari/Sandbox/CProgram/ASTanalysis/Dataset/Autopilot/Machine8/save_Machine8.c", "C", 15, 0, 0, 0, 0, 4, 19
"/Users/sbukhari/Sandbox/CProgram/ASTanalysis/Dataset/Autopilot/Machine8/swapItem_Machine8.c", "C", 49, 0, 0, 0, 0, 9, 58
"/Users/sbukhari/Sandbox/CProgram/ASTanalysis/Dataset/Autopilot/Machine8/updateItem_Machine8.c", "C", 23, 0, 0, 0, 0, 3, 26
"/Users/sbukhari/Sandbox/CProgram/ASTanalysis/Dataset/Autopilot/Machine9/addItem_Machine9.c", "C", 31, 0, 0, 0, 5, 0, 36
"/Users/sbukhari/Sandbox/CProgram/ASTanalysis/Dataset/Autopilot/Machine9/costSum_Machine9.c", "C", 15, 0, 0, 0, 3, 0, 18
"/Users/sbukhari/Sandbox/CProgram/ASTanalysis/Dataset/Autopilot/Machine9/deduplicate_Machine9.c", "C", 21, 0, 0, 0, 4, 0, 25
"/Users/sbukhari/Sandbox/CProgram/ASTanalysis/Dataset/Autopilot/Machine9/highestPrice_Machine9.c", "C", 19, 0, 0, 0, 4, 0, 23
"/Users/sbukhari/Sandbox/CProgram/ASTanalysis/Dataset/Autopilot/Machine9/itemToString_Machine9.c", "C", 24, 0, 0, 0, 9, 0, 33
"/Users/sbukhari/Sandbox/CProgram/ASTanalysis/Dataset/Autopilot/Machine9/listInitialization_Machine9.c", "C", 11, 0, 0, 0, 0, 0, 11
"/Users/sbukhari/Sandbox/CProgram/ASTanalysis/Dataset/Autopilot/Machine9/load_Machine9.c", "C", 31, 0, 0, 0, 0, 0, 31
"/Users/sbukhari/Sandbox/CProgram/ASTanalysis/Dataset/Autopilot/Machine9/printList_Machine9.c", "C", 27, 0, 0, 0, 9, 0, 36
"/Users/sbukhari/Sandbox/CProgram/ASTanalysis/Dataset/Autopilot/Machine9/removeItem_Machine9.c", "C", 28, 0, 0, 0, 5, 0, 33
"/Users/sbukhari/Sandbox/CProgram/ASTanalysis/Dataset/Autopilot/Machine9/save_Machine9.c", "C", 24, 0, 0, 0, 0, 0, 24
"/Users/sbukhari/Sandbox/CProgram/ASTanalysis/Dataset/Autopilot/Machine9/swapItem_Machine9.c", "C", 42, 0, 0, 0, 8, 0, 50
"/Users/sbukhari/Sandbox/CProgram/ASTanalysis/Dataset/Autopilot/Machine9/updateItem_Machine9.c", "C", 29, 0, 0, 0, 8, 0, 37
"/Users/sbukhari/Sandbox/CProgram/ASTanalysis/Dataset/Control/Human1/addItem_Human1.c", "C", 17, 0, 0, 0, 3, 1, 21
"/Users/sbukhari/Sandbox/CProgram/ASTanalysis/Dataset/Control/Human1/itemToString_Human1.c", "C", 7, 0, 0, 0, 2, 0, 9
"/Users/sbukhari/Sandbox/CProgram/ASTanalysis/Dataset/Control/Human1/listInitialization_Human1.c", "C", 5, 0, 0, 0, 0, 0, 5
"/Users/sbukhari/Sandbox/CProgram/ASTanalysis/Dataset/Control/Human1/printList_Human1.c", "C", 14, 0, 0, 0, 4, 0, 18
"/Users/sbukhari/Sandbox/CProgram/ASTanalysis/Dataset/Control/Human10/addItem_Human10.c", "C", 29, 0, 0, 0, 0, 2, 31
"/Users/sbukhari/Sandbox/CProgram/ASTanalysis/Dataset/Control/Human10/costSum_Human10.c", "C", 10, 0, 0, 0, 0, 3, 13
"/Users/sbukhari/Sandbox/CProgram/ASTanalysis/Dataset/Control/Human10/deduplicate_Human10.c", "C", 20, 0, 0, 0, 0, 2, 22
"/Users/sbukhari/Sandbox/CProgram/ASTanalysis/Dataset/Control/Human10/highestPrice_Human10.c", "C", 12, 0, 0, 0, 0, 4, 16
"/Users/sbukhari/Sandbox/CProgram/ASTanalysis/Dataset/Control/Human10/itemToString_Human10.c", "C", 6, 0, 0, 0, 0, 0, 6
"/Users/sbukhari/Sandbox/CProgram/ASTanalysis/Dataset/Control/Human10/listInitialization_Human10.c", "C", 5, 0, 0, 0, 0, 0, 5
"/Users/sbukhari/Sandbox/CProgram/ASTanalysis/Dataset/Control/Human10/load_Human10.c", "C", 24, 0, 0, 0, 0, 5, 29
"/Users/sbukhari/Sandbox/CProgram/ASTanalysis/Dataset/Control/Human10/printList_Human10.c", "C", 9, 0, 0, 0, 0, 0, 9
"/Users/sbukhari/Sandbox/CProgram/ASTanalysis/Dataset/Control/Human10/removeItem_Human10.c", "C", 21, 0, 0, 0, 0, 3, 24
"/Users/sbukhari/Sandbox/CProgram/ASTanalysis/Dataset/Control/Human10/save_Human10.c", "C", 14, 0, 0, 0, 0, 5, 19
"/Users/sbukhari/Sandbox/CProgram/ASTanalysis/Dataset/Control/Human10/swapItem_Human10.c", "C", 36, 0, 0, 0, 0, 9, 45
"/Users/sbukhari/Sandbox/CProgram/ASTanalysis/Dataset/Control/Human10/updateItem_Human10.c", "C", 14, 0, 0, 0, 0, 0, 14
"/Users/sbukhari/Sandbox/CProgram/ASTanalysis/Dataset/Control/Human11/addItem_Human11.c", "C", 20, 0, 0, 0, 19, 2, 41
"/Users/sbukhari/Sandbox/CProgram/ASTanalysis/Dataset/Control/Human11/costSum_Human11.c", "C", 11, 0, 0, 0, 2, 0, 13
"/Users/sbukhari/Sandbox/CProgram/ASTanalysis/Dataset/Control/Human11/deduplicate_Human11.cpp", "C++", 0, 0, 0, 27, 3, 1, 31
"/Users/sbukhari/Sandbox/CProgram/ASTanalysis/Dataset/Control/Human11/highestPrice_Human11.c", "C", 15, 0, 0, 0, 2, 1, 18
"/Users/sbukhari/Sandbox/CProgram/ASTanalysis/Dataset/Control/Human11/itemToString_Human11.cpp", "C++", 0, 0, 0, 8, 4, 0, 12
"/Users/sbukhari/Sandbox/CProgram/ASTanalysis/Dataset/Control/Human11/listInitialization_Human11.c", "C", 5, 0, 0, 0, 0, 0, 5
"/Users/sbukhari/Sandbox/CProgram/ASTanalysis/Dataset/Control/Human11/load_Human11.c", "C", 35, 0, 0, 0, 2, 0, 37
"/Users/sbukhari/Sandbox/CProgram/ASTanalysis/Dataset/Control/Human11/printList_Human11.cpp", "C++", 0, 0, 0, 15, 2, 0, 17
"/Users/sbukhari/Sandbox/CProgram/ASTanalysis/Dataset/Control/Human11/removeItem_Human11.c", "C", 10, 0, 0, 0, 2, 0, 12
"/Users/sbukhari/Sandbox/CProgram/ASTanalysis/Dataset/Control/Human11/save_Human11.c", "C", 13, 0, 0, 0, 2, 0, 15
"/Users/sbukhari/Sandbox/CProgram/ASTanalysis/Dataset/Control/Human11/swapItem_Human11.c", "C", 33, 0, 0, 0, 2, 1, 36
"/Users/sbukhari/Sandbox/CProgram/ASTanalysis/Dataset/Control/Human11/updateItem_Human11.cpp", "C++", 0, 0, 0, 10, 2, 0, 12
"/Users/sbukhari/Sandbox/CProgram/ASTanalysis/Dataset/Control/Human12/addItem_Human12.cpp", "C++", 0, 0, 0, 12, 1, 3, 16
"/Users/sbukhari/Sandbox/CProgram/ASTanalysis/Dataset/Control/Human12/costSum_Human12.cpp", "C++", 0, 0, 0, 4, 2, 0, 6
"/Users/sbukhari/Sandbox/CProgram/ASTanalysis/Dataset/Control/Human12/deduplicate_Human12.c", "C", 4, 0, 0, 0, 0, 0, 4
"/Users/sbukhari/Sandbox/CProgram/ASTanalysis/Dataset/Control/Human12/highestPrice_Human12.cpp", "C++", 0, 0, 0, 4, 2, 0, 6
"/Users/sbukhari/Sandbox/CProgram/ASTanalysis/Dataset/Control/Human12/itemToString_Human12.cpp", "C++", 0, 0, 0, 3, 2, 0, 5
"/Users/sbukhari/Sandbox/CProgram/ASTanalysis/Dataset/Control/Human12/listInitialization_Human12.c", "C", 5, 0, 0, 0, 0, 0, 5
"/Users/sbukhari/Sandbox/CProgram/ASTanalysis/Dataset/Control/Human12/printList_Human12.c", "C", 11, 0, 0, 0, 0, 0, 11
"/Users/sbukhari/Sandbox/CProgram/ASTanalysis/Dataset/Control/Human12/removeItem_Human12.c", "C", 4, 0, 0, 0, 2, 0, 6
"/Users/sbukhari/Sandbox/CProgram/ASTanalysis/Dataset/Control/Human12/save_Human12.c", "C", 4, 0, 0, 0, 2, 0, 6
"/Users/sbukhari/Sandbox/CProgram/ASTanalysis/Dataset/Control/Human12/swapItem_Human12.c", "C", 3, 0, 0, 0, 2, 0, 5
"/Users/sbukhari/Sandbox/CProgram/ASTanalysis/Dataset/Control/Human12/updateItem_Human12.cpp", "C++", 0, 0, 0, 3, 2, 0, 5
"/Users/sbukhari/Sandbox/CProgram/ASTanalysis/Dataset/Control/Human13/addItem_Human13.c", "C", 28, 0, 0, 0, 0, 4, 32
"/Users/sbukhari/Sandbox/CProgram/ASTanalysis/Dataset/Control/Human13/itemToString_Human13.cpp", "C++", 0, 0, 0, 10, 2, 0, 12
"/Users/sbukhari/Sandbox/CProgram/ASTanalysis/Dataset/Control/Human13/listInitialization_Human13.c", "C", 5, 0, 0, 0, 0, 0, 5
"/Users/sbukhari/Sandbox/CProgram/ASTanalysis/Dataset/Control/Human13/printList_Human13.c", "C", 8, 0, 0, 0, 0, 0, 8
"/Users/sbukhari/Sandbox/CProgram/ASTanalysis/Dataset/Control/Human13/removeItem_Human13.c", "C", 16, 0, 0, 0, 0, 0, 16
"/Users/sbukhari/Sandbox/CProgram/ASTanalysis/Dataset/Control/Human13/updateItem_Human13.c", "C", 17, 0, 0, 0, 1, 0, 18
"/Users/sbukhari/Sandbox/CProgram/ASTanalysis/Dataset/Control/Human14/itemToString_Human14.cpp", "C++", 0, 0, 0, 14, 2, 1, 17
"/Users/sbukhari/Sandbox/CProgram/ASTanalysis/Dataset/Control/Human14/listInitialization_Human14.c", "C", 5, 0, 0, 0, 0, 0, 5
"/Users/sbukhari/Sandbox/CProgram/ASTanalysis/Dataset/Control/Human14/printList_Human14.c", "C", 16, 0, 0, 0, 2, 0, 18
"/Users/sbukhari/Sandbox/CProgram/ASTanalysis/Dataset/Control/Human15/addItem_Human15.c", "C", 19, 0, 0, 0, 0, 1, 20
"/Users/sbukhari/Sandbox/CProgram/ASTanalysis/Dataset/Control/Human15/costSum_Human15.cpp", "C++", 0, 0, 0, 8, 0, 1, 9
"/Users/sbukhari/Sandbox/CProgram/ASTanalysis/Dataset/Control/Human15/highestPrice_Human15.c", "C", 15, 0, 0, 0, 0, 0, 15
"/Users/sbukhari/Sandbox/CProgram/ASTanalysis/Dataset/Control/Human15/itemToString_Human15.c", "C", 4, 0, 0, 0, 0, 0, 4
"/Users/sbukhari/Sandbox/CProgram/ASTanalysis/Dataset/Control/Human15/listInitialization_Human15.c", "C", 5, 0, 0, 0, 0, 0, 5
"/Users/sbukhari/Sandbox/CProgram/ASTanalysis/Dataset/Control/Human15/printList_Human15.c", "C", 12, 0, 0, 0, 0, 0, 12
"/Users/sbukhari/Sandbox/CProgram/ASTanalysis/Dataset/Control/Human15/removeItem_Human15.c", "C", 13, 0, 0, 0, 0, 0, 13
"/Users/sbukhari/Sandbox/CProgram/ASTanalysis/Dataset/Control/Human15/swapItem_Human15.c", "C", 20, 0, 0, 0, 0, 2, 22
"/Users/sbukhari/Sandbox/CProgram/ASTanalysis/Dataset/Control/Human15/updateItem_Human15.cpp", "C++", 0, 0, 0, 11, 0, 0, 11
"/Users/sbukhari/Sandbox/CProgram/ASTanalysis/Dataset/Control/Human16/addItem_Human16.c", "C", 24, 0, 0, 0, 2, 5, 31
"/Users/sbukhari/Sandbox/CProgram/ASTanalysis/Dataset/Control/Human16/costSum_Human16.c", "C", 10, 0, 0, 0, 2, 0, 12
"/Users/sbukhari/Sandbox/CProgram/ASTanalysis/Dataset/Control/Human16/deduplicate_Human16.c", "C", 26, 0, 0, 0, 2, 0, 28
"/Users/sbukhari/Sandbox/CProgram/ASTanalysis/Dataset/Control/Human16/highestPrice_Human16.c", "C", 16, 0, 0, 0, 2, 0, 18
"/Users/sbukhari/Sandbox/CProgram/ASTanalysis/Dataset/Control/Human16/itemToString_Human16.c", "C", 7, 0, 0, 0, 5, 0, 12
"/Users/sbukhari/Sandbox/CProgram/ASTanalysis/Dataset/Control/Human16/listInitialization_Human16.c", "C", 5, 0, 0, 0, 0, 0, 5
"/Users/sbukhari/Sandbox/CProgram/ASTanalysis/Dataset/Control/Human16/load_Human16.c", "C", 33, 0, 0, 0, 2, 6, 41
"/Users/sbukhari/Sandbox/CProgram/ASTanalysis/Dataset/Control/Human16/printList_Human16.c", "C", 11, 0, 0, 0, 2, 0, 13
"/Users/sbukhari/Sandbox/CProgram/ASTanalysis/Dataset/Control/Human16/removeItem_Human16.c", "C", 20, 0, 0, 0, 2, 3, 25
"/Users/sbukhari/Sandbox/CProgram/ASTanalysis/Dataset/Control/Human16/save_Human16.cpp", "C++", 0, 0, 0, 18, 2, 4, 24
"/Users/sbukhari/Sandbox/CProgram/ASTanalysis/Dataset/Control/Human16/swapItem_Human16.c", "C", 30, 0, 0, 0, 2, 4, 36
"/Users/sbukhari/Sandbox/CProgram/ASTanalysis/Dataset/Control/Human16/updateItem_Human16.cpp", "C++", 0, 0, 0, 15, 2, 3, 20
"/Users/sbukhari/Sandbox/CProgram/ASTanalysis/Dataset/Control/Human17/addItem_Human17.c", "C", 27, 0, 0, 0, 0, 0, 27
"/Users/sbukhari/Sandbox/CProgram/ASTanalysis/Dataset/Control/Human17/costSum_Human17.cpp", "C++", 0, 0, 0, 12, 0, 0, 12
"/Users/sbukhari/Sandbox/CProgram/ASTanalysis/Dataset/Control/Human17/highestPrice_Human17.c", "C", 18, 0, 0, 0, 0, 1, 19
"/Users/sbukhari/Sandbox/CProgram/ASTanalysis/Dataset/Control/Human17/itemToString_Human17.c", "C", 13, 0, 0, 0, 0, 1, 14
"/Users/sbukhari/Sandbox/CProgram/ASTanalysis/Dataset/Control/Human17/listInitialization_Human17.c", "C", 5, 0, 0, 0, 0, 0, 5
"/Users/sbukhari/Sandbox/CProgram/ASTanalysis/Dataset/Control/Human17/printList_Human17.c", "C", 13, 0, 0, 0, 0, 1, 14
"/Users/sbukhari/Sandbox/CProgram/ASTanalysis/Dataset/Control/Human17/removeItem_Human17.c", "C", 28, 0, 0, 0, 0, 1, 29
"/Users/sbukhari/Sandbox/CProgram/ASTanalysis/Dataset/Control/Human17/save_Human17.cpp", "C++", 0, 0, 0, 5, 0, 0, 5
"/Users/sbukhari/Sandbox/CProgram/ASTanalysis/Dataset/Control/Human17/swapItem_Human17.c", "C", 46, 0, 0, 0, 13, 13, 72
"/Users/sbukhari/Sandbox/CProgram/ASTanalysis/Dataset/Control/Human17/updateItem_Human17.cpp", "C++", 0, 0, 0, 14, 0, 2, 16
"/Users/sbukhari/Sandbox/CProgram/ASTanalysis/Dataset/Control/Human18/addItem_Human18.cpp", "C++", 0, 0, 0, 8, 13, 0, 21
"/Users/sbukhari/Sandbox/CProgram/ASTanalysis/Dataset/Control/Human18/itemToString_Human18.cpp", "C++", 0, 0, 0, 5, 7, 1, 13
"/Users/sbukhari/Sandbox/CProgram/ASTanalysis/Dataset/Control/Human18/listInitialization_Human18.c", "C", 5, 0, 0, 0, 0, 0, 5
"/Users/sbukhari/Sandbox/CProgram/ASTanalysis/Dataset/Control/Human18/printList_Human18.c", "C", 11, 0, 0, 0, 0, 0, 11
"/Users/sbukhari/Sandbox/CProgram/ASTanalysis/Dataset/Control/Human19/addItem_Human19.c", "C", 17, 0, 0, 0, 1, 4, 22
"/Users/sbukhari/Sandbox/CProgram/ASTanalysis/Dataset/Control/Human19/itemToString_Human19.cpp", "C++", 0, 0, 0, 7, 0, 1, 8
"/Users/sbukhari/Sandbox/CProgram/ASTanalysis/Dataset/Control/Human19/listInitialization_Human19.c", "C", 5, 0, 0, 0, 0, 0, 5
"/Users/sbukhari/Sandbox/CProgram/ASTanalysis/Dataset/Control/Human19/printList_Human19.c", "C", 10, 0, 0, 0, 0, 1, 11
"/Users/sbukhari/Sandbox/CProgram/ASTanalysis/Dataset/Control/Human2/addItem_Human2.c", "C", 13, 0, 0, 0, 2, 0, 15
"/Users/sbukhari/Sandbox/CProgram/ASTanalysis/Dataset/Control/Human2/listInitialization_Human2.c", "C", 5, 0, 0, 0, 0, 0, 5
"/Users/sbukhari/Sandbox/CProgram/ASTanalysis/Dataset/Control/Human20/addItem_Human20.c", "C", 8, 0, 0, 0, 4, 1, 13
"/Users/sbukhari/Sandbox/CProgram/ASTanalysis/Dataset/Control/Human20/listInitialization_Human20.c", "C", 5, 0, 0, 0, 0, 0, 5
"/Users/sbukhari/Sandbox/CProgram/ASTanalysis/Dataset/Control/Human20/printList_Human20.c", "C", 12, 0, 0, 0, 0, 0, 12
"/Users/sbukhari/Sandbox/CProgram/ASTanalysis/Dataset/Control/Human20/removeItem_Human20.c", "C", 4, 0, 0, 0, 4, 0, 8
"/Users/sbukhari/Sandbox/CProgram/ASTanalysis/Dataset/Control/Human20/updateItem_Human20.c", "C", 5, 0, 0, 0, 9, 1, 15
"/Users/sbukhari/Sandbox/CProgram/ASTanalysis/Dataset/Control/Human21/addItem_Human21.c", "C", 21, 0, 0, 0, 2, 2, 25
"/Users/sbukhari/Sandbox/CProgram/ASTanalysis/Dataset/Control/Human21/itemToString_Human21.c", "C", 5, 0, 0, 0, 2, 0, 7
"/Users/sbukhari/Sandbox/CProgram/ASTanalysis/Dataset/Control/Human21/listInitialization_Human21.c", "C", 5, 0, 0, 0, 0, 0, 5
"/Users/sbukhari/Sandbox/CProgram/ASTanalysis/Dataset/Control/Human21/printList_Human21.c", "C", 11, 0, 0, 0, 2, 2, 15
"/Users/sbukhari/Sandbox/CProgram/ASTanalysis/Dataset/Control/Human22/addItem_Human22.c", "C", 22, 0, 0, 0, 3, 4, 29
"/Users/sbukhari/Sandbox/CProgram/ASTanalysis/Dataset/Control/Human22/itemToString_Human22.cpp", "C++", 0, 0, 0, 5, 2, 0, 7
"/Users/sbukhari/Sandbox/CProgram/ASTanalysis/Dataset/Control/Human22/listInitialization_Human22.c", "C", 5, 0, 0, 0, 0, 0, 5
"/Users/sbukhari/Sandbox/CProgram/ASTanalysis/Dataset/Control/Human22/printList_Human22.c", "C", 11, 0, 0, 0, 2, 0, 13
"/Users/sbukhari/Sandbox/CProgram/ASTanalysis/Dataset/Control/Human23/addItem_Human23.c", "C", 24, 0, 0, 0, 2, 3, 29
"/Users/sbukhari/Sandbox/CProgram/ASTanalysis/Dataset/Control/Human23/costSum_Human23.c", "C", 9, 0, 0, 0, 0, 0, 9
"/Users/sbukhari/Sandbox/CProgram/ASTanalysis/Dataset/Control/Human23/deduplicate_Human23.c", "C", 17, 0, 0, 0, 0, 1, 18
"/Users/sbukhari/Sandbox/CProgram/ASTanalysis/Dataset/Control/Human23/highestPrice_Human23.c", "C", 15, 0, 0, 0, 0, 0, 15
"/Users/sbukhari/Sandbox/CProgram/ASTanalysis/Dataset/Control/Human23/itemToString_Human23.cpp", "C++", 0, 0, 0, 6, 2, 0, 8
"/Users/sbukhari/Sandbox/CProgram/ASTanalysis/Dataset/Control/Human23/listInitialization_Human23.c", "C", 5, 0, 0, 0, 0, 1, 6
"/Users/sbukhari/Sandbox/CProgram/ASTanalysis/Dataset/Control/Human23/load_Human23.c", "C", 27, 0, 0, 0, 0, 4, 31
"/Users/sbukhari/Sandbox/CProgram/ASTanalysis/Dataset/Control/Human23/printList_Human23.c", "C", 14, 0, 0, 0, 0, 0, 14
"/Users/sbukhari/Sandbox/CProgram/ASTanalysis/Dataset/Control/Human23/removeItem_Human23.c", "C", 22, 0, 0, 0, 0, 1, 23
"/Users/sbukhari/Sandbox/CProgram/ASTanalysis/Dataset/Control/Human23/save_Human23.cpp", "C++", 0, 0, 0, 14, 0, 3, 17
"/Users/sbukhari/Sandbox/CProgram/ASTanalysis/Dataset/Control/Human23/swapItem_Human23.c", "C", 25, 0, 0, 0, 0, 4, 29
"/Users/sbukhari/Sandbox/CProgram/ASTanalysis/Dataset/Control/Human23/updateItem_Human23.cpp", "C++", 0, 0, 0, 14, 0, 2, 16
"/Users/sbukhari/Sandbox/CProgram/ASTanalysis/Dataset/Control/Human24/itemToString_Human24.cpp", "C++", 0, 0, 0, 9, 0, 0, 9
"/Users/sbukhari/Sandbox/CProgram/ASTanalysis/Dataset/Control/Human24/listInitialization_Human24.c", "C", 5, 0, 0, 0, 0, 0, 5
"/Users/sbukhari/Sandbox/CProgram/ASTanalysis/Dataset/Control/Human25/costSum_Human25.cpp", "C++", 0, 0, 0, 9, 2, 0, 11
"/Users/sbukhari/Sandbox/CProgram/ASTanalysis/Dataset/Control/Human25/highestPrice_Human25.c", "C", 15, 0, 0, 0, 2, 0, 17
"/Users/sbukhari/Sandbox/CProgram/ASTanalysis/Dataset/Control/Human25/itemToString_Human25.cpp", "C++", 0, 0, 0, 11, 4, 0, 15
"/Users/sbukhari/Sandbox/CProgram/ASTanalysis/Dataset/Control/Human25/listInitialization_Human25.c", "C", 5, 0, 0, 0, 0, 0, 5
"/Users/sbukhari/Sandbox/CProgram/ASTanalysis/Dataset/Control/Human25/printList_Human25.c", "C", 8, 0, 0, 0, 2, 0, 10
"/Users/sbukhari/Sandbox/CProgram/ASTanalysis/Dataset/Control/Human26/addItem_Human26.c", "C", 29, 0, 0, 0, 8, 8, 45
"/Users/sbukhari/Sandbox/CProgram/ASTanalysis/Dataset/Control/Human26/costSum_Human26.c", "C", 11, 0, 0, 0, 4, 4, 19
"/Users/sbukhari/Sandbox/CProgram/ASTanalysis/Dataset/Control/Human26/deduplicate_Human26.c", "C", 24, 0, 0, 0, 6, 6, 36
"/Users/sbukhari/Sandbox/CProgram/ASTanalysis/Dataset/Control/Human26/highestPrice_Human26.c", "C", 19, 0, 0, 0, 5, 6, 30
"/Users/sbukhari/Sandbox/CProgram/ASTanalysis/Dataset/Control/Human26/itemToString_Human26.c", "C", 10, 0, 0, 0, 4, 3, 17
"/Users/sbukhari/Sandbox/CProgram/ASTanalysis/Dataset/Control/Human26/listInitialization_Human26.c", "C", 5, 0, 0, 0, 0, 0, 5
"/Users/sbukhari/Sandbox/CProgram/ASTanalysis/Dataset/Control/Human26/load_Human26.cpp", "C++", 0, 0, 0, 25, 7, 8, 40
"/Users/sbukhari/Sandbox/CProgram/ASTanalysis/Dataset/Control/Human26/printList_Human26.c", "C", 15, 0, 0, 0, 3, 3, 21
"/Users/sbukhari/Sandbox/CProgram/ASTanalysis/Dataset/Control/Human26/removeItem_Human26.c", "C", 25, 0, 0, 0, 7, 8, 40
"/Users/sbukhari/Sandbox/CProgram/ASTanalysis/Dataset/Control/Human26/save_Human26.cpp", "C++", 0, 0, 0, 15, 5, 5, 25
"/Users/sbukhari/Sandbox/CProgram/ASTanalysis/Dataset/Control/Human26/swapItem_Human26.c", "C", 33, 0, 0, 0, 6, 11, 50
"/Users/sbukhari/Sandbox/CProgram/ASTanalysis/Dataset/Control/Human26/updateItem_Human26.c", "C", 20, 0, 0, 0, 6, 6, 32
"/Users/sbukhari/Sandbox/CProgram/ASTanalysis/Dataset/Control/Human27/addItem_Human27.c", "C", 23, 0, 0, 0, 2, 1, 26
"/Users/sbukhari/Sandbox/CProgram/ASTanalysis/Dataset/Control/Human27/costSum_Human27.c", "C", 11, 0, 0, 0, 2, 1, 14
"/Users/sbukhari/Sandbox/CProgram/ASTanalysis/Dataset/Control/Human27/deduplicate_Human27.c", "C", 17, 0, 0, 0, 2, 1, 20
"/Users/sbukhari/Sandbox/CProgram/ASTanalysis/Dataset/Control/Human27/highestPrice_Human27.c", "C", 4, 0, 0, 0, 19, 1, 24
"/Users/sbukhari/Sandbox/CProgram/ASTanalysis/Dataset/Control/Human27/itemToString_Human27.c", "C", 5, 0, 0, 0, 3, 0, 8
"/Users/sbukhari/Sandbox/CProgram/ASTanalysis/Dataset/Control/Human27/listInitialization_Human27.c", "C", 5, 0, 0, 0, 0, 0, 5
"/Users/sbukhari/Sandbox/CProgram/ASTanalysis/Dataset/Control/Human27/load_Human27.cpp", "C++", 0, 0, 0, 20, 2, 4, 26
"/Users/sbukhari/Sandbox/CProgram/ASTanalysis/Dataset/Control/Human27/printList_Human27.c", "C", 10, 0, 0, 0, 2, 0, 12
"/Users/sbukhari/Sandbox/CProgram/ASTanalysis/Dataset/Control/Human27/removeItem_Human27.c", "C", 22, 0, 0, 0, 2, 1, 25
"/Users/sbukhari/Sandbox/CProgram/ASTanalysis/Dataset/Control/Human27/save_Human27.cpp", "C++", 0, 0, 0, 12, 2, 0, 14
"/Users/sbukhari/Sandbox/CProgram/ASTanalysis/Dataset/Control/Human27/swapItem_Human27.c", "C", 42, 0, 0, 0, 3, 8, 53
"/Users/sbukhari/Sandbox/CProgram/ASTanalysis/Dataset/Control/Human27/updateItem_Human27.cpp", "C++", 0, 0, 0, 13, 2, 1, 16
"/Users/sbukhari/Sandbox/CProgram/ASTanalysis/Dataset/Control/Human28/itemToString_Human28.cpp", "C++", 0, 0, 0, 4, 0, 0, 4
"/Users/sbukhari/Sandbox/CProgram/ASTanalysis/Dataset/Control/Human28/listInitialization_Human28.c", "C", 5, 0, 0, 0, 0, 0, 5
"/Users/sbukhari/Sandbox/CProgram/ASTanalysis/Dataset/Control/Human28/printList_Human28.c", "C", 10, 0, 0, 0, 0, 0, 10
"/Users/sbukhari/Sandbox/CProgram/ASTanalysis/Dataset/Control/Human3/addItem_Human3.c", "C", 24, 0, 0, 0, 2, 1, 27
"/Users/sbukhari/Sandbox/CProgram/ASTanalysis/Dataset/Control/Human3/costSum_Human3.c", "C", 15, 0, 0, 0, 2, 1, 18
"/Users/sbukhari/Sandbox/CProgram/ASTanalysis/Dataset/Control/Human3/deduplicate_Human3.c", "C", 32, 0, 0, 0, 3, 5, 40
"/Users/sbukhari/Sandbox/CProgram/ASTanalysis/Dataset/Control/Human3/highestPrice_Human3.c", "C", 20, 0, 0, 0, 2, 1, 23
"/Users/sbukhari/Sandbox/CProgram/ASTanalysis/Dataset/Control/Human3/itemToString_Human3.c", "C", 6, 0, 0, 0, 2, 1, 9
"/Users/sbukhari/Sandbox/CProgram/ASTanalysis/Dataset/Control/Human3/listInitialization_Human3.c", "C", 5, 0, 0, 0, 0, 0, 5
"/Users/sbukhari/Sandbox/CProgram/ASTanalysis/Dataset/Control/Human3/load_Human3.c", "C", 15, 0, 0, 0, 2, 1, 18
"/Users/sbukhari/Sandbox/CProgram/ASTanalysis/Dataset/Control/Human3/printList_Human3.c", "C", 11, 0, 0, 0, 2, 0, 13
"/Users/sbukhari/Sandbox/CProgram/ASTanalysis/Dataset/Control/Human3/removeItem_Human3.c", "C", 18, 0, 0, 0, 2, 2, 22
"/Users/sbukhari/Sandbox/CProgram/ASTanalysis/Dataset/Control/Human3/save_Human3.c", "C", 12, 0, 0, 0, 2, 2, 16
"/Users/sbukhari/Sandbox/CProgram/ASTanalysis/Dataset/Control/Human3/swapItem_Human3.c", "C", 22, 0, 0, 0, 2, 2, 26
"/Users/sbukhari/Sandbox/CProgram/ASTanalysis/Dataset/Control/Human3/updateItem_Human3.c", "C", 10, 0, 0, 0, 2, 0, 12
"/Users/sbukhari/Sandbox/CProgram/ASTanalysis/Dataset/Control/Human4/addItem_Human4.c", "C", 18, 0, 0, 0, 6, 2, 26
"/Users/sbukhari/Sandbox/CProgram/ASTanalysis/Dataset/Control/Human4/itemToString_Human4.c", "C", 17, 0, 0, 0, 0, 0, 17
"/Users/sbukhari/Sandbox/CProgram/ASTanalysis/Dataset/Control/Human4/listInitialization_Human4.c", "C", 5, 0, 0, 0, 0, 0, 5
"/Users/sbukhari/Sandbox/CProgram/ASTanalysis/Dataset/Control/Human4/printList_Human4.c", "C", 12, 0, 0, 0, 2, 0, 14
"/Users/sbukhari/Sandbox/CProgram/ASTanalysis/Dataset/Control/Human5/addItem_Human5.c", "C", 21, 0, 0, 0, 0, 0, 21
"/Users/sbukhari/Sandbox/CProgram/ASTanalysis/Dataset/Control/Human5/costSum_Human5.c", "C", 10, 0, 0, 0, 1, 2, 13
"/Users/sbukhari/Sandbox/CProgram/ASTanalysis/Dataset/Control/Human5/deduplicate_Human5.c", "C", 40, 0, 0, 0, 1, 7, 48
"/Users/sbukhari/Sandbox/CProgram/ASTanalysis/Dataset/Control/Human5/highestPrice_Human5.c", "C", 16, 0, 0, 0, 1, 2, 19
"/Users/sbukhari/Sandbox/CProgram/ASTanalysis/Dataset/Control/Human5/itemToString_Human5.c", "C", 5, 0, 0, 0, 1, 2, 8
"/Users/sbukhari/Sandbox/CProgram/ASTanalysis/Dataset/Control/Human5/listInitialization_Human5.c", "C", 5, 0, 0, 0, 0, 0, 5
"/Users/sbukhari/Sandbox/CProgram/ASTanalysis/Dataset/Control/Human5/load_Human5.c", "C", 24, 0, 0, 0, 1, 2, 27
"/Users/sbukhari/Sandbox/CProgram/ASTanalysis/Dataset/Control/Human5/printList_Human5.c", "C", 16, 0, 0, 0, 1, 2, 19
"/Users/sbukhari/Sandbox/CProgram/ASTanalysis/Dataset/Control/Human5/removeItem_Human5.c", "C", 21, 0, 0, 0, 1, 2, 24
"/Users/sbukhari/Sandbox/CProgram/ASTanalysis/Dataset/Control/Human5/save_Human5.c", "C", 11, 0, 0, 0, 1, 5, 17
"/Users/sbukhari/Sandbox/CProgram/ASTanalysis/Dataset/Control/Human5/swapItem_Human5.c", "C", 35, 0, 0, 0, 1, 3, 39
"/Users/sbukhari/Sandbox/CProgram/ASTanalysis/Dataset/Control/Human5/updateItem_Human5.c", "C", 24, 0, 0, 0, 1, 1, 26
"/Users/sbukhari/Sandbox/CProgram/ASTanalysis/Dataset/Control/Human6/addItem_Human6.c", "C", 19, 0, 0, 0, 0, 4, 23
"/Users/sbukhari/Sandbox/CProgram/ASTanalysis/Dataset/Control/Human6/itemToString_Human6.c", "C", 7, 0, 0, 0, 4, 3, 14
"/Users/sbukhari/Sandbox/CProgram/ASTanalysis/Dataset/Control/Human6/listInitialization_Human6.c", "C", 5, 0, 0, 0, 0, 0, 5
"/Users/sbukhari/Sandbox/CProgram/ASTanalysis/Dataset/Control/Human6/printList_Human6.c", "C", 9, 0, 0, 0, 2, 0, 11
"/Users/sbukhari/Sandbox/CProgram/ASTanalysis/Dataset/Control/Human6/removeItem_Human6.c", "C", 12, 0, 0, 0, 2, 3, 17
"/Users/sbukhari/Sandbox/CProgram/ASTanalysis/Dataset/Control/Human7/addItem_Human7.c", "C", 23, 0, 0, 0, 2, 0, 25
"/Users/sbukhari/Sandbox/CProgram/ASTanalysis/Dataset/Control/Human7/costSum_Human7.c", "C", 10, 0, 0, 0, 2, 0, 12
"/Users/sbukhari/Sandbox/CProgram/ASTanalysis/Dataset/Control/Human7/highestPrice_Human7.c", "C", 15, 0, 0, 0, 2, 0, 17
"/Users/sbukhari/Sandbox/CProgram/ASTanalysis/Dataset/Control/Human7/itemToString_Human7.c", "C", 7, 0, 0, 0, 3, 0, 10
"/Users/sbukhari/Sandbox/CProgram/ASTanalysis/Dataset/Control/Human7/listInitialization_Human7.c", "C", 5, 0, 0, 0, 0, 0, 5
"/Users/sbukhari/Sandbox/CProgram/ASTanalysis/Dataset/Control/Human7/printList_Human7.c", "C", 13, 0, 0, 0, 2, 0, 15
"/Users/sbukhari/Sandbox/CProgram/ASTanalysis/Dataset/Control/Human7/removeItem_Human7.c", "C", 15, 0, 0, 0, 2, 1, 18
"/Users/sbukhari/Sandbox/CProgram/ASTanalysis/Dataset/Control/Human7/save_Human7.c", "C", 18, 0, 0, 0, 2, 1, 21
"/Users/sbukhari/Sandbox/CProgram/ASTanalysis/Dataset/Control/Human7/updateItem_Human7.c", "C", 20, 0, 0, 0, 2, 1, 23
"/Users/sbukhari/Sandbox/CProgram/ASTanalysis/Dataset/Control/Human8/addItem_Human8.c", "C", 34, 0, 0, 0, 3, 7, 44
"/Users/sbukhari/Sandbox/CProgram/ASTanalysis/Dataset/Control/Human8/costSum_Human8.c", "C", 10, 0, 0, 0, 2, 2, 14
"/Users/sbukhari/Sandbox/CProgram/ASTanalysis/Dataset/Control/Human8/deduplicate_Human8.c", "C", 44, 0, 0, 0, 12, 18, 74
"/Users/sbukhari/Sandbox/CProgram/ASTanalysis/Dataset/Control/Human8/highestPrice_Human8.c", "C", 15, 0, 0, 0, 2, 3, 20
"/Users/sbukhari/Sandbox/CProgram/ASTanalysis/Dataset/Control/Human8/itemToString_Human8.c", "C", 12, 0, 0, 0, 5, 4, 21
"/Users/sbukhari/Sandbox/CProgram/ASTanalysis/Dataset/Control/Human8/listInitialization_Human8.c", "C", 5, 0, 0, 0, 0, 0, 5
"/Users/sbukhari/Sandbox/CProgram/ASTanalysis/Dataset/Control/Human8/load_Human8.c", "C", 30, 0, 0, 0, 10, 11, 51
"/Users/sbukhari/Sandbox/CProgram/ASTanalysis/Dataset/Control/Human8/printList_Human8.c", "C", 18, 0, 0, 0, 3, 5, 26
"/Users/sbukhari/Sandbox/CProgram/ASTanalysis/Dataset/Control/Human8/removeItem_Human8.c", "C", 24, 0, 0, 0, 15, 7, 46
"/Users/sbukhari/Sandbox/CProgram/ASTanalysis/Dataset/Control/Human8/save_Human8.c", "C", 20, 0, 0, 0, 3, 10, 33
"/Users/sbukhari/Sandbox/CProgram/ASTanalysis/Dataset/Control/Human8/swapItem_Human8.c", "C", 36, 0, 0, 0, 2, 8, 46
"/Users/sbukhari/Sandbox/CProgram/ASTanalysis/Dataset/Control/Human8/updateItem_Human8.c", "C", 20, 0, 0, 0, 6, 5, 31
"/Users/sbukhari/Sandbox/CProgram/ASTanalysis/Dataset/Control/Human9/addItem_Human9.c", "C", 23, 0, 0, 0, 4, 1, 28
"/Users/sbukhari/Sandbox/CProgram/ASTanalysis/Dataset/Control/Human9/costSum_Human9.c", "C", 10, 0, 0, 0, 3, 1, 14
"/Users/sbukhari/Sandbox/CProgram/ASTanalysis/Dataset/Control/Human9/deduplicate_Human9.c", "C", 30, 0, 0, 0, 3, 0, 33
"/Users/sbukhari/Sandbox/CProgram/ASTanalysis/Dataset/Control/Human9/highestPrice_Human9.c", "C", 21, 0, 0, 0, 4, 2, 27
"/Users/sbukhari/Sandbox/CProgram/ASTanalysis/Dataset/Control/Human9/itemToString_Human9.c", "C", 8, 0, 0, 0, 2, 0, 10
"/Users/sbukhari/Sandbox/CProgram/ASTanalysis/Dataset/Control/Human9/listInitialization_Human9.c", "C", 5, 0, 0, 0, 0, 0, 5
"/Users/sbukhari/Sandbox/CProgram/ASTanalysis/Dataset/Control/Human9/load_Human9.c", "C", 33, 0, 0, 0, 4, 0, 37
"/Users/sbukhari/Sandbox/CProgram/ASTanalysis/Dataset/Control/Human9/ownFunction_Human9.c", "C", 11, 0, 0, 0, 0, 0, 11
"/Users/sbukhari/Sandbox/CProgram/ASTanalysis/Dataset/Control/Human9/printList_Human9.c", "C", 14, 0, 0, 0, 2, 0, 16
"/Users/sbukhari/Sandbox/CProgram/ASTanalysis/Dataset/Control/Human9/removeItem_Human9.c", "C", 20, 0, 0, 0, 3, 2, 25
"/Users/sbukhari/Sandbox/CProgram/ASTanalysis/Dataset/Control/Human9/save_Human9.c", "C", 15, 0, 0, 0, 3, 1, 19
"/Users/sbukhari/Sandbox/CProgram/ASTanalysis/Dataset/Control/Human9/swapItem_Human9.c", "C", 36, 0, 0, 0, 4, 3, 43
"/Users/sbukhari/Sandbox/CProgram/ASTanalysis/Dataset/Control/Human9/updateItem_Human9.c", "C", 24, 0, 0, 0, 4, 2, 30
"/Users/sbukhari/Sandbox/CProgram/ASTanalysis/DictOfNodes.py", "Python", 0, 0, 125, 0, 0, 18, 143
"/Users/sbukhari/Sandbox/CProgram/ASTanalysis/LexicalClassification.py", "Python", 0, 0, 133, 0, 31, 111, 275
"/Users/sbukhari/Sandbox/CProgram/ASTanalysis/LexicalLooper.py", "Python", 0, 0, 43, 0, 26, 41, 110
"/Users/sbukhari/Sandbox/CProgram/ASTanalysis/LexicalParse.py", "Python", 0, 0, 140, 0, 98, 139, 377
"/Users/sbukhari/Sandbox/CProgram/ASTanalysis/NGramEmptyPair.py", "Python", 0, 0, 183, 0, 57, 85, 325
"/Users/sbukhari/Sandbox/CProgram/ASTanalysis/QuadgramASTClassification.py", "Python", 0, 0, 168, 0, 59, 148, 375
"/Users/sbukhari/Sandbox/CProgram/ASTanalysis/QuadgramDictUpdate.py", "Python", 0, 0, 80, 0, 41, 68, 189
"/Users/sbukhari/Sandbox/CProgram/ASTanalysis/QuadgramVectorCreation.py", "Python", 0, 0, 63, 0, 32, 58, 153
"/Users/sbukhari/Sandbox/CProgram/ASTanalysis/TrigramASTClassification.py", "Python", 0, 0, 133, 0, 30, 106, 269
"/Users/sbukhari/Sandbox/CProgram/ASTanalysis/TrigramDictUpdate.py", "Python", 0, 0, 80, 0, 41, 68, 189
"/Users/sbukhari/Sandbox/CProgram/ASTanalysis/TrigramVectorCreation.py", "Python", 0, 0, 63, 0, 32, 58, 153
"/Users/sbukhari/Sandbox/CProgram/ASTanalysis/builder.py", "Python", 0, 0, 7, 0, 3, 3, 13
"Total", "-", 103491, 226620, 2099, 370, 38887, 22538, 394005